District,Urban/Rural,Age_years,Male,Female,Total,County,Province,OBJECTID
NAIROBI WEST,Urban,0,10126,10116,20242,Nairobi,NAIROBI,0
NAIROBI WEST,Urban,1,8124,7989,16113,Nairobi,NAIROBI,1
NAIROBI WEST,Urban,2,8462,8627,17089,Nairobi,NAIROBI,2
NAIROBI WEST,Urban,3,8334,8420,16754,Nairobi,NAIROBI,3
NAIROBI WEST,Urban,4,7948,7820,15768,Nairobi,NAIROBI,4
NAIROBI WEST,Urban,5,7547,7660,15207,Nairobi,NAIROBI,5
NAIROBI WEST,Urban,6,6966,7082,14048,Nairobi,NAIROBI,6
NAIROBI WEST,Urban,7,6511,6674,13185,Nairobi,NAIROBI,7
NAIROBI WEST,Urban,8,6171,6489,12660,Nairobi,NAIROBI,8
NAIROBI WEST,Urban,9,6361,6662,13023,Nairobi,NAIROBI,9
NAIROBI WEST,Urban,10,6440,6592,13032,Nairobi,NAIROBI,10
NAIROBI WEST,Urban,11,4907,5260,10167,Nairobi,NAIROBI,11
NAIROBI WEST,Urban,12,5717,5998,11715,Nairobi,NAIROBI,12
NAIROBI WEST,Urban,13,5442,5763,11205,Nairobi,NAIROBI,13
NAIROBI WEST,Urban,14,4956,5193,10149,Nairobi,NAIROBI,14
NAIROBI WEST,Urban,15,4630,5384,10014,Nairobi,NAIROBI,15
NAIROBI WEST,Urban,16,4686,5690,10376,Nairobi,NAIROBI,16
NAIROBI WEST,Urban,17,5396,6580,11976,Nairobi,NAIROBI,17
NAIROBI WEST,Urban,18,5914,7810,13724,Nairobi,NAIROBI,18
NAIROBI WEST,Urban,19,5891,7942,13833,Nairobi,NAIROBI,19
NAIROBI WEST,Urban,20,8128,11795,19923,Nairobi,NAIROBI,20
NAIROBI WEST,Urban,21,7348,9257,16605,Nairobi,NAIROBI,21
NAIROBI WEST,Urban,22,9543,11537,21080,Nairobi,NAIROBI,22
NAIROBI WEST,Urban,23,10187,11374,21561,Nairobi,NAIROBI,23
NAIROBI WEST,Urban,24,10076,10686,20762,Nairobi,NAIROBI,24
NAIROBI WEST,Urban,25,12078,12002,24080,Nairobi,NAIROBI,25
NAIROBI WEST,Urban,26,9296,9245,18541,Nairobi,NAIROBI,26
NAIROBI WEST,Urban,27,9861,8706,18567,Nairobi,NAIROBI,27
NAIROBI WEST,Urban,28,9510,9231,18741,Nairobi,NAIROBI,28
NAIROBI WEST,Urban,29,7961,7086,15047,Nairobi,NAIROBI,29
NAIROBI WEST,Urban,30,12093,10335,22428,Nairobi,NAIROBI,30
NAIROBI WEST,Urban,31,6136,4517,10653,Nairobi,NAIROBI,31
NAIROBI WEST,Urban,32,8362,6711,15073,Nairobi,NAIROBI,32
NAIROBI WEST,Urban,33,5520,4400,9920,Nairobi,NAIROBI,33
NAIROBI WEST,Urban,34,6081,4553,10634,Nairobi,NAIROBI,34
NAIROBI WEST,Urban,35,9421,6425,15846,Nairobi,NAIROBI,35
NAIROBI WEST,Urban,36,5140,4040,9180,Nairobi,NAIROBI,36
NAIROBI WEST,Urban,37,4966,3542,8508,Nairobi,NAIROBI,37
NAIROBI WEST,Urban,38,5411,4398,9809,Nairobi,NAIROBI,38
NAIROBI WEST,Urban,39,4568,3174,7742,Nairobi,NAIROBI,39
NAIROBI WEST,Urban,40,7341,4991,12332,Nairobi,NAIROBI,40
NAIROBI WEST,Urban,41,3107,1976,5083,Nairobi,NAIROBI,41
NAIROBI WEST,Urban,42,4165,2733,6898,Nairobi,NAIROBI,42
NAIROBI WEST,Urban,43,3054,2101,5155,Nairobi,NAIROBI,43
NAIROBI WEST,Urban,44,2551,1662,4213,Nairobi,NAIROBI,44
NAIROBI WEST,Urban,45,4616,2980,7596,Nairobi,NAIROBI,45
NAIROBI WEST,Urban,46,2891,2003,4894,Nairobi,NAIROBI,46
NAIROBI WEST,Urban,47,2657,1606,4263,Nairobi,NAIROBI,47
NAIROBI WEST,Urban,48,2602,1724,4326,Nairobi,NAIROBI,48
NAIROBI WEST,Urban,49,2714,1519,4233,Nairobi,NAIROBI,49
NAIROBI WEST,Urban,50,3416,2212,5628,Nairobi,NAIROBI,50
NAIROBI WEST,Urban,51,1645,916,2561,Nairobi,NAIROBI,51
NAIROBI WEST,Urban,52,2020,1138,3158,Nairobi,NAIROBI,52
NAIROBI WEST,Urban,53,1475,845,2320,Nairobi,NAIROBI,53
NAIROBI WEST,Urban,54,1430,843,2273,Nairobi,NAIROBI,54
NAIROBI WEST,Urban,55,1842,1068,2910,Nairobi,NAIROBI,55
NAIROBI WEST,Urban,56,1286,757,2043,Nairobi,NAIROBI,56
NAIROBI WEST,Urban,57,1167,674,1841,Nairobi,NAIROBI,57
NAIROBI WEST,Urban,58,888,522,1410,Nairobi,NAIROBI,58
NAIROBI WEST,Urban,59,861,571,1432,Nairobi,NAIROBI,59
NAIROBI WEST,Urban,60,1342,926,2268,Nairobi,NAIROBI,60
NAIROBI WEST,Urban,61,606,396,1002,Nairobi,NAIROBI,61
NAIROBI WEST,Urban,62,643,402,1045,Nairobi,NAIROBI,62
NAIROBI WEST,Urban,63,533,354,887,Nairobi,NAIROBI,63
NAIROBI WEST,Urban,64,472,378,850,Nairobi,NAIROBI,64
NAIROBI WEST,Urban,65,631,462,1093,Nairobi,NAIROBI,65
NAIROBI WEST,Urban,66,309,267,576,Nairobi,NAIROBI,66
NAIROBI WEST,Urban,67,358,248,606,Nairobi,NAIROBI,67
NAIROBI WEST,Urban,68,294,199,493,Nairobi,NAIROBI,68
NAIROBI WEST,Urban,69,235,210,445,Nairobi,NAIROBI,69
NAIROBI WEST,Urban,70,400,415,815,Nairobi,NAIROBI,70
NAIROBI WEST,Urban,71,135,138,273,Nairobi,NAIROBI,71
NAIROBI WEST,Urban,72,205,178,383,Nairobi,NAIROBI,72
NAIROBI WEST,Urban,73,175,134,309,Nairobi,NAIROBI,73
NAIROBI WEST,Urban,74,128,91,219,Nairobi,NAIROBI,74
NAIROBI WEST,Urban,75,180,209,389,Nairobi,NAIROBI,75
NAIROBI WEST,Urban,76,130,106,236,Nairobi,NAIROBI,76
NAIROBI WEST,Urban,77,96,91,187,Nairobi,NAIROBI,77
NAIROBI WEST,Urban,78,98,114,212,Nairobi,NAIROBI,78
NAIROBI WEST,Urban,79,91,101,192,Nairobi,NAIROBI,79
NAIROBI WEST,Urban,80+,834,1288,2122,Nairobi,NAIROBI,80
NAIROBI WEST,Urban,Age NS,389,225,614,Nairobi,NAIROBI,81
NAIROBI EAST,Urban,0,18237,18163,36400,Nairobi,NAIROBI,82
NAIROBI EAST,Urban,1,14557,14227,28784,Nairobi,NAIROBI,83
NAIROBI EAST,Urban,2,15274,14917,30191,Nairobi,NAIROBI,84
NAIROBI EAST,Urban,3,14410,14247,28657,Nairobi,NAIROBI,85
NAIROBI EAST,Urban,4,13735,13617,27352,Nairobi,NAIROBI,86
NAIROBI EAST,Urban,5,13211,13181,26392,Nairobi,NAIROBI,87
NAIROBI EAST,Urban,6,11407,12000,23407,Nairobi,NAIROBI,88
NAIROBI EAST,Urban,7,11061,11171,22232,Nairobi,NAIROBI,89
NAIROBI EAST,Urban,8,10225,10487,20712,Nairobi,NAIROBI,90
NAIROBI EAST,Urban,9,10552,10872,21424,Nairobi,NAIROBI,91
NAIROBI EAST,Urban,10,10241,10474,20715,Nairobi,NAIROBI,92
NAIROBI EAST,Urban,11,7829,8381,16210,Nairobi,NAIROBI,93
NAIROBI EAST,Urban,12,8746,9432,18178,Nairobi,NAIROBI,94
NAIROBI EAST,Urban,13,8239,8950,17189,Nairobi,NAIROBI,95
NAIROBI EAST,Urban,62,715,415,1130,Nairobi,NAIROBI,96
NAIROBI EAST,Urban,14,7172,7960,15132,Nairobi,NAIROBI,97
NAIROBI EAST,Urban,15,6831,8554,15385,Nairobi,NAIROBI,98
NAIROBI EAST,Urban,16,6939,9692,16631,Nairobi,NAIROBI,99
NAIROBI EAST,Urban,17,7502,10747,18249,Nairobi,NAIROBI,100
NAIROBI EAST,Urban,18,8281,12944,21225,Nairobi,NAIROBI,101
NAIROBI EAST,Urban,19,8787,13708,22495,Nairobi,NAIROBI,102
NAIROBI EAST,Urban,20,12803,21060,33863,Nairobi,NAIROBI,103
NAIROBI EAST,Urban,21,12217,16777,28994,Nairobi,NAIROBI,104
NAIROBI EAST,Urban,22,15898,21697,37595,Nairobi,NAIROBI,105
NAIROBI EAST,Urban,23,16882,21301,38183,Nairobi,NAIROBI,106
NAIROBI EAST,Urban,24,18028,20785,38813,Nairobi,NAIROBI,107
NAIROBI EAST,Urban,25,21383,23090,44473,Nairobi,NAIROBI,108
NAIROBI EAST,Urban,26,17238,18413,35651,Nairobi,NAIROBI,109
NAIROBI EAST,Urban,27,18267,16848,35115,Nairobi,NAIROBI,110
NAIROBI EAST,Urban,28,18264,18054,36318,Nairobi,NAIROBI,111
NAIROBI EAST,Urban,29,15530,13176,28706,Nairobi,NAIROBI,112
NAIROBI EAST,Urban,30,23060,18937,41997,Nairobi,NAIROBI,113
NAIROBI EAST,Urban,31,11422,7906,19328,Nairobi,NAIROBI,114
NAIROBI EAST,Urban,32,15495,11519,27014,Nairobi,NAIROBI,115
NAIROBI EAST,Urban,33,10233,7204,17437,Nairobi,NAIROBI,116
NAIROBI EAST,Urban,34,11139,7684,18823,Nairobi,NAIROBI,117
NAIROBI EAST,Urban,35,16527,10542,27069,Nairobi,NAIROBI,118
NAIROBI EAST,Urban,36,8879,6034,14913,Nairobi,NAIROBI,119
NAIROBI EAST,Urban,37,8403,5489,13892,Nairobi,NAIROBI,120
NAIROBI EAST,Urban,38,9182,6583,15765,Nairobi,NAIROBI,121
NAIROBI EAST,Urban,39,7557,4802,12359,Nairobi,NAIROBI,122
NAIROBI EAST,Urban,40,11658,7211,18869,Nairobi,NAIROBI,123
NAIROBI EAST,Urban,41,4812,2592,7404,Nairobi,NAIROBI,124
NAIROBI EAST,Urban,42,6525,3905,10430,Nairobi,NAIROBI,125
NAIROBI EAST,Urban,43,4524,2826,7350,Nairobi,NAIROBI,126
NAIROBI EAST,Urban,44,3760,2276,6036,Nairobi,NAIROBI,127
NAIROBI EAST,Urban,45,6695,3923,10618,Nairobi,NAIROBI,128
NAIROBI EAST,Urban,46,4254,2539,6793,Nairobi,NAIROBI,129
NAIROBI EAST,Urban,47,3822,2126,5948,Nairobi,NAIROBI,130
NAIROBI EAST,Urban,48,3469,2214,5683,Nairobi,NAIROBI,131
NAIROBI EAST,Urban,49,3386,1941,5327,Nairobi,NAIROBI,132
NAIROBI EAST,Urban,50,4537,2728,7265,Nairobi,NAIROBI,133
NAIROBI EAST,Urban,51,2155,1227,3382,Nairobi,NAIROBI,134
NAIROBI EAST,Urban,52,2407,1292,3699,Nairobi,NAIROBI,135
NAIROBI EAST,Urban,53,1811,1001,2812,Nairobi,NAIROBI,136
NAIROBI EAST,Urban,54,1771,978,2749,Nairobi,NAIROBI,137
NAIROBI EAST,Urban,55,1978,1301,3279,Nairobi,NAIROBI,138
NAIROBI EAST,Urban,56,1464,916,2380,Nairobi,NAIROBI,139
NAIROBI EAST,Urban,57,1357,815,2172,Nairobi,NAIROBI,140
NAIROBI EAST,Urban,58,967,716,1683,Nairobi,NAIROBI,141
NAIROBI EAST,Urban,59,1022,617,1639,Nairobi,NAIROBI,142
NAIROBI EAST,Urban,60,1547,1136,2683,Nairobi,NAIROBI,143
NAIROBI EAST,Urban,61,705,399,1104,Nairobi,NAIROBI,144
NAIROBI EAST,Urban,63,632,355,987,Nairobi,NAIROBI,145
NAIROBI EAST,Urban,64,501,307,808,Nairobi,NAIROBI,146
NAIROBI EAST,Urban,65,618,457,1075,Nairobi,NAIROBI,147
NAIROBI EAST,Urban,66,293,220,513,Nairobi,NAIROBI,148
NAIROBI EAST,Urban,67,355,235,590,Nairobi,NAIROBI,149
NAIROBI EAST,Urban,68,238,213,451,Nairobi,NAIROBI,150
NAIROBI EAST,Urban,69,248,205,453,Nairobi,NAIROBI,151
NAIROBI EAST,Urban,70,371,454,825,Nairobi,NAIROBI,152
NAIROBI EAST,Urban,71,145,124,269,Nairobi,NAIROBI,153
NAIROBI EAST,Urban,72,183,142,325,Nairobi,NAIROBI,154
NAIROBI EAST,Urban,73,124,134,258,Nairobi,NAIROBI,155
NAIROBI EAST,Urban,74,103,138,241,Nairobi,NAIROBI,156
NAIROBI EAST,Urban,75,170,184,354,Nairobi,NAIROBI,157
NAIROBI EAST,Urban,76,95,116,211,Nairobi,NAIROBI,158
NAIROBI EAST,Urban,77,87,78,165,Nairobi,NAIROBI,159
NAIROBI EAST,Urban,78,87,103,190,Nairobi,NAIROBI,160
NAIROBI EAST,Urban,79,77,110,187,Nairobi,NAIROBI,161
NAIROBI EAST,Urban,80+,787,1342,2129,Nairobi,NAIROBI,162
NAIROBI EAST,Urban,Age NS,456,226,682,Nairobi,NAIROBI,163
NAIROBI NORTH,Urban,0,16399,16210,32609,Nairobi,NAIROBI,164
NAIROBI NORTH,Urban,1,12640,12620,25260,Nairobi,NAIROBI,165
NAIROBI NORTH,Urban,2,13583,13414,26997,Nairobi,NAIROBI,166
NAIROBI NORTH,Urban,3,13085,12950,26035,Nairobi,NAIROBI,167
NAIROBI NORTH,Urban,4,12537,12377,24914,Nairobi,NAIROBI,168
NAIROBI NORTH,Urban,5,11980,11723,23703,Nairobi,NAIROBI,169
NAIROBI NORTH,Urban,6,10669,10739,21408,Nairobi,NAIROBI,170
NAIROBI NORTH,Urban,7,10034,10240,20274,Nairobi,NAIROBI,171
NAIROBI NORTH,Urban,8,9463,9831,19294,Nairobi,NAIROBI,172
NAIROBI NORTH,Urban,9,9709,10009,19718,Nairobi,NAIROBI,173
NAIROBI NORTH,Urban,10,9655,10245,19900,Nairobi,NAIROBI,174
NAIROBI NORTH,Urban,11,7444,7818,15262,Nairobi,NAIROBI,175
NAIROBI NORTH,Urban,12,8662,9076,17738,Nairobi,NAIROBI,176
NAIROBI NORTH,Urban,13,8304,8738,17042,Nairobi,NAIROBI,177
NAIROBI NORTH,Urban,14,7289,7864,15153,Nairobi,NAIROBI,178
NAIROBI NORTH,Urban,15,7142,8370,15512,Nairobi,NAIROBI,179
NAIROBI NORTH,Urban,16,7099,9353,16452,Nairobi,NAIROBI,180
NAIROBI NORTH,Urban,17,8284,10593,18877,Nairobi,NAIROBI,181
NAIROBI NORTH,Urban,18,9885,12901,22786,Nairobi,NAIROBI,182
NAIROBI NORTH,Urban,19,9518,13204,22722,Nairobi,NAIROBI,183
NAIROBI NORTH,Urban,20,14284,20517,34801,Nairobi,NAIROBI,184
NAIROBI NORTH,Urban,21,12241,15121,27362,Nairobi,NAIROBI,185
NAIROBI NORTH,Urban,22,15923,19585,35508,Nairobi,NAIROBI,186
NAIROBI NORTH,Urban,23,16443,18839,35282,Nairobi,NAIROBI,187
NAIROBI NORTH,Urban,24,16334,18226,34560,Nairobi,NAIROBI,188
NAIROBI NORTH,Urban,25,20175,20637,40812,Nairobi,NAIROBI,189
NAIROBI NORTH,Urban,26,15332,15410,30742,Nairobi,NAIROBI,190
NAIROBI NORTH,Urban,27,15781,13983,29764,Nairobi,NAIROBI,191
NAIROBI NORTH,Urban,28,15773,15459,31232,Nairobi,NAIROBI,192
NAIROBI NORTH,Urban,29,12957,11014,23971,Nairobi,NAIROBI,193
NAIROBI NORTH,Urban,30,20554,16771,37325,Nairobi,NAIROBI,194
NAIROBI NORTH,Urban,31,9295,6477,15772,Nairobi,NAIROBI,195
NAIROBI NORTH,Urban,32,13287,10045,23332,Nairobi,NAIROBI,196
NAIROBI NORTH,Urban,33,8121,6125,14246,Nairobi,NAIROBI,197
NAIROBI NORTH,Urban,34,9419,6352,15771,Nairobi,NAIROBI,198
NAIROBI NORTH,Urban,35,14483,9844,24327,Nairobi,NAIROBI,199
NAIROBI NORTH,Urban,36,7546,5368,12914,Nairobi,NAIROBI,200
NAIROBI NORTH,Urban,37,7038,4806,11844,Nairobi,NAIROBI,201
NAIROBI NORTH,Urban,38,7894,5993,13887,Nairobi,NAIROBI,202
NAIROBI NORTH,Urban,39,6422,4370,10792,Nairobi,NAIROBI,203
NAIROBI NORTH,Urban,40,11235,7256,18491,Nairobi,NAIROBI,204
NAIROBI NORTH,Urban,41,4226,2487,6713,Nairobi,NAIROBI,205
NAIROBI NORTH,Urban,42,6037,3684,9721,Nairobi,NAIROBI,206
NAIROBI NORTH,Urban,43,4257,2683,6940,Nairobi,NAIROBI,207
NAIROBI NORTH,Urban,44,3446,2129,5575,Nairobi,NAIROBI,208
NAIROBI NORTH,Urban,45,6713,4226,10939,Nairobi,NAIROBI,209
NAIROBI NORTH,Urban,46,3986,2518,6504,Nairobi,NAIROBI,210
NAIROBI NORTH,Urban,47,3741,2094,5835,Nairobi,NAIROBI,211
NAIROBI NORTH,Urban,48,3654,2256,5910,Nairobi,NAIROBI,212
NAIROBI NORTH,Urban,49,3438,1858,5296,Nairobi,NAIROBI,213
NAIROBI NORTH,Urban,50,5080,3303,8383,Nairobi,NAIROBI,214
NAIROBI NORTH,Urban,51,2213,1117,3330,Nairobi,NAIROBI,215
NAIROBI NORTH,Urban,52,2562,1403,3965,Nairobi,NAIROBI,216
NAIROBI NORTH,Urban,53,1889,956,2845,Nairobi,NAIROBI,217
NAIROBI NORTH,Urban,54,1923,1043,2966,Nairobi,NAIROBI,218
NAIROBI NORTH,Urban,55,2408,1489,3897,Nairobi,NAIROBI,219
NAIROBI NORTH,Urban,56,1625,932,2557,Nairobi,NAIROBI,220
NAIROBI NORTH,Urban,57,1477,747,2224,Nairobi,NAIROBI,221
NAIROBI NORTH,Urban,58,1153,681,1834,Nairobi,NAIROBI,222
NAIROBI NORTH,Urban,59,1048,597,1645,Nairobi,NAIROBI,223
NAIROBI NORTH,Urban,60,1938,1560,3498,Nairobi,NAIROBI,224
NAIROBI NORTH,Urban,61,716,399,1115,Nairobi,NAIROBI,225
NAIROBI NORTH,Urban,62,832,467,1299,Nairobi,NAIROBI,226
NAIROBI NORTH,Urban,63,648,332,980,Nairobi,NAIROBI,227
NAIROBI NORTH,Urban,64,564,346,910,Nairobi,NAIROBI,228
NAIROBI NORTH,Urban,65,838,718,1556,Nairobi,NAIROBI,229
NAIROBI NORTH,Urban,66,344,241,585,Nairobi,NAIROBI,230
NAIROBI NORTH,Urban,67,387,305,692,Nairobi,NAIROBI,231
NAIROBI NORTH,Urban,68,321,263,584,Nairobi,NAIROBI,232
NAIROBI NORTH,Urban,69,291,235,526,Nairobi,NAIROBI,233
NAIROBI NORTH,Urban,70,657,784,1441,Nairobi,NAIROBI,234
NAIROBI NORTH,Urban,71,187,143,330,Nairobi,NAIROBI,235
NAIROBI NORTH,Urban,72,242,175,417,Nairobi,NAIROBI,236
NAIROBI NORTH,Urban,73,182,136,318,Nairobi,NAIROBI,237
NAIROBI NORTH,Urban,74,178,138,316,Nairobi,NAIROBI,238
NAIROBI NORTH,Urban,75,257,292,549,Nairobi,NAIROBI,239
NAIROBI NORTH,Urban,76,124,128,252,Nairobi,NAIROBI,240
NAIROBI NORTH,Urban,77,107,82,189,Nairobi,NAIROBI,241
NAIROBI NORTH,Urban,78,115,123,238,Nairobi,NAIROBI,242
NAIROBI NORTH,Urban,79,86,98,184,Nairobi,NAIROBI,243
NAIROBI NORTH,Urban,80+,1128,1679,2807,Nairobi,NAIROBI,244
NAIROBI NORTH,Urban,Age NS,765,1065,1830,Nairobi,NAIROBI,245
WESTLANDS,Urban,0,2704,2692,5396,Nairobi,NAIROBI,246
WESTLANDS,Urban,1,2287,2297,4584,Nairobi,NAIROBI,247
WESTLANDS,Urban,2,2354,2352,4706,Nairobi,NAIROBI,248
WESTLANDS,Urban,3,2369,2427,4796,Nairobi,NAIROBI,249
WESTLANDS,Urban,4,2216,2298,4514,Nairobi,NAIROBI,250
WESTLANDS,Urban,5,2157,2129,4286,Nairobi,NAIROBI,251
WESTLANDS,Urban,6,2050,2070,4120,Nairobi,NAIROBI,252
WESTLANDS,Urban,7,1890,1929,3819,Nairobi,NAIROBI,253
WESTLANDS,Urban,8,1928,1988,3916,Nairobi,NAIROBI,254
WESTLANDS,Urban,9,2008,2041,4049,Nairobi,NAIROBI,255
WESTLANDS,Urban,10,1959,2067,4026,Nairobi,NAIROBI,256
WESTLANDS,Urban,11,1683,1670,3353,Nairobi,NAIROBI,257
WESTLANDS,Urban,12,1850,1927,3777,Nairobi,NAIROBI,258
WESTLANDS,Urban,13,1768,1840,3608,Nairobi,NAIROBI,259
WESTLANDS,Urban,14,1648,1766,3414,Nairobi,NAIROBI,260
WESTLANDS,Urban,15,1671,1794,3465,Nairobi,NAIROBI,261
WESTLANDS,Urban,16,1629,2034,3663,Nairobi,NAIROBI,262
WESTLANDS,Urban,17,1788,2209,3997,Nairobi,NAIROBI,263
WESTLANDS,Urban,18,1959,2369,4328,Nairobi,NAIROBI,264
WESTLANDS,Urban,19,1940,2414,4354,Nairobi,NAIROBI,265
WESTLANDS,Urban,20,2433,3563,5996,Nairobi,NAIROBI,266
WESTLANDS,Urban,21,2498,3123,5621,Nairobi,NAIROBI,267
WESTLANDS,Urban,22,3065,3789,6854,Nairobi,NAIROBI,268
WESTLANDS,Urban,23,3384,3734,7118,Nairobi,NAIROBI,269
WESTLANDS,Urban,24,3374,3541,6915,Nairobi,NAIROBI,270
WESTLANDS,Urban,25,3583,3894,7477,Nairobi,NAIROBI,271
WESTLANDS,Urban,26,2949,3151,6100,Nairobi,NAIROBI,272
WESTLANDS,Urban,27,3096,3060,6156,Nairobi,NAIROBI,273
WESTLANDS,Urban,28,2885,3141,6026,Nairobi,NAIROBI,274
WESTLANDS,Urban,29,2677,2557,5234,Nairobi,NAIROBI,275
WESTLANDS,Urban,30,3551,3617,7168,Nairobi,NAIROBI,276
WESTLANDS,Urban,31,2055,1932,3987,Nairobi,NAIROBI,277
WESTLANDS,Urban,32,2681,2584,5265,Nairobi,NAIROBI,278
WESTLANDS,Urban,33,1906,1834,3740,Nairobi,NAIROBI,279
WESTLANDS,Urban,34,2213,2003,4216,Nairobi,NAIROBI,280
WESTLANDS,Urban,35,3137,2679,5816,Nairobi,NAIROBI,281
WESTLANDS,Urban,36,1968,1824,3792,Nairobi,NAIROBI,282
WESTLANDS,Urban,37,1981,1678,3659,Nairobi,NAIROBI,283
WESTLANDS,Urban,38,2029,1953,3982,Nairobi,NAIROBI,284
WESTLANDS,Urban,39,1907,1629,3536,Nairobi,NAIROBI,285
WESTLANDS,Urban,40,2622,2252,4874,Nairobi,NAIROBI,286
WESTLANDS,Urban,41,1321,1067,2388,Nairobi,NAIROBI,287
WESTLANDS,Urban,42,1724,1496,3220,Nairobi,NAIROBI,288
WESTLANDS,Urban,43,1397,1189,2586,Nairobi,NAIROBI,289
WESTLANDS,Urban,44,1347,976,2323,Nairobi,NAIROBI,290
WESTLANDS,Urban,45,1985,1524,3509,Nairobi,NAIROBI,291
WESTLANDS,Urban,46,1375,1079,2454,Nairobi,NAIROBI,292
WESTLANDS,Urban,47,1290,953,2243,Nairobi,NAIROBI,293
WESTLANDS,Urban,48,1293,1040,2333,Nairobi,NAIROBI,294
WESTLANDS,Urban,49,1320,979,2299,Nairobi,NAIROBI,295
WESTLANDS,Urban,50,1604,1251,2855,Nairobi,NAIROBI,296
WESTLANDS,Urban,51,932,608,1540,Nairobi,NAIROBI,297
WESTLANDS,Urban,52,1132,768,1900,Nairobi,NAIROBI,298
WESTLANDS,Urban,53,828,618,1446,Nairobi,NAIROBI,299
WESTLANDS,Urban,54,852,647,1499,Nairobi,NAIROBI,300
WESTLANDS,Urban,55,957,700,1657,Nairobi,NAIROBI,301
WESTLANDS,Urban,56,824,543,1367,Nairobi,NAIROBI,302
WESTLANDS,Urban,57,743,507,1250,Nairobi,NAIROBI,303
WESTLANDS,Urban,58,628,418,1046,Nairobi,NAIROBI,304
WESTLANDS,Urban,59,609,410,1019,Nairobi,NAIROBI,305
WESTLANDS,Urban,60,823,629,1452,Nairobi,NAIROBI,306
WESTLANDS,Urban,61,473,293,766,Nairobi,NAIROBI,307
WESTLANDS,Urban,62,521,378,899,Nairobi,NAIROBI,308
WESTLANDS,Urban,63,425,332,757,Nairobi,NAIROBI,309
WESTLANDS,Urban,64,425,301,726,Nairobi,NAIROBI,310
WESTLANDS,Urban,65,514,371,885,Nairobi,NAIROBI,311
WESTLANDS,Urban,66,261,201,462,Nairobi,NAIROBI,312
WESTLANDS,Urban,67,325,210,535,Nairobi,NAIROBI,313
WESTLANDS,Urban,68,259,200,459,Nairobi,NAIROBI,314
WESTLANDS,Urban,69,239,204,443,Nairobi,NAIROBI,315
WESTLANDS,Urban,70,349,357,706,Nairobi,NAIROBI,316
WESTLANDS,Urban,71,156,132,288,Nairobi,NAIROBI,317
WESTLANDS,Urban,72,212,169,381,Nairobi,NAIROBI,318
WESTLANDS,Urban,73,186,136,322,Nairobi,NAIROBI,319
WESTLANDS,Urban,74,144,122,266,Nairobi,NAIROBI,320
WESTLANDS,Urban,75,197,198,395,Nairobi,NAIROBI,321
WESTLANDS,Urban,76,133,112,245,Nairobi,NAIROBI,322
WESTLANDS,Urban,77,99,86,185,Nairobi,NAIROBI,323
WESTLANDS,Urban,78,115,96,211,Nairobi,NAIROBI,324
WESTLANDS,Urban,79,80,92,172,Nairobi,NAIROBI,325
WESTLANDS,Urban,80+,599,866,1465,Nairobi,NAIROBI,326
WESTLANDS,Urban,Age NS,200,245,445,Nairobi,NAIROBI,327
NYANDARUA NORTH,Urban,0,1285,1212,2497,Nyandarua,CENTRAL,328
NYANDARUA NORTH,Urban,1,1189,1143,2332,Nyandarua,CENTRAL,329
NYANDARUA NORTH,Urban,2,1315,1276,2591,Nyandarua,CENTRAL,330
NYANDARUA NORTH,Urban,3,1285,1330,2615,Nyandarua,CENTRAL,331
NYANDARUA NORTH,Urban,4,1428,1358,2786,Nyandarua,CENTRAL,332
NYANDARUA NORTH,Urban,5,1414,1324,2738,Nyandarua,CENTRAL,333
NYANDARUA NORTH,Urban,6,1376,1301,2677,Nyandarua,CENTRAL,334
NYANDARUA NORTH,Urban,7,1321,1259,2580,Nyandarua,CENTRAL,335
NYANDARUA NORTH,Urban,8,1268,1200,2468,Nyandarua,CENTRAL,336
NYANDARUA NORTH,Urban,9,1337,1230,2567,Nyandarua,CENTRAL,337
NYANDARUA NORTH,Urban,10,1338,1362,2700,Nyandarua,CENTRAL,338
NYANDARUA NORTH,Urban,11,1044,1022,2066,Nyandarua,CENTRAL,339
NYANDARUA NORTH,Urban,12,1327,1301,2628,Nyandarua,CENTRAL,340
NYANDARUA NORTH,Urban,13,1258,1215,2473,Nyandarua,CENTRAL,341
NYANDARUA NORTH,Urban,14,1134,1107,2241,Nyandarua,CENTRAL,342
NYANDARUA NORTH,Urban,15,1024,981,2005,Nyandarua,CENTRAL,343
NYANDARUA NORTH,Urban,16,973,958,1931,Nyandarua,CENTRAL,344
NYANDARUA NORTH,Urban,17,1028,929,1957,Nyandarua,CENTRAL,345
NYANDARUA NORTH,Urban,18,1051,887,1938,Nyandarua,CENTRAL,346
NYANDARUA NORTH,Urban,19,835,791,1626,Nyandarua,CENTRAL,347
NYANDARUA NORTH,Urban,20,904,954,1858,Nyandarua,CENTRAL,348
NYANDARUA NORTH,Urban,21,703,772,1475,Nyandarua,CENTRAL,349
NYANDARUA NORTH,Urban,22,835,890,1725,Nyandarua,CENTRAL,350
NYANDARUA NORTH,Urban,23,693,863,1556,Nyandarua,CENTRAL,351
NYANDARUA NORTH,Urban,24,707,839,1546,Nyandarua,CENTRAL,352
NYANDARUA NORTH,Urban,25,910,1123,2033,Nyandarua,CENTRAL,353
NYANDARUA NORTH,Urban,26,653,794,1447,Nyandarua,CENTRAL,354
NYANDARUA NORTH,Urban,27,715,784,1499,Nyandarua,CENTRAL,355
NYANDARUA NORTH,Urban,28,671,769,1440,Nyandarua,CENTRAL,356
NYANDARUA NORTH,Urban,29,605,687,1292,Nyandarua,CENTRAL,357
NYANDARUA NORTH,Urban,30,928,1129,2057,Nyandarua,CENTRAL,358
NYANDARUA NORTH,Urban,31,550,505,1055,Nyandarua,CENTRAL,359
NYANDARUA NORTH,Urban,32,618,705,1323,Nyandarua,CENTRAL,360
NYANDARUA NORTH,Urban,33,416,474,890,Nyandarua,CENTRAL,361
NYANDARUA NORTH,Urban,34,480,542,1022,Nyandarua,CENTRAL,362
NYANDARUA NORTH,Urban,35,832,893,1725,Nyandarua,CENTRAL,363
NYANDARUA NORTH,Urban,36,453,479,932,Nyandarua,CENTRAL,364
NYANDARUA NORTH,Urban,37,444,480,924,Nyandarua,CENTRAL,365
NYANDARUA NORTH,Urban,38,482,594,1076,Nyandarua,CENTRAL,366
NYANDARUA NORTH,Urban,39,435,524,959,Nyandarua,CENTRAL,367
NYANDARUA NORTH,Urban,40,743,817,1560,Nyandarua,CENTRAL,368
NYANDARUA NORTH,Urban,41,315,359,674,Nyandarua,CENTRAL,369
NYANDARUA NORTH,Urban,42,450,499,949,Nyandarua,CENTRAL,370
NYANDARUA NORTH,Urban,43,269,378,647,Nyandarua,CENTRAL,371
NYANDARUA NORTH,Urban,44,290,306,596,Nyandarua,CENTRAL,372
NYANDARUA NORTH,Urban,45,548,594,1142,Nyandarua,CENTRAL,373
NYANDARUA NORTH,Urban,46,332,328,660,Nyandarua,CENTRAL,374
NYANDARUA NORTH,Urban,47,303,310,613,Nyandarua,CENTRAL,375
NYANDARUA NORTH,Urban,48,309,367,676,Nyandarua,CENTRAL,376
NYANDARUA NORTH,Urban,49,293,303,596,Nyandarua,CENTRAL,377
NYANDARUA NORTH,Urban,50,417,461,878,Nyandarua,CENTRAL,378
NYANDARUA NORTH,Urban,51,199,176,375,Nyandarua,CENTRAL,379
NYANDARUA NORTH,Urban,52,211,230,441,Nyandarua,CENTRAL,380
NYANDARUA NORTH,Urban,53,135,153,288,Nyandarua,CENTRAL,381
NYANDARUA NORTH,Urban,54,175,160,335,Nyandarua,CENTRAL,382
NYANDARUA NORTH,Urban,55,260,243,503,Nyandarua,CENTRAL,383
NYANDARUA NORTH,Urban,56,184,181,365,Nyandarua,CENTRAL,384
NYANDARUA NORTH,Urban,57,189,204,393,Nyandarua,CENTRAL,385
NYANDARUA NORTH,Urban,58,104,151,255,Nyandarua,CENTRAL,386
NYANDARUA NORTH,Urban,59,131,167,298,Nyandarua,CENTRAL,387
NYANDARUA NORTH,Urban,60,253,333,586,Nyandarua,CENTRAL,388
NYANDARUA NORTH,Urban,61,100,122,222,Nyandarua,CENTRAL,389
NYANDARUA NORTH,Urban,62,97,128,225,Nyandarua,CENTRAL,390
NYANDARUA NORTH,Urban,63,122,116,238,Nyandarua,CENTRAL,391
NYANDARUA NORTH,Urban,64,113,121,234,Nyandarua,CENTRAL,392
NYANDARUA NORTH,Urban,65,155,201,356,Nyandarua,CENTRAL,393
NYANDARUA NORTH,Urban,66,96,197,293,Nyandarua,CENTRAL,394
NYANDARUA NORTH,Urban,67,92,109,201,Nyandarua,CENTRAL,395
NYANDARUA NORTH,Urban,68,68,90,158,Nyandarua,CENTRAL,396
NYANDARUA NORTH,Urban,69,83,91,174,Nyandarua,CENTRAL,397
NYANDARUA NORTH,Urban,70,158,207,365,Nyandarua,CENTRAL,398
NYANDARUA NORTH,Urban,71,56,62,118,Nyandarua,CENTRAL,399
NYANDARUA NORTH,Urban,72,69,62,131,Nyandarua,CENTRAL,400
NYANDARUA NORTH,Urban,73,56,64,120,Nyandarua,CENTRAL,401
NYANDARUA NORTH,Urban,74,70,73,143,Nyandarua,CENTRAL,402
NYANDARUA NORTH,Urban,75,84,83,167,Nyandarua,CENTRAL,403
NYANDARUA NORTH,Urban,76,44,68,112,Nyandarua,CENTRAL,404
NYANDARUA NORTH,Urban,77,41,50,91,Nyandarua,CENTRAL,405
NYANDARUA NORTH,Urban,78,52,41,93,Nyandarua,CENTRAL,406
NYANDARUA NORTH,Urban,79,43,51,94,Nyandarua,CENTRAL,407
NYANDARUA NORTH,Urban,80+,404,604,1008,Nyandarua,CENTRAL,408
NYANDARUA NORTH,Urban,Age NS,23,9,32,Nyandarua,CENTRAL,409
NYANDARUA SOUTH,Urban,0,275,324,599,Nyandarua,CENTRAL,410
NYANDARUA SOUTH,Urban,1,239,227,466,Nyandarua,CENTRAL,411
NYANDARUA SOUTH,Urban,2,233,235,468,Nyandarua,CENTRAL,412
NYANDARUA SOUTH,Urban,3,283,246,529,Nyandarua,CENTRAL,413
NYANDARUA SOUTH,Urban,4,247,275,522,Nyandarua,CENTRAL,414
NYANDARUA SOUTH,Urban,5,282,223,505,Nyandarua,CENTRAL,415
NYANDARUA SOUTH,Urban,6,248,256,504,Nyandarua,CENTRAL,416
NYANDARUA SOUTH,Urban,7,235,215,450,Nyandarua,CENTRAL,417
NYANDARUA SOUTH,Urban,8,225,228,453,Nyandarua,CENTRAL,418
NYANDARUA SOUTH,Urban,9,217,213,430,Nyandarua,CENTRAL,419
NYANDARUA SOUTH,Urban,10,226,225,451,Nyandarua,CENTRAL,420
NYANDARUA SOUTH,Urban,11,155,191,346,Nyandarua,CENTRAL,421
NYANDARUA SOUTH,Urban,12,219,237,456,Nyandarua,CENTRAL,422
NYANDARUA SOUTH,Urban,13,195,221,416,Nyandarua,CENTRAL,423
NYANDARUA SOUTH,Urban,14,192,185,377,Nyandarua,CENTRAL,424
NYANDARUA SOUTH,Urban,15,165,158,323,Nyandarua,CENTRAL,425
NYANDARUA SOUTH,Urban,16,144,165,309,Nyandarua,CENTRAL,426
NYANDARUA SOUTH,Urban,17,150,184,334,Nyandarua,CENTRAL,427
NYANDARUA SOUTH,Urban,18,151,189,340,Nyandarua,CENTRAL,428
NYANDARUA SOUTH,Urban,19,121,154,275,Nyandarua,CENTRAL,429
NYANDARUA SOUTH,Urban,20,146,227,373,Nyandarua,CENTRAL,430
NYANDARUA SOUTH,Urban,21,135,214,349,Nyandarua,CENTRAL,431
NYANDARUA SOUTH,Urban,22,168,232,400,Nyandarua,CENTRAL,432
NYANDARUA SOUTH,Urban,23,182,226,408,Nyandarua,CENTRAL,433
NYANDARUA SOUTH,Urban,24,156,223,379,Nyandarua,CENTRAL,434
NYANDARUA SOUTH,Urban,25,222,297,519,Nyandarua,CENTRAL,435
NYANDARUA SOUTH,Urban,26,197,196,393,Nyandarua,CENTRAL,436
NYANDARUA SOUTH,Urban,27,203,191,394,Nyandarua,CENTRAL,437
NYANDARUA SOUTH,Urban,28,201,210,411,Nyandarua,CENTRAL,438
NYANDARUA SOUTH,Urban,29,167,149,316,Nyandarua,CENTRAL,439
NYANDARUA SOUTH,Urban,30,270,245,515,Nyandarua,CENTRAL,440
NYANDARUA SOUTH,Urban,31,152,122,274,Nyandarua,CENTRAL,441
NYANDARUA SOUTH,Urban,32,157,158,315,Nyandarua,CENTRAL,442
NYANDARUA SOUTH,Urban,33,111,100,211,Nyandarua,CENTRAL,443
NYANDARUA SOUTH,Urban,34,123,123,246,Nyandarua,CENTRAL,444
NYANDARUA SOUTH,Urban,35,194,182,376,Nyandarua,CENTRAL,445
NYANDARUA SOUTH,Urban,36,103,100,203,Nyandarua,CENTRAL,446
NYANDARUA SOUTH,Urban,37,111,108,219,Nyandarua,CENTRAL,447
NYANDARUA SOUTH,Urban,38,123,111,234,Nyandarua,CENTRAL,448
NYANDARUA SOUTH,Urban,39,87,95,182,Nyandarua,CENTRAL,449
NYANDARUA SOUTH,Urban,40,151,133,284,Nyandarua,CENTRAL,450
NYANDARUA SOUTH,Urban,41,68,48,116,Nyandarua,CENTRAL,451
NYANDARUA SOUTH,Urban,42,96,81,177,Nyandarua,CENTRAL,452
NYANDARUA SOUTH,Urban,43,83,69,152,Nyandarua,CENTRAL,453
NYANDARUA SOUTH,Urban,44,73,44,117,Nyandarua,CENTRAL,454
NYANDARUA SOUTH,Urban,45,112,101,213,Nyandarua,CENTRAL,455
NYANDARUA SOUTH,Urban,46,57,55,112,Nyandarua,CENTRAL,456
NYANDARUA SOUTH,Urban,47,50,51,101,Nyandarua,CENTRAL,457
NYANDARUA SOUTH,Urban,48,51,42,93,Nyandarua,CENTRAL,458
NYANDARUA SOUTH,Urban,49,51,31,82,Nyandarua,CENTRAL,459
NYANDARUA SOUTH,Urban,50,71,69,140,Nyandarua,CENTRAL,460
NYANDARUA SOUTH,Urban,51,32,27,59,Nyandarua,CENTRAL,461
NYANDARUA SOUTH,Urban,52,41,31,72,Nyandarua,CENTRAL,462
NYANDARUA SOUTH,Urban,53,17,13,30,Nyandarua,CENTRAL,463
NYANDARUA SOUTH,Urban,54,18,18,36,Nyandarua,CENTRAL,464
NYANDARUA SOUTH,Urban,55,39,41,80,Nyandarua,CENTRAL,465
NYANDARUA SOUTH,Urban,56,20,17,37,Nyandarua,CENTRAL,466
NYANDARUA SOUTH,Urban,57,31,23,54,Nyandarua,CENTRAL,467
NYANDARUA SOUTH,Urban,58,14,20,34,Nyandarua,CENTRAL,468
NYANDARUA SOUTH,Urban,59,19,22,41,Nyandarua,CENTRAL,469
NYANDARUA SOUTH,Urban,60,37,33,70,Nyandarua,CENTRAL,470
NYANDARUA SOUTH,Urban,61,11,13,24,Nyandarua,CENTRAL,471
NYANDARUA SOUTH,Urban,62,14,15,29,Nyandarua,CENTRAL,472
NYANDARUA SOUTH,Urban,63,16,10,26,Nyandarua,CENTRAL,473
NYANDARUA SOUTH,Urban,64,15,15,30,Nyandarua,CENTRAL,474
NYANDARUA SOUTH,Urban,65,26,20,46,Nyandarua,CENTRAL,475
NYANDARUA SOUTH,Urban,66,6,24,30,Nyandarua,CENTRAL,476
NYANDARUA SOUTH,Urban,67,10,19,29,Nyandarua,CENTRAL,477
NYANDARUA SOUTH,Urban,68,12,11,23,Nyandarua,CENTRAL,478
NYANDARUA SOUTH,Urban,69,9,4,13,Nyandarua,CENTRAL,479
NYANDARUA SOUTH,Urban,70,24,19,43,Nyandarua,CENTRAL,480
NYANDARUA SOUTH,Urban,71,10,5,15,Nyandarua,CENTRAL,481
NYANDARUA SOUTH,Urban,72,9,14,23,Nyandarua,CENTRAL,482
NYANDARUA SOUTH,Urban,73,6,2,8,Nyandarua,CENTRAL,483
NYANDARUA SOUTH,Urban,74,7,9,16,Nyandarua,CENTRAL,484
NYANDARUA SOUTH,Urban,75,12,11,23,Nyandarua,CENTRAL,485
NYANDARUA SOUTH,Urban,76,3,7,10,Nyandarua,CENTRAL,486
NYANDARUA SOUTH,Urban,77,3,1,4,Nyandarua,CENTRAL,487
NYANDARUA SOUTH,Urban,78,7,3,10,Nyandarua,CENTRAL,488
NYANDARUA SOUTH,Urban,79,2,5,7,Nyandarua,CENTRAL,489
NYANDARUA SOUTH,Urban,80+,26,55,81,Nyandarua,CENTRAL,490
NYANDARUA SOUTH,Urban,Age NS,3,0,3,Nyandarua,CENTRAL,491
NYERI NORTH,Urban,0,573,598,1171,Nyeri,CENTRAL,492
NYERI NORTH,Urban,1,467,471,938,Nyeri,CENTRAL,493
NYERI NORTH,Urban,2,484,505,989,Nyeri,CENTRAL,494
NYERI NORTH,Urban,3,510,440,950,Nyeri,CENTRAL,495
NYERI NORTH,Urban,4,489,468,957,Nyeri,CENTRAL,496
NYERI NORTH,Urban,5,455,456,911,Nyeri,CENTRAL,497
NYERI NORTH,Urban,6,462,414,876,Nyeri,CENTRAL,498
NYERI NORTH,Urban,7,425,412,837,Nyeri,CENTRAL,499
NYERI NORTH,Urban,8,396,390,786,Nyeri,CENTRAL,500
NYERI NORTH,Urban,9,390,428,818,Nyeri,CENTRAL,501
NYERI NORTH,Urban,10,442,425,867,Nyeri,CENTRAL,502
NYERI NORTH,Urban,11,364,461,825,Nyeri,CENTRAL,503
NYERI NORTH,Urban,12,447,543,990,Nyeri,CENTRAL,504
NYERI NORTH,Urban,13,407,513,920,Nyeri,CENTRAL,505
NYERI NORTH,Urban,14,386,396,782,Nyeri,CENTRAL,506
NYERI NORTH,Urban,15,287,328,615,Nyeri,CENTRAL,507
NYERI NORTH,Urban,16,265,326,591,Nyeri,CENTRAL,508
NYERI NORTH,Urban,17,284,304,588,Nyeri,CENTRAL,509
NYERI NORTH,Urban,18,296,315,611,Nyeri,CENTRAL,510
NYERI NORTH,Urban,19,247,323,570,Nyeri,CENTRAL,511
NYERI NORTH,Urban,20,357,526,883,Nyeri,CENTRAL,512
NYERI NORTH,Urban,21,278,453,731,Nyeri,CENTRAL,513
NYERI NORTH,Urban,22,399,571,970,Nyeri,CENTRAL,514
NYERI NORTH,Urban,23,375,660,1035,Nyeri,CENTRAL,515
NYERI NORTH,Urban,24,441,603,1044,Nyeri,CENTRAL,516
NYERI NORTH,Urban,25,575,681,1256,Nyeri,CENTRAL,517
NYERI NORTH,Urban,26,457,512,969,Nyeri,CENTRAL,518
NYERI NORTH,Urban,27,481,524,1005,Nyeri,CENTRAL,519
NYERI NORTH,Urban,28,470,543,1013,Nyeri,CENTRAL,520
NYERI NORTH,Urban,29,392,465,857,Nyeri,CENTRAL,521
NYERI NORTH,Urban,30,635,700,1335,Nyeri,CENTRAL,522
NYERI NORTH,Urban,31,302,297,599,Nyeri,CENTRAL,523
NYERI NORTH,Urban,32,415,390,805,Nyeri,CENTRAL,524
NYERI NORTH,Urban,33,254,296,550,Nyeri,CENTRAL,525
NYERI NORTH,Urban,34,325,299,624,Nyeri,CENTRAL,526
NYERI NORTH,Urban,35,513,461,974,Nyeri,CENTRAL,527
NYERI NORTH,Urban,36,282,262,544,Nyeri,CENTRAL,528
NYERI NORTH,Urban,37,228,254,482,Nyeri,CENTRAL,529
NYERI NORTH,Urban,38,269,291,560,Nyeri,CENTRAL,530
NYERI NORTH,Urban,39,234,227,461,Nyeri,CENTRAL,531
NYERI NORTH,Urban,40,371,382,753,Nyeri,CENTRAL,532
NYERI NORTH,Urban,41,157,137,294,Nyeri,CENTRAL,533
NYERI NORTH,Urban,42,182,185,367,Nyeri,CENTRAL,534
NYERI NORTH,Urban,43,141,141,282,Nyeri,CENTRAL,535
NYERI NORTH,Urban,44,147,140,287,Nyeri,CENTRAL,536
NYERI NORTH,Urban,45,234,278,512,Nyeri,CENTRAL,537
NYERI NORTH,Urban,46,128,139,267,Nyeri,CENTRAL,538
NYERI NORTH,Urban,47,124,122,246,Nyeri,CENTRAL,539
NYERI NORTH,Urban,48,134,138,272,Nyeri,CENTRAL,540
NYERI NORTH,Urban,49,122,113,235,Nyeri,CENTRAL,541
NYERI NORTH,Urban,50,168,152,320,Nyeri,CENTRAL,542
NYERI NORTH,Urban,51,55,72,127,Nyeri,CENTRAL,543
NYERI NORTH,Urban,52,99,77,176,Nyeri,CENTRAL,544
NYERI NORTH,Urban,53,50,59,109,Nyeri,CENTRAL,545
NYERI NORTH,Urban,54,49,49,98,Nyeri,CENTRAL,546
NYERI NORTH,Urban,55,77,52,129,Nyeri,CENTRAL,547
NYERI NORTH,Urban,56,64,51,115,Nyeri,CENTRAL,548
NYERI NORTH,Urban,57,61,57,118,Nyeri,CENTRAL,549
NYERI NORTH,Urban,58,40,36,76,Nyeri,CENTRAL,550
NYERI NORTH,Urban,59,44,33,77,Nyeri,CENTRAL,551
NYERI NORTH,Urban,60,75,87,162,Nyeri,CENTRAL,552
NYERI NORTH,Urban,61,33,32,65,Nyeri,CENTRAL,553
NYERI NORTH,Urban,62,36,26,62,Nyeri,CENTRAL,554
NYERI NORTH,Urban,63,26,30,56,Nyeri,CENTRAL,555
NYERI NORTH,Urban,64,26,31,57,Nyeri,CENTRAL,556
NYERI NORTH,Urban,65,37,49,86,Nyeri,CENTRAL,557
NYERI NORTH,Urban,66,16,37,53,Nyeri,CENTRAL,558
NYERI NORTH,Urban,67,16,14,30,Nyeri,CENTRAL,559
NYERI NORTH,Urban,68,18,20,38,Nyeri,CENTRAL,560
NYERI NORTH,Urban,69,19,22,41,Nyeri,CENTRAL,561
NYERI NORTH,Urban,70,20,48,68,Nyeri,CENTRAL,562
NYERI NORTH,Urban,71,9,20,29,Nyeri,CENTRAL,563
NYERI NORTH,Urban,72,11,11,22,Nyeri,CENTRAL,564
NYERI NORTH,Urban,73,15,10,25,Nyeri,CENTRAL,565
NYERI NORTH,Urban,74,6,11,17,Nyeri,CENTRAL,566
NYERI NORTH,Urban,75,18,13,31,Nyeri,CENTRAL,567
NYERI NORTH,Urban,76,8,9,17,Nyeri,CENTRAL,568
NYERI NORTH,Urban,77,6,10,16,Nyeri,CENTRAL,569
NYERI NORTH,Urban,78,10,4,14,Nyeri,CENTRAL,570
NYERI NORTH,Urban,79,7,11,18,Nyeri,CENTRAL,571
NYERI NORTH,Urban,80+,77,125,202,Nyeri,CENTRAL,572
NYERI NORTH,Urban,Age NS,4,3,7,Nyeri,CENTRAL,573
NYERI SOUTH,Urban,0,1620,1514,3134,Nyeri,CENTRAL,574
NYERI SOUTH,Urban,1,1353,1376,2729,Nyeri,CENTRAL,575
NYERI SOUTH,Urban,2,1417,1396,2813,Nyeri,CENTRAL,576
NYERI SOUTH,Urban,3,1445,1348,2793,Nyeri,CENTRAL,577
NYERI SOUTH,Urban,4,1431,1320,2751,Nyeri,CENTRAL,578
NYERI SOUTH,Urban,5,1382,1332,2714,Nyeri,CENTRAL,579
NYERI SOUTH,Urban,6,1221,1293,2514,Nyeri,CENTRAL,580
NYERI SOUTH,Urban,7,1288,1192,2480,Nyeri,CENTRAL,581
NYERI SOUTH,Urban,8,1204,1239,2443,Nyeri,CENTRAL,582
NYERI SOUTH,Urban,9,1313,1264,2577,Nyeri,CENTRAL,583
NYERI SOUTH,Urban,10,1314,1259,2573,Nyeri,CENTRAL,584
NYERI SOUTH,Urban,11,1155,1272,2427,Nyeri,CENTRAL,585
NYERI SOUTH,Urban,12,1289,1432,2721,Nyeri,CENTRAL,586
NYERI SOUTH,Urban,13,1324,1492,2816,Nyeri,CENTRAL,587
NYERI SOUTH,Urban,14,1186,1200,2386,Nyeri,CENTRAL,588
NYERI SOUTH,Urban,15,1136,1072,2208,Nyeri,CENTRAL,589
NYERI SOUTH,Urban,16,1117,1188,2305,Nyeri,CENTRAL,590
NYERI SOUTH,Urban,17,1268,1225,2493,Nyeri,CENTRAL,591
NYERI SOUTH,Urban,18,1275,1260,2535,Nyeri,CENTRAL,592
NYERI SOUTH,Urban,19,1136,1166,2302,Nyeri,CENTRAL,593
NYERI SOUTH,Urban,20,1448,1588,3036,Nyeri,CENTRAL,594
NYERI SOUTH,Urban,21,1217,1360,2577,Nyeri,CENTRAL,595
NYERI SOUTH,Urban,22,1426,1578,3004,Nyeri,CENTRAL,596
NYERI SOUTH,Urban,23,1380,1600,2980,Nyeri,CENTRAL,597
NYERI SOUTH,Urban,24,1283,1673,2956,Nyeri,CENTRAL,598
NYERI SOUTH,Urban,25,1654,1897,3551,Nyeri,CENTRAL,599
NYERI SOUTH,Urban,26,1351,1424,2775,Nyeri,CENTRAL,600
NYERI SOUTH,Urban,27,1460,1408,2868,Nyeri,CENTRAL,601
NYERI SOUTH,Urban,28,1418,1424,2842,Nyeri,CENTRAL,602
NYERI SOUTH,Urban,29,1297,1259,2556,Nyeri,CENTRAL,603
NYERI SOUTH,Urban,30,1882,1741,3623,Nyeri,CENTRAL,604
NYERI SOUTH,Urban,31,1027,856,1883,Nyeri,CENTRAL,605
NYERI SOUTH,Urban,32,1361,1121,2482,Nyeri,CENTRAL,606
NYERI SOUTH,Urban,33,858,848,1706,Nyeri,CENTRAL,607
NYERI SOUTH,Urban,34,1053,929,1982,Nyeri,CENTRAL,608
NYERI SOUTH,Urban,35,1471,1238,2709,Nyeri,CENTRAL,609
NYERI SOUTH,Urban,36,878,766,1644,Nyeri,CENTRAL,610
NYERI SOUTH,Urban,37,854,731,1585,Nyeri,CENTRAL,611
NYERI SOUTH,Urban,38,912,910,1822,Nyeri,CENTRAL,612
NYERI SOUTH,Urban,39,854,739,1593,Nyeri,CENTRAL,613
NYERI SOUTH,Urban,40,1277,1179,2456,Nyeri,CENTRAL,614
NYERI SOUTH,Urban,41,576,583,1159,Nyeri,CENTRAL,615
NYERI SOUTH,Urban,42,821,777,1598,Nyeri,CENTRAL,616
NYERI SOUTH,Urban,43,558,603,1161,Nyeri,CENTRAL,617
NYERI SOUTH,Urban,44,549,511,1060,Nyeri,CENTRAL,618
NYERI SOUTH,Urban,45,983,923,1906,Nyeri,CENTRAL,619
NYERI SOUTH,Urban,46,640,600,1240,Nyeri,CENTRAL,620
NYERI SOUTH,Urban,47,577,551,1128,Nyeri,CENTRAL,621
NYERI SOUTH,Urban,48,570,515,1085,Nyeri,CENTRAL,622
NYERI SOUTH,Urban,49,565,440,1005,Nyeri,CENTRAL,623
NYERI SOUTH,Urban,50,692,651,1343,Nyeri,CENTRAL,624
NYERI SOUTH,Urban,51,371,325,696,Nyeri,CENTRAL,625
NYERI SOUTH,Urban,52,392,337,729,Nyeri,CENTRAL,626
NYERI SOUTH,Urban,53,266,270,536,Nyeri,CENTRAL,627
NYERI SOUTH,Urban,54,243,245,488,Nyeri,CENTRAL,628
NYERI SOUTH,Urban,55,357,378,735,Nyeri,CENTRAL,629
NYERI SOUTH,Urban,56,269,284,553,Nyeri,CENTRAL,630
NYERI SOUTH,Urban,57,322,313,635,Nyeri,CENTRAL,631
NYERI SOUTH,Urban,58,218,233,451,Nyeri,CENTRAL,632
NYERI SOUTH,Urban,59,233,259,492,Nyeri,CENTRAL,633
NYERI SOUTH,Urban,60,470,519,989,Nyeri,CENTRAL,634
NYERI SOUTH,Urban,61,228,172,400,Nyeri,CENTRAL,635
NYERI SOUTH,Urban,62,213,202,415,Nyeri,CENTRAL,636
NYERI SOUTH,Urban,63,190,198,388,Nyeri,CENTRAL,637
NYERI SOUTH,Urban,64,184,189,373,Nyeri,CENTRAL,638
NYERI SOUTH,Urban,65,262,244,506,Nyeri,CENTRAL,639
NYERI SOUTH,Urban,66,176,228,404,Nyeri,CENTRAL,640
NYERI SOUTH,Urban,67,144,144,288,Nyeri,CENTRAL,641
NYERI SOUTH,Urban,68,105,109,214,Nyeri,CENTRAL,642
NYERI SOUTH,Urban,69,108,128,236,Nyeri,CENTRAL,643
NYERI SOUTH,Urban,70,218,334,552,Nyeri,CENTRAL,644
NYERI SOUTH,Urban,71,86,81,167,Nyeri,CENTRAL,645
NYERI SOUTH,Urban,72,94,119,213,Nyeri,CENTRAL,646
NYERI SOUTH,Urban,73,100,114,214,Nyeri,CENTRAL,647
NYERI SOUTH,Urban,74,84,80,164,Nyeri,CENTRAL,648
NYERI SOUTH,Urban,75,106,153,259,Nyeri,CENTRAL,649
NYERI SOUTH,Urban,76,80,103,183,Nyeri,CENTRAL,650
NYERI SOUTH,Urban,77,60,78,138,Nyeri,CENTRAL,651
NYERI SOUTH,Urban,78,59,70,129,Nyeri,CENTRAL,652
NYERI SOUTH,Urban,79,62,101,163,Nyeri,CENTRAL,653
NYERI SOUTH,Urban,80+,550,1001,1551,Nyeri,CENTRAL,654
NYERI SOUTH,Urban,Age NS,31,31,62,Nyeri,CENTRAL,655
KIRINYAGA,Urban,0,1116,1081,2197,Kirinyaga,CENTRAL,656
KIRINYAGA,Urban,1,889,842,1731,Kirinyaga,CENTRAL,657
KIRINYAGA,Urban,2,919,911,1830,Kirinyaga,CENTRAL,658
KIRINYAGA,Urban,3,893,918,1811,Kirinyaga,CENTRAL,659
KIRINYAGA,Urban,4,936,933,1869,Kirinyaga,CENTRAL,660
KIRINYAGA,Urban,5,952,965,1917,Kirinyaga,CENTRAL,661
KIRINYAGA,Urban,6,838,894,1732,Kirinyaga,CENTRAL,662
KIRINYAGA,Urban,7,926,914,1840,Kirinyaga,CENTRAL,663
KIRINYAGA,Urban,8,789,836,1625,Kirinyaga,CENTRAL,664
KIRINYAGA,Urban,9,887,914,1801,Kirinyaga,CENTRAL,665
KIRINYAGA,Urban,10,915,845,1760,Kirinyaga,CENTRAL,666
KIRINYAGA,Urban,11,738,794,1532,Kirinyaga,CENTRAL,667
KIRINYAGA,Urban,12,938,995,1933,Kirinyaga,CENTRAL,668
KIRINYAGA,Urban,13,943,981,1924,Kirinyaga,CENTRAL,669
KIRINYAGA,Urban,14,862,807,1669,Kirinyaga,CENTRAL,670
KIRINYAGA,Urban,15,687,689,1376,Kirinyaga,CENTRAL,671
KIRINYAGA,Urban,16,607,706,1313,Kirinyaga,CENTRAL,672
KIRINYAGA,Urban,17,590,737,1327,Kirinyaga,CENTRAL,673
KIRINYAGA,Urban,18,633,694,1327,Kirinyaga,CENTRAL,674
KIRINYAGA,Urban,19,605,725,1330,Kirinyaga,CENTRAL,675
KIRINYAGA,Urban,20,789,1111,1900,Kirinyaga,CENTRAL,676
KIRINYAGA,Urban,21,645,843,1488,Kirinyaga,CENTRAL,677
KIRINYAGA,Urban,22,797,1101,1898,Kirinyaga,CENTRAL,678
KIRINYAGA,Urban,23,837,1215,2052,Kirinyaga,CENTRAL,679
KIRINYAGA,Urban,24,871,1121,1992,Kirinyaga,CENTRAL,680
KIRINYAGA,Urban,25,1071,1448,2519,Kirinyaga,CENTRAL,681
KIRINYAGA,Urban,26,902,1117,2019,Kirinyaga,CENTRAL,682
KIRINYAGA,Urban,27,953,986,1939,Kirinyaga,CENTRAL,683
KIRINYAGA,Urban,28,868,1174,2042,Kirinyaga,CENTRAL,684
KIRINYAGA,Urban,29,785,869,1654,Kirinyaga,CENTRAL,685
KIRINYAGA,Urban,30,1369,1449,2818,Kirinyaga,CENTRAL,686
KIRINYAGA,Urban,31,643,627,1270,Kirinyaga,CENTRAL,687
KIRINYAGA,Urban,32,869,902,1771,Kirinyaga,CENTRAL,688
KIRINYAGA,Urban,33,554,620,1174,Kirinyaga,CENTRAL,689
KIRINYAGA,Urban,34,615,621,1236,Kirinyaga,CENTRAL,690
KIRINYAGA,Urban,35,1083,1014,2097,Kirinyaga,CENTRAL,691
KIRINYAGA,Urban,36,515,535,1050,Kirinyaga,CENTRAL,692
KIRINYAGA,Urban,37,509,473,982,Kirinyaga,CENTRAL,693
KIRINYAGA,Urban,38,551,578,1129,Kirinyaga,CENTRAL,694
KIRINYAGA,Urban,39,480,463,943,Kirinyaga,CENTRAL,695
KIRINYAGA,Urban,40,863,873,1736,Kirinyaga,CENTRAL,696
KIRINYAGA,Urban,41,388,327,715,Kirinyaga,CENTRAL,697
KIRINYAGA,Urban,42,435,457,892,Kirinyaga,CENTRAL,698
KIRINYAGA,Urban,43,318,382,700,Kirinyaga,CENTRAL,699
KIRINYAGA,Urban,44,314,313,627,Kirinyaga,CENTRAL,700
KIRINYAGA,Urban,45,610,591,1201,Kirinyaga,CENTRAL,701
KIRINYAGA,Urban,46,411,377,788,Kirinyaga,CENTRAL,702
KIRINYAGA,Urban,47,325,274,599,Kirinyaga,CENTRAL,703
KIRINYAGA,Urban,48,318,306,624,Kirinyaga,CENTRAL,704
KIRINYAGA,Urban,49,303,267,570,Kirinyaga,CENTRAL,705
KIRINYAGA,Urban,50,458,465,923,Kirinyaga,CENTRAL,706
KIRINYAGA,Urban,51,202,159,361,Kirinyaga,CENTRAL,707
KIRINYAGA,Urban,52,226,187,413,Kirinyaga,CENTRAL,708
KIRINYAGA,Urban,53,151,117,268,Kirinyaga,CENTRAL,709
KIRINYAGA,Urban,54,155,144,299,Kirinyaga,CENTRAL,710
KIRINYAGA,Urban,55,231,209,440,Kirinyaga,CENTRAL,711
KIRINYAGA,Urban,56,138,122,260,Kirinyaga,CENTRAL,712
KIRINYAGA,Urban,57,162,136,298,Kirinyaga,CENTRAL,713
KIRINYAGA,Urban,58,103,96,199,Kirinyaga,CENTRAL,714
KIRINYAGA,Urban,59,111,90,201,Kirinyaga,CENTRAL,715
KIRINYAGA,Urban,60,198,234,432,Kirinyaga,CENTRAL,716
KIRINYAGA,Urban,61,95,92,187,Kirinyaga,CENTRAL,717
KIRINYAGA,Urban,62,108,65,173,Kirinyaga,CENTRAL,718
KIRINYAGA,Urban,63,80,64,144,Kirinyaga,CENTRAL,719
KIRINYAGA,Urban,64,66,74,140,Kirinyaga,CENTRAL,720
KIRINYAGA,Urban,65,116,132,248,Kirinyaga,CENTRAL,721
KIRINYAGA,Urban,66,44,49,93,Kirinyaga,CENTRAL,722
KIRINYAGA,Urban,67,62,48,110,Kirinyaga,CENTRAL,723
KIRINYAGA,Urban,68,53,39,92,Kirinyaga,CENTRAL,724
KIRINYAGA,Urban,69,54,61,115,Kirinyaga,CENTRAL,725
KIRINYAGA,Urban,70,118,163,281,Kirinyaga,CENTRAL,726
KIRINYAGA,Urban,71,23,39,62,Kirinyaga,CENTRAL,727
KIRINYAGA,Urban,72,42,36,78,Kirinyaga,CENTRAL,728
KIRINYAGA,Urban,73,26,28,54,Kirinyaga,CENTRAL,729
KIRINYAGA,Urban,74,33,38,71,Kirinyaga,CENTRAL,730
KIRINYAGA,Urban,75,45,54,99,Kirinyaga,CENTRAL,731
KIRINYAGA,Urban,76,24,33,57,Kirinyaga,CENTRAL,732
KIRINYAGA,Urban,77,26,24,50,Kirinyaga,CENTRAL,733
KIRINYAGA,Urban,78,20,25,45,Kirinyaga,CENTRAL,734
KIRINYAGA,Urban,79,23,57,80,Kirinyaga,CENTRAL,735
KIRINYAGA,Urban,80+,275,558,833,Kirinyaga,CENTRAL,736
KIRINYAGA,Urban,Age NS,14,15,29,Kirinyaga,CENTRAL,737
MURANGA NORTH,Urban,0,426,386,812,Murang'a,CENTRAL,738
MURANGA NORTH,Urban,1,344,317,661,Murang'a,CENTRAL,739
MURANGA NORTH,Urban,2,368,352,720,Murang'a,CENTRAL,740
MURANGA NORTH,Urban,3,335,314,649,Murang'a,CENTRAL,741
MURANGA NORTH,Urban,4,337,327,664,Murang'a,CENTRAL,742
MURANGA NORTH,Urban,5,331,360,691,Murang'a,CENTRAL,743
MURANGA NORTH,Urban,6,279,289,568,Murang'a,CENTRAL,744
MURANGA NORTH,Urban,7,321,333,654,Murang'a,CENTRAL,745
MURANGA NORTH,Urban,8,283,295,578,Murang'a,CENTRAL,746
MURANGA NORTH,Urban,9,299,320,619,Murang'a,CENTRAL,747
MURANGA NORTH,Urban,10,327,317,644,Murang'a,CENTRAL,748
MURANGA NORTH,Urban,11,286,277,563,Murang'a,CENTRAL,749
MURANGA NORTH,Urban,12,330,319,649,Murang'a,CENTRAL,750
MURANGA NORTH,Urban,13,382,331,713,Murang'a,CENTRAL,751
MURANGA NORTH,Urban,14,295,263,558,Murang'a,CENTRAL,752
MURANGA NORTH,Urban,15,258,246,504,Murang'a,CENTRAL,753
MURANGA NORTH,Urban,16,247,267,514,Murang'a,CENTRAL,754
MURANGA NORTH,Urban,17,282,319,601,Murang'a,CENTRAL,755
MURANGA NORTH,Urban,18,279,322,601,Murang'a,CENTRAL,756
MURANGA NORTH,Urban,19,259,342,601,Murang'a,CENTRAL,757
MURANGA NORTH,Urban,20,315,499,814,Murang'a,CENTRAL,758
MURANGA NORTH,Urban,21,293,403,696,Murang'a,CENTRAL,759
MURANGA NORTH,Urban,22,340,444,784,Murang'a,CENTRAL,760
MURANGA NORTH,Urban,23,333,452,785,Murang'a,CENTRAL,761
MURANGA NORTH,Urban,24,335,459,794,Murang'a,CENTRAL,762
MURANGA NORTH,Urban,25,452,534,986,Murang'a,CENTRAL,763
MURANGA NORTH,Urban,26,343,406,749,Murang'a,CENTRAL,764
MURANGA NORTH,Urban,27,375,413,788,Murang'a,CENTRAL,765
MURANGA NORTH,Urban,28,364,404,768,Murang'a,CENTRAL,766
MURANGA NORTH,Urban,29,284,342,626,Murang'a,CENTRAL,767
MURANGA NORTH,Urban,30,488,476,964,Murang'a,CENTRAL,768
MURANGA NORTH,Urban,31,247,238,485,Murang'a,CENTRAL,769
MURANGA NORTH,Urban,32,315,318,633,Murang'a,CENTRAL,770
MURANGA NORTH,Urban,33,200,195,395,Murang'a,CENTRAL,771
MURANGA NORTH,Urban,34,237,241,478,Murang'a,CENTRAL,772
MURANGA NORTH,Urban,35,369,349,718,Murang'a,CENTRAL,773
MURANGA NORTH,Urban,36,207,233,440,Murang'a,CENTRAL,774
MURANGA NORTH,Urban,37,196,175,371,Murang'a,CENTRAL,775
MURANGA NORTH,Urban,38,225,255,480,Murang'a,CENTRAL,776
MURANGA NORTH,Urban,39,190,192,382,Murang'a,CENTRAL,777
MURANGA NORTH,Urban,40,308,274,582,Murang'a,CENTRAL,778
MURANGA NORTH,Urban,41,140,126,266,Murang'a,CENTRAL,779
MURANGA NORTH,Urban,42,186,177,363,Murang'a,CENTRAL,780
MURANGA NORTH,Urban,43,127,141,268,Murang'a,CENTRAL,781
MURANGA NORTH,Urban,44,129,120,249,Murang'a,CENTRAL,782
MURANGA NORTH,Urban,45,238,231,469,Murang'a,CENTRAL,783
MURANGA NORTH,Urban,46,159,139,298,Murang'a,CENTRAL,784
MURANGA NORTH,Urban,47,126,119,245,Murang'a,CENTRAL,785
MURANGA NORTH,Urban,48,121,122,243,Murang'a,CENTRAL,786
MURANGA NORTH,Urban,49,110,110,220,Murang'a,CENTRAL,787
MURANGA NORTH,Urban,50,176,154,330,Murang'a,CENTRAL,788
MURANGA NORTH,Urban,51,97,68,165,Murang'a,CENTRAL,789
MURANGA NORTH,Urban,52,89,82,171,Murang'a,CENTRAL,790
MURANGA NORTH,Urban,53,77,58,135,Murang'a,CENTRAL,791
MURANGA NORTH,Urban,54,61,69,130,Murang'a,CENTRAL,792
MURANGA NORTH,Urban,55,90,80,170,Murang'a,CENTRAL,793
MURANGA NORTH,Urban,56,65,52,117,Murang'a,CENTRAL,794
MURANGA NORTH,Urban,57,74,63,137,Murang'a,CENTRAL,795
MURANGA NORTH,Urban,58,44,44,88,Murang'a,CENTRAL,796
MURANGA NORTH,Urban,59,49,46,95,Murang'a,CENTRAL,797
MURANGA NORTH,Urban,60,75,96,171,Murang'a,CENTRAL,798
MURANGA NORTH,Urban,61,46,48,94,Murang'a,CENTRAL,799
MURANGA NORTH,Urban,62,43,38,81,Murang'a,CENTRAL,800
MURANGA NORTH,Urban,63,42,36,78,Murang'a,CENTRAL,801
MURANGA NORTH,Urban,64,31,26,57,Murang'a,CENTRAL,802
MURANGA NORTH,Urban,65,45,53,98,Murang'a,CENTRAL,803
MURANGA NORTH,Urban,66,26,22,48,Murang'a,CENTRAL,804
MURANGA NORTH,Urban,67,29,19,48,Murang'a,CENTRAL,805
MURANGA NORTH,Urban,68,12,23,35,Murang'a,CENTRAL,806
MURANGA NORTH,Urban,69,24,23,47,Murang'a,CENTRAL,807
MURANGA NORTH,Urban,70,31,60,91,Murang'a,CENTRAL,808
MURANGA NORTH,Urban,71,10,20,30,Murang'a,CENTRAL,809
MURANGA NORTH,Urban,72,13,22,35,Murang'a,CENTRAL,810
MURANGA NORTH,Urban,73,18,16,34,Murang'a,CENTRAL,811
MURANGA NORTH,Urban,74,15,15,30,Murang'a,CENTRAL,812
MURANGA NORTH,Urban,75,15,15,30,Murang'a,CENTRAL,813
MURANGA NORTH,Urban,76,16,18,34,Murang'a,CENTRAL,814
MURANGA NORTH,Urban,77,13,13,26,Murang'a,CENTRAL,815
MURANGA NORTH,Urban,78,9,13,22,Murang'a,CENTRAL,816
MURANGA NORTH,Urban,79,10,9,19,Murang'a,CENTRAL,817
MURANGA NORTH,Urban,80+,107,187,294,Murang'a,CENTRAL,818
MURANGA NORTH,Urban,Age NS,17,15,32,Murang'a,CENTRAL,819
MURANGA SOUTH,Urban,0,1387,1457,2844,Murang'a,CENTRAL,820
MURANGA SOUTH,Urban,1,1268,1285,2553,Murang'a,CENTRAL,821
MURANGA SOUTH,Urban,2,1365,1347,2712,Murang'a,CENTRAL,822
MURANGA SOUTH,Urban,3,1382,1392,2774,Murang'a,CENTRAL,823
MURANGA SOUTH,Urban,4,1518,1413,2931,Murang'a,CENTRAL,824
MURANGA SOUTH,Urban,5,1513,1505,3018,Murang'a,CENTRAL,825
MURANGA SOUTH,Urban,6,1405,1438,2843,Murang'a,CENTRAL,826
MURANGA SOUTH,Urban,7,1446,1425,2871,Murang'a,CENTRAL,827
MURANGA SOUTH,Urban,8,1403,1347,2750,Murang'a,CENTRAL,828
MURANGA SOUTH,Urban,9,1541,1573,3114,Murang'a,CENTRAL,829
MURANGA SOUTH,Urban,10,1559,1456,3015,Murang'a,CENTRAL,830
MURANGA SOUTH,Urban,11,1261,1282,2543,Murang'a,CENTRAL,831
MURANGA SOUTH,Urban,12,1479,1473,2952,Murang'a,CENTRAL,832
MURANGA SOUTH,Urban,13,1520,1554,3074,Murang'a,CENTRAL,833
MURANGA SOUTH,Urban,14,1311,1339,2650,Murang'a,CENTRAL,834
MURANGA SOUTH,Urban,15,1240,1242,2482,Murang'a,CENTRAL,835
MURANGA SOUTH,Urban,16,1092,1093,2185,Murang'a,CENTRAL,836
MURANGA SOUTH,Urban,17,1240,1129,2369,Murang'a,CENTRAL,837
MURANGA SOUTH,Urban,18,1159,1075,2234,Murang'a,CENTRAL,838
MURANGA SOUTH,Urban,19,1103,918,2021,Murang'a,CENTRAL,839
MURANGA SOUTH,Urban,20,1069,1089,2158,Murang'a,CENTRAL,840
MURANGA SOUTH,Urban,21,873,838,1711,Murang'a,CENTRAL,841
MURANGA SOUTH,Urban,22,906,1016,1922,Murang'a,CENTRAL,842
MURANGA SOUTH,Urban,23,841,933,1774,Murang'a,CENTRAL,843
MURANGA SOUTH,Urban,24,771,950,1721,Murang'a,CENTRAL,844
MURANGA SOUTH,Urban,25,1020,1144,2164,Murang'a,CENTRAL,845
MURANGA SOUTH,Urban,26,735,910,1645,Murang'a,CENTRAL,846
MURANGA SOUTH,Urban,27,727,876,1603,Murang'a,CENTRAL,847
MURANGA SOUTH,Urban,28,795,923,1718,Murang'a,CENTRAL,848
MURANGA SOUTH,Urban,29,705,815,1520,Murang'a,CENTRAL,849
MURANGA SOUTH,Urban,30,1104,1189,2293,Murang'a,CENTRAL,850
MURANGA SOUTH,Urban,31,601,629,1230,Murang'a,CENTRAL,851
MURANGA SOUTH,Urban,32,803,799,1602,Murang'a,CENTRAL,852
MURANGA SOUTH,Urban,33,515,605,1120,Murang'a,CENTRAL,853
MURANGA SOUTH,Urban,34,588,680,1268,Murang'a,CENTRAL,854
MURANGA SOUTH,Urban,35,973,1045,2018,Murang'a,CENTRAL,855
MURANGA SOUTH,Urban,36,543,652,1195,Murang'a,CENTRAL,856
MURANGA SOUTH,Urban,37,605,574,1179,Murang'a,CENTRAL,857
MURANGA SOUTH,Urban,38,603,698,1301,Murang'a,CENTRAL,858
MURANGA SOUTH,Urban,39,480,556,1036,Murang'a,CENTRAL,859
MURANGA SOUTH,Urban,40,884,955,1839,Murang'a,CENTRAL,860
MURANGA SOUTH,Urban,41,427,375,802,Murang'a,CENTRAL,861
MURANGA SOUTH,Urban,42,503,554,1057,Murang'a,CENTRAL,862
MURANGA SOUTH,Urban,43,398,482,880,Murang'a,CENTRAL,863
MURANGA SOUTH,Urban,44,386,374,760,Murang'a,CENTRAL,864
MURANGA SOUTH,Urban,45,704,826,1530,Murang'a,CENTRAL,865
MURANGA SOUTH,Urban,46,463,497,960,Murang'a,CENTRAL,866
MURANGA SOUTH,Urban,47,389,425,814,Murang'a,CENTRAL,867
MURANGA SOUTH,Urban,48,338,423,761,Murang'a,CENTRAL,868
MURANGA SOUTH,Urban,49,362,404,766,Murang'a,CENTRAL,869
MURANGA SOUTH,Urban,50,559,739,1298,Murang'a,CENTRAL,870
MURANGA SOUTH,Urban,51,302,273,575,Murang'a,CENTRAL,871
MURANGA SOUTH,Urban,52,349,291,640,Murang'a,CENTRAL,872
MURANGA SOUTH,Urban,53,238,234,472,Murang'a,CENTRAL,873
MURANGA SOUTH,Urban,54,238,237,475,Murang'a,CENTRAL,874
MURANGA SOUTH,Urban,55,355,453,808,Murang'a,CENTRAL,875
MURANGA SOUTH,Urban,56,240,286,526,Murang'a,CENTRAL,876
MURANGA SOUTH,Urban,57,330,370,700,Murang'a,CENTRAL,877
MURANGA SOUTH,Urban,58,181,209,390,Murang'a,CENTRAL,878
MURANGA SOUTH,Urban,59,226,251,477,Murang'a,CENTRAL,879
MURANGA SOUTH,Urban,60,443,534,977,Murang'a,CENTRAL,880
MURANGA SOUTH,Urban,61,228,228,456,Murang'a,CENTRAL,881
MURANGA SOUTH,Urban,62,218,214,432,Murang'a,CENTRAL,882
MURANGA SOUTH,Urban,63,204,196,400,Murang'a,CENTRAL,883
MURANGA SOUTH,Urban,64,192,186,378,Murang'a,CENTRAL,884
MURANGA SOUTH,Urban,65,251,291,542,Murang'a,CENTRAL,885
MURANGA SOUTH,Urban,66,195,275,470,Murang'a,CENTRAL,886
MURANGA SOUTH,Urban,67,175,152,327,Murang'a,CENTRAL,887
MURANGA SOUTH,Urban,68,119,146,265,Murang'a,CENTRAL,888
MURANGA SOUTH,Urban,69,127,140,267,Murang'a,CENTRAL,889
MURANGA SOUTH,Urban,70,277,344,621,Murang'a,CENTRAL,890
MURANGA SOUTH,Urban,71,94,102,196,Murang'a,CENTRAL,891
MURANGA SOUTH,Urban,72,108,91,199,Murang'a,CENTRAL,892
MURANGA SOUTH,Urban,73,117,120,237,Murang'a,CENTRAL,893
MURANGA SOUTH,Urban,74,131,118,249,Murang'a,CENTRAL,894
MURANGA SOUTH,Urban,75,98,160,258,Murang'a,CENTRAL,895
MURANGA SOUTH,Urban,76,70,100,170,Murang'a,CENTRAL,896
MURANGA SOUTH,Urban,77,78,70,148,Murang'a,CENTRAL,897
MURANGA SOUTH,Urban,78,60,79,139,Murang'a,CENTRAL,898
MURANGA SOUTH,Urban,79,68,129,197,Murang'a,CENTRAL,899
MURANGA SOUTH,Urban,80+,638,1139,1777,Murang'a,CENTRAL,900
MURANGA SOUTH,Urban,Age NS,28,15,43,Murang'a,CENTRAL,901
KIAMBU EAST(KIAMBAA),Urban,0,3056,3061,6117,Kiambu,CENTRAL,902
KIAMBU EAST(KIAMBAA),Urban,1,2462,2476,4938,Kiambu,CENTRAL,903
KIAMBU EAST(KIAMBAA),Urban,2,2606,2634,5240,Kiambu,CENTRAL,904
KIAMBU EAST(KIAMBAA),Urban,3,2440,2532,4972,Kiambu,CENTRAL,905
KIAMBU EAST(KIAMBAA),Urban,4,2508,2479,4987,Kiambu,CENTRAL,906
KIAMBU EAST(KIAMBAA),Urban,5,2408,2290,4698,Kiambu,CENTRAL,907
KIAMBU EAST(KIAMBAA),Urban,6,2198,2186,4384,Kiambu,CENTRAL,908
KIAMBU EAST(KIAMBAA),Urban,7,2031,2019,4050,Kiambu,CENTRAL,909
KIAMBU EAST(KIAMBAA),Urban,8,1907,2080,3987,Kiambu,CENTRAL,910
KIAMBU EAST(KIAMBAA),Urban,9,2142,2095,4237,Kiambu,CENTRAL,911
KIAMBU EAST(KIAMBAA),Urban,10,2012,2100,4112,Kiambu,CENTRAL,912
KIAMBU EAST(KIAMBAA),Urban,11,1767,1856,3623,Kiambu,CENTRAL,913
KIAMBU EAST(KIAMBAA),Urban,12,1979,2016,3995,Kiambu,CENTRAL,914
KIAMBU EAST(KIAMBAA),Urban,13,1877,2023,3900,Kiambu,CENTRAL,915
KIAMBU EAST(KIAMBAA),Urban,14,1691,1777,3468,Kiambu,CENTRAL,916
KIAMBU EAST(KIAMBAA),Urban,15,1578,1718,3296,Kiambu,CENTRAL,917
KIAMBU EAST(KIAMBAA),Urban,16,1526,1930,3456,Kiambu,CENTRAL,918
KIAMBU EAST(KIAMBAA),Urban,17,1743,1992,3735,Kiambu,CENTRAL,919
KIAMBU EAST(KIAMBAA),Urban,18,1709,2025,3734,Kiambu,CENTRAL,920
KIAMBU EAST(KIAMBAA),Urban,19,1715,2139,3854,Kiambu,CENTRAL,921
KIAMBU EAST(KIAMBAA),Urban,20,2061,2880,4941,Kiambu,CENTRAL,922
KIAMBU EAST(KIAMBAA),Urban,21,1845,2381,4226,Kiambu,CENTRAL,923
KIAMBU EAST(KIAMBAA),Urban,22,2313,2860,5173,Kiambu,CENTRAL,924
KIAMBU EAST(KIAMBAA),Urban,23,2385,2972,5357,Kiambu,CENTRAL,925
KIAMBU EAST(KIAMBAA),Urban,24,2393,2876,5269,Kiambu,CENTRAL,926
KIAMBU EAST(KIAMBAA),Urban,25,2999,3390,6389,Kiambu,CENTRAL,927
KIAMBU EAST(KIAMBAA),Urban,26,2358,2662,5020,Kiambu,CENTRAL,928
KIAMBU EAST(KIAMBAA),Urban,27,2569,2622,5191,Kiambu,CENTRAL,929
KIAMBU EAST(KIAMBAA),Urban,28,2498,2621,5119,Kiambu,CENTRAL,930
KIAMBU EAST(KIAMBAA),Urban,29,2288,2290,4578,Kiambu,CENTRAL,931
KIAMBU EAST(KIAMBAA),Urban,30,3299,3114,6413,Kiambu,CENTRAL,932
KIAMBU EAST(KIAMBAA),Urban,31,1825,1612,3437,Kiambu,CENTRAL,933
KIAMBU EAST(KIAMBAA),Urban,32,2252,2032,4284,Kiambu,CENTRAL,934
KIAMBU EAST(KIAMBAA),Urban,33,1608,1492,3100,Kiambu,CENTRAL,935
KIAMBU EAST(KIAMBAA),Urban,34,1826,1576,3402,Kiambu,CENTRAL,936
KIAMBU EAST(KIAMBAA),Urban,35,2511,2107,4618,Kiambu,CENTRAL,937
KIAMBU EAST(KIAMBAA),Urban,36,1547,1359,2906,Kiambu,CENTRAL,938
KIAMBU EAST(KIAMBAA),Urban,37,1525,1225,2750,Kiambu,CENTRAL,939
KIAMBU EAST(KIAMBAA),Urban,38,1554,1316,2870,Kiambu,CENTRAL,940
KIAMBU EAST(KIAMBAA),Urban,39,1353,1098,2451,Kiambu,CENTRAL,941
KIAMBU EAST(KIAMBAA),Urban,40,2052,1679,3731,Kiambu,CENTRAL,942
KIAMBU EAST(KIAMBAA),Urban,41,927,737,1664,Kiambu,CENTRAL,943
KIAMBU EAST(KIAMBAA),Urban,42,1172,975,2147,Kiambu,CENTRAL,944
KIAMBU EAST(KIAMBAA),Urban,43,894,791,1685,Kiambu,CENTRAL,945
KIAMBU EAST(KIAMBAA),Urban,44,791,704,1495,Kiambu,CENTRAL,946
KIAMBU EAST(KIAMBAA),Urban,45,1381,1141,2522,Kiambu,CENTRAL,947
KIAMBU EAST(KIAMBAA),Urban,46,873,740,1613,Kiambu,CENTRAL,948
KIAMBU EAST(KIAMBAA),Urban,47,762,637,1399,Kiambu,CENTRAL,949
KIAMBU EAST(KIAMBAA),Urban,48,650,608,1258,Kiambu,CENTRAL,950
KIAMBU EAST(KIAMBAA),Urban,49,638,558,1196,Kiambu,CENTRAL,951
KIAMBU EAST(KIAMBAA),Urban,50,868,866,1734,Kiambu,CENTRAL,952
KIAMBU EAST(KIAMBAA),Urban,51,489,384,873,Kiambu,CENTRAL,953
KIAMBU EAST(KIAMBAA),Urban,52,512,446,958,Kiambu,CENTRAL,954
KIAMBU EAST(KIAMBAA),Urban,53,353,321,674,Kiambu,CENTRAL,955
KIAMBU EAST(KIAMBAA),Urban,54,371,302,673,Kiambu,CENTRAL,956
KIAMBU EAST(KIAMBAA),Urban,55,519,510,1029,Kiambu,CENTRAL,957
KIAMBU EAST(KIAMBAA),Urban,56,368,326,694,Kiambu,CENTRAL,958
KIAMBU EAST(KIAMBAA),Urban,57,448,392,840,Kiambu,CENTRAL,959
KIAMBU EAST(KIAMBAA),Urban,58,289,242,531,Kiambu,CENTRAL,960
KIAMBU EAST(KIAMBAA),Urban,59,307,281,588,Kiambu,CENTRAL,961
KIAMBU EAST(KIAMBAA),Urban,60,491,563,1054,Kiambu,CENTRAL,962
KIAMBU EAST(KIAMBAA),Urban,61,270,267,537,Kiambu,CENTRAL,963
KIAMBU EAST(KIAMBAA),Urban,62,261,227,488,Kiambu,CENTRAL,964
KIAMBU EAST(KIAMBAA),Urban,63,243,190,433,Kiambu,CENTRAL,965
KIAMBU EAST(KIAMBAA),Urban,64,209,224,433,Kiambu,CENTRAL,966
KIAMBU EAST(KIAMBAA),Urban,65,273,299,572,Kiambu,CENTRAL,967
KIAMBU EAST(KIAMBAA),Urban,66,180,274,454,Kiambu,CENTRAL,968
KIAMBU EAST(KIAMBAA),Urban,67,158,195,353,Kiambu,CENTRAL,969
KIAMBU EAST(KIAMBAA),Urban,68,126,125,251,Kiambu,CENTRAL,970
KIAMBU EAST(KIAMBAA),Urban,69,124,163,287,Kiambu,CENTRAL,971
KIAMBU EAST(KIAMBAA),Urban,70,243,366,609,Kiambu,CENTRAL,972
KIAMBU EAST(KIAMBAA),Urban,71,78,112,190,Kiambu,CENTRAL,973
KIAMBU EAST(KIAMBAA),Urban,72,121,120,241,Kiambu,CENTRAL,974
KIAMBU EAST(KIAMBAA),Urban,73,100,111,211,Kiambu,CENTRAL,975
KIAMBU EAST(KIAMBAA),Urban,74,82,111,193,Kiambu,CENTRAL,976
KIAMBU EAST(KIAMBAA),Urban,75,115,186,301,Kiambu,CENTRAL,977
KIAMBU EAST(KIAMBAA),Urban,76,77,92,169,Kiambu,CENTRAL,978
KIAMBU EAST(KIAMBAA),Urban,77,66,92,158,Kiambu,CENTRAL,979
KIAMBU EAST(KIAMBAA),Urban,78,62,85,147,Kiambu,CENTRAL,980
KIAMBU EAST(KIAMBAA),Urban,79,50,105,155,Kiambu,CENTRAL,981
KIAMBU EAST(KIAMBAA),Urban,80+,573,1111,1684,Kiambu,CENTRAL,982
KIAMBU EAST(KIAMBAA),Urban,Age NS,98,78,176,Kiambu,CENTRAL,983
KIKUYU,Urban,0,3642,3651,7293,Kiambu,CENTRAL,984
KIKUYU,Urban,1,3214,3026,6240,Kiambu,CENTRAL,985
KIKUYU,Urban,2,3170,3212,6382,Kiambu,CENTRAL,986
KIKUYU,Urban,3,3383,3157,6540,Kiambu,CENTRAL,987
KIKUYU,Urban,4,3240,3165,6405,Kiambu,CENTRAL,988
KIKUYU,Urban,5,3129,3014,6143,Kiambu,CENTRAL,989
KIKUYU,Urban,6,2892,2881,5773,Kiambu,CENTRAL,990
KIKUYU,Urban,7,2658,2807,5465,Kiambu,CENTRAL,991
KIKUYU,Urban,8,2534,2621,5155,Kiambu,CENTRAL,992
KIKUYU,Urban,9,2988,2952,5940,Kiambu,CENTRAL,993
KIKUYU,Urban,10,2658,2728,5386,Kiambu,CENTRAL,994
KIKUYU,Urban,11,2325,2423,4748,Kiambu,CENTRAL,995
KIKUYU,Urban,12,2706,2681,5387,Kiambu,CENTRAL,996
KIKUYU,Urban,13,2561,2804,5365,Kiambu,CENTRAL,997
KIKUYU,Urban,14,2383,2303,4686,Kiambu,CENTRAL,998
KIKUYU,Urban,15,2136,2316,4452,Kiambu,CENTRAL,999
KIKUYU,Urban,16,2143,2434,4577,Kiambu,CENTRAL,1000
KIKUYU,Urban,17,2467,2630,5097,Kiambu,CENTRAL,1001
KIKUYU,Urban,18,2297,2563,4860,Kiambu,CENTRAL,1002
KIKUYU,Urban,19,2225,2716,4941,Kiambu,CENTRAL,1003
KIKUYU,Urban,20,2657,3468,6125,Kiambu,CENTRAL,1004
KIKUYU,Urban,21,2294,2976,5270,Kiambu,CENTRAL,1005
KIKUYU,Urban,22,2641,3471,6112,Kiambu,CENTRAL,1006
KIKUYU,Urban,23,2803,3426,6229,Kiambu,CENTRAL,1007
KIKUYU,Urban,24,2846,3361,6207,Kiambu,CENTRAL,1008
KIKUYU,Urban,25,3213,3892,7105,Kiambu,CENTRAL,1009
KIKUYU,Urban,26,2695,3130,5825,Kiambu,CENTRAL,1010
KIKUYU,Urban,27,3082,3072,6154,Kiambu,CENTRAL,1011
KIKUYU,Urban,28,2816,3072,5888,Kiambu,CENTRAL,1012
KIKUYU,Urban,29,2646,2656,5302,Kiambu,CENTRAL,1013
KIKUYU,Urban,30,3598,3713,7311,Kiambu,CENTRAL,1014
KIKUYU,Urban,31,2189,1999,4188,Kiambu,CENTRAL,1015
KIKUYU,Urban,32,2516,2514,5030,Kiambu,CENTRAL,1016
KIKUYU,Urban,33,1853,1822,3675,Kiambu,CENTRAL,1017
KIKUYU,Urban,34,2076,1932,4008,Kiambu,CENTRAL,1018
KIKUYU,Urban,35,2843,2529,5372,Kiambu,CENTRAL,1019
KIKUYU,Urban,36,1730,1763,3493,Kiambu,CENTRAL,1020
KIKUYU,Urban,37,1753,1555,3308,Kiambu,CENTRAL,1021
KIKUYU,Urban,38,1792,1768,3560,Kiambu,CENTRAL,1022
KIKUYU,Urban,39,1736,1520,3256,Kiambu,CENTRAL,1023
KIKUYU,Urban,40,2316,2250,4566,Kiambu,CENTRAL,1024
KIKUYU,Urban,41,1174,1111,2285,Kiambu,CENTRAL,1025
KIKUYU,Urban,42,1472,1373,2845,Kiambu,CENTRAL,1026
KIKUYU,Urban,43,1197,1152,2349,Kiambu,CENTRAL,1027
KIKUYU,Urban,44,1041,971,2012,Kiambu,CENTRAL,1028
KIKUYU,Urban,45,1675,1432,3107,Kiambu,CENTRAL,1029
KIKUYU,Urban,46,1267,1043,2310,Kiambu,CENTRAL,1030
KIKUYU,Urban,47,950,942,1892,Kiambu,CENTRAL,1031
KIKUYU,Urban,48,917,889,1806,Kiambu,CENTRAL,1032
KIKUYU,Urban,49,912,818,1730,Kiambu,CENTRAL,1033
KIKUYU,Urban,50,1177,1198,2375,Kiambu,CENTRAL,1034
KIKUYU,Urban,51,703,605,1308,Kiambu,CENTRAL,1035
KIKUYU,Urban,52,667,601,1268,Kiambu,CENTRAL,1036
KIKUYU,Urban,53,543,463,1006,Kiambu,CENTRAL,1037
KIKUYU,Urban,54,509,483,992,Kiambu,CENTRAL,1038
KIKUYU,Urban,55,696,674,1370,Kiambu,CENTRAL,1039
KIKUYU,Urban,56,494,493,987,Kiambu,CENTRAL,1040
KIKUYU,Urban,57,665,601,1266,Kiambu,CENTRAL,1041
KIKUYU,Urban,58,380,356,736,Kiambu,CENTRAL,1042
KIKUYU,Urban,59,490,455,945,Kiambu,CENTRAL,1043
KIKUYU,Urban,60,671,806,1477,Kiambu,CENTRAL,1044
KIKUYU,Urban,61,408,369,777,Kiambu,CENTRAL,1045
KIKUYU,Urban,62,423,361,784,Kiambu,CENTRAL,1046
KIKUYU,Urban,63,390,324,714,Kiambu,CENTRAL,1047
KIKUYU,Urban,64,342,350,692,Kiambu,CENTRAL,1048
KIKUYU,Urban,65,397,474,871,Kiambu,CENTRAL,1049
KIKUYU,Urban,66,297,362,659,Kiambu,CENTRAL,1050
KIKUYU,Urban,67,311,304,615,Kiambu,CENTRAL,1051
KIKUYU,Urban,68,183,200,383,Kiambu,CENTRAL,1052
KIKUYU,Urban,69,203,233,436,Kiambu,CENTRAL,1053
KIKUYU,Urban,70,370,507,877,Kiambu,CENTRAL,1054
KIKUYU,Urban,71,160,140,300,Kiambu,CENTRAL,1055
KIKUYU,Urban,72,185,170,355,Kiambu,CENTRAL,1056
KIKUYU,Urban,73,148,176,324,Kiambu,CENTRAL,1057
KIKUYU,Urban,74,138,175,313,Kiambu,CENTRAL,1058
KIKUYU,Urban,75,167,280,447,Kiambu,CENTRAL,1059
KIKUYU,Urban,76,123,151,274,Kiambu,CENTRAL,1060
KIKUYU,Urban,77,98,102,200,Kiambu,CENTRAL,1061
KIKUYU,Urban,78,91,132,223,Kiambu,CENTRAL,1062
KIKUYU,Urban,79,108,170,278,Kiambu,CENTRAL,1063
KIKUYU,Urban,80+,871,1575,2446,Kiambu,CENTRAL,1064
KIKUYU,Urban,Age NS,87,67,154,Kiambu,CENTRAL,1065
KIAMBU WEST,Urban,0,1095,1101,2196,Kiambu,CENTRAL,1066
KIAMBU WEST,Urban,1,974,1030,2004,Kiambu,CENTRAL,1067
KIAMBU WEST,Urban,2,1053,1063,2116,Kiambu,CENTRAL,1068
KIAMBU WEST,Urban,3,1123,1054,2177,Kiambu,CENTRAL,1069
KIAMBU WEST,Urban,4,1015,1063,2078,Kiambu,CENTRAL,1070
KIAMBU WEST,Urban,5,1098,1041,2139,Kiambu,CENTRAL,1071
KIAMBU WEST,Urban,6,969,954,1923,Kiambu,CENTRAL,1072
KIAMBU WEST,Urban,7,928,948,1876,Kiambu,CENTRAL,1073
KIAMBU WEST,Urban,8,910,913,1823,Kiambu,CENTRAL,1074
KIAMBU WEST,Urban,9,982,1021,2003,Kiambu,CENTRAL,1075
KIAMBU WEST,Urban,10,1022,965,1987,Kiambu,CENTRAL,1076
KIAMBU WEST,Urban,11,794,822,1616,Kiambu,CENTRAL,1077
KIAMBU WEST,Urban,12,930,945,1875,Kiambu,CENTRAL,1078
KIAMBU WEST,Urban,13,942,910,1852,Kiambu,CENTRAL,1079
KIAMBU WEST,Urban,14,725,817,1542,Kiambu,CENTRAL,1080
KIAMBU WEST,Urban,15,691,694,1385,Kiambu,CENTRAL,1081
KIAMBU WEST,Urban,16,699,821,1520,Kiambu,CENTRAL,1082
KIAMBU WEST,Urban,17,778,726,1504,Kiambu,CENTRAL,1083
KIAMBU WEST,Urban,18,686,863,1549,Kiambu,CENTRAL,1084
KIAMBU WEST,Urban,19,657,737,1394,Kiambu,CENTRAL,1085
KIAMBU WEST,Urban,20,844,965,1809,Kiambu,CENTRAL,1086
KIAMBU WEST,Urban,21,691,774,1465,Kiambu,CENTRAL,1087
KIAMBU WEST,Urban,22,759,934,1693,Kiambu,CENTRAL,1088
KIAMBU WEST,Urban,23,764,917,1681,Kiambu,CENTRAL,1089
KIAMBU WEST,Urban,24,810,878,1688,Kiambu,CENTRAL,1090
KIAMBU WEST,Urban,25,995,1015,2010,Kiambu,CENTRAL,1091
KIAMBU WEST,Urban,26,724,815,1539,Kiambu,CENTRAL,1092
KIAMBU WEST,Urban,27,768,819,1587,Kiambu,CENTRAL,1093
KIAMBU WEST,Urban,28,761,814,1575,Kiambu,CENTRAL,1094
KIAMBU WEST,Urban,29,689,719,1408,Kiambu,CENTRAL,1095
KIAMBU WEST,Urban,30,984,1036,2020,Kiambu,CENTRAL,1096
KIAMBU WEST,Urban,31,613,530,1143,Kiambu,CENTRAL,1097
KIAMBU WEST,Urban,32,799,748,1547,Kiambu,CENTRAL,1098
KIAMBU WEST,Urban,33,517,489,1006,Kiambu,CENTRAL,1099
KIAMBU WEST,Urban,34,549,527,1076,Kiambu,CENTRAL,1100
KIAMBU WEST,Urban,35,912,782,1694,Kiambu,CENTRAL,1101
KIAMBU WEST,Urban,36,539,480,1019,Kiambu,CENTRAL,1102
KIAMBU WEST,Urban,37,545,469,1014,Kiambu,CENTRAL,1103
KIAMBU WEST,Urban,38,558,527,1085,Kiambu,CENTRAL,1104
KIAMBU WEST,Urban,39,448,465,913,Kiambu,CENTRAL,1105
KIAMBU WEST,Urban,40,658,623,1281,Kiambu,CENTRAL,1106
KIAMBU WEST,Urban,41,366,273,639,Kiambu,CENTRAL,1107
KIAMBU WEST,Urban,42,455,345,800,Kiambu,CENTRAL,1108
KIAMBU WEST,Urban,43,304,300,604,Kiambu,CENTRAL,1109
KIAMBU WEST,Urban,44,267,239,506,Kiambu,CENTRAL,1110
KIAMBU WEST,Urban,45,505,483,988,Kiambu,CENTRAL,1111
KIAMBU WEST,Urban,46,334,319,653,Kiambu,CENTRAL,1112
KIAMBU WEST,Urban,47,295,258,553,Kiambu,CENTRAL,1113
KIAMBU WEST,Urban,48,269,242,511,Kiambu,CENTRAL,1114
KIAMBU WEST,Urban,49,286,247,533,Kiambu,CENTRAL,1115
KIAMBU WEST,Urban,50,388,382,770,Kiambu,CENTRAL,1116
KIAMBU WEST,Urban,51,239,182,421,Kiambu,CENTRAL,1117
KIAMBU WEST,Urban,52,202,155,357,Kiambu,CENTRAL,1118
KIAMBU WEST,Urban,53,174,128,302,Kiambu,CENTRAL,1119
KIAMBU WEST,Urban,54,147,122,269,Kiambu,CENTRAL,1120
KIAMBU WEST,Urban,55,221,224,445,Kiambu,CENTRAL,1121
KIAMBU WEST,Urban,56,126,151,277,Kiambu,CENTRAL,1122
KIAMBU WEST,Urban,57,161,177,338,Kiambu,CENTRAL,1123
KIAMBU WEST,Urban,58,99,98,197,Kiambu,CENTRAL,1124
KIAMBU WEST,Urban,59,142,130,272,Kiambu,CENTRAL,1125
KIAMBU WEST,Urban,60,206,248,454,Kiambu,CENTRAL,1126
KIAMBU WEST,Urban,61,103,83,186,Kiambu,CENTRAL,1127
KIAMBU WEST,Urban,62,118,121,239,Kiambu,CENTRAL,1128
KIAMBU WEST,Urban,63,100,96,196,Kiambu,CENTRAL,1129
KIAMBU WEST,Urban,64,89,105,194,Kiambu,CENTRAL,1130
KIAMBU WEST,Urban,65,123,151,274,Kiambu,CENTRAL,1131
KIAMBU WEST,Urban,66,85,116,201,Kiambu,CENTRAL,1132
KIAMBU WEST,Urban,67,82,85,167,Kiambu,CENTRAL,1133
KIAMBU WEST,Urban,68,52,59,111,Kiambu,CENTRAL,1134
KIAMBU WEST,Urban,69,63,73,136,Kiambu,CENTRAL,1135
KIAMBU WEST,Urban,70,91,134,225,Kiambu,CENTRAL,1136
KIAMBU WEST,Urban,71,40,33,73,Kiambu,CENTRAL,1137
KIAMBU WEST,Urban,72,55,45,100,Kiambu,CENTRAL,1138
KIAMBU WEST,Urban,73,54,67,121,Kiambu,CENTRAL,1139
KIAMBU WEST,Urban,74,39,60,99,Kiambu,CENTRAL,1140
KIAMBU WEST,Urban,75,62,82,144,Kiambu,CENTRAL,1141
KIAMBU WEST,Urban,76,27,33,60,Kiambu,CENTRAL,1142
KIAMBU WEST,Urban,77,30,29,59,Kiambu,CENTRAL,1143
KIAMBU WEST,Urban,78,22,46,68,Kiambu,CENTRAL,1144
KIAMBU WEST,Urban,79,29,45,74,Kiambu,CENTRAL,1145
KIAMBU WEST,Urban,80+,240,440,680,Kiambu,CENTRAL,1146
KIAMBU WEST,Urban,Age NS,12,11,23,Kiambu,CENTRAL,1147
LARI,Urban,0,0,0,0,Kiambu,CENTRAL,1148
LARI,Urban,1,0,0,0,Kiambu,CENTRAL,1149
LARI,Urban,2,0,0,0,Kiambu,CENTRAL,1150
LARI,Urban,3,0,0,0,Kiambu,CENTRAL,1151
LARI,Urban,4,0,0,0,Kiambu,CENTRAL,1152
LARI,Urban,5,0,0,0,Kiambu,CENTRAL,1153
LARI,Urban,6,0,0,0,Kiambu,CENTRAL,1154
LARI,Urban,7,0,0,0,Kiambu,CENTRAL,1155
LARI,Urban,8,0,0,0,Kiambu,CENTRAL,1156
LARI,Urban,9,0,0,0,Kiambu,CENTRAL,1157
LARI,Urban,10,0,0,0,Kiambu,CENTRAL,1158
LARI,Urban,11,0,0,0,Kiambu,CENTRAL,1159
LARI,Urban,12,0,0,0,Kiambu,CENTRAL,1160
LARI,Urban,13,0,0,0,Kiambu,CENTRAL,1161
LARI,Urban,14,0,0,0,Kiambu,CENTRAL,1162
LARI,Urban,15,0,0,0,Kiambu,CENTRAL,1163
LARI,Urban,16,0,0,0,Kiambu,CENTRAL,1164
LARI,Urban,17,0,0,0,Kiambu,CENTRAL,1165
LARI,Urban,18,0,0,0,Kiambu,CENTRAL,1166
LARI,Urban,19,0,0,0,Kiambu,CENTRAL,1167
LARI,Urban,20,0,0,0,Kiambu,CENTRAL,1168
LARI,Urban,21,0,0,0,Kiambu,CENTRAL,1169
LARI,Urban,22,0,0,0,Kiambu,CENTRAL,1170
LARI,Urban,23,0,0,0,Kiambu,CENTRAL,1171
LARI,Urban,24,0,0,0,Kiambu,CENTRAL,1172
LARI,Urban,25,0,0,0,Kiambu,CENTRAL,1173
LARI,Urban,26,0,0,0,Kiambu,CENTRAL,1174
LARI,Urban,27,0,0,0,Kiambu,CENTRAL,1175
LARI,Urban,28,0,0,0,Kiambu,CENTRAL,1176
LARI,Urban,29,0,0,0,Kiambu,CENTRAL,1177
LARI,Urban,30,0,0,0,Kiambu,CENTRAL,1178
LARI,Urban,31,0,0,0,Kiambu,CENTRAL,1179
LARI,Urban,32,0,0,0,Kiambu,CENTRAL,1180
LARI,Urban,33,0,0,0,Kiambu,CENTRAL,1181
LARI,Urban,34,0,0,0,Kiambu,CENTRAL,1182
LARI,Urban,35,0,0,0,Kiambu,CENTRAL,1183
LARI,Urban,36,0,0,0,Kiambu,CENTRAL,1184
LARI,Urban,37,0,0,0,Kiambu,CENTRAL,1185
LARI,Urban,38,0,0,0,Kiambu,CENTRAL,1186
LARI,Urban,39,0,0,0,Kiambu,CENTRAL,1187
LARI,Urban,40,0,0,0,Kiambu,CENTRAL,1188
LARI,Urban,41,0,0,0,Kiambu,CENTRAL,1189
LARI,Urban,42,0,0,0,Kiambu,CENTRAL,1190
LARI,Urban,43,0,0,0,Kiambu,CENTRAL,1191
LARI,Urban,44,0,0,0,Kiambu,CENTRAL,1192
LARI,Urban,45,0,0,0,Kiambu,CENTRAL,1193
LARI,Urban,46,0,0,0,Kiambu,CENTRAL,1194
LARI,Urban,47,0,0,0,Kiambu,CENTRAL,1195
LARI,Urban,48,0,0,0,Kiambu,CENTRAL,1196
LARI,Urban,49,0,0,0,Kiambu,CENTRAL,1197
LARI,Urban,50,0,0,0,Kiambu,CENTRAL,1198
LARI,Urban,51,0,0,0,Kiambu,CENTRAL,1199
LARI,Urban,52,0,0,0,Kiambu,CENTRAL,1200
LARI,Urban,53,0,0,0,Kiambu,CENTRAL,1201
LARI,Urban,54,0,0,0,Kiambu,CENTRAL,1202
LARI,Urban,55,0,0,0,Kiambu,CENTRAL,1203
LARI,Urban,56,0,0,0,Kiambu,CENTRAL,1204
LARI,Urban,57,0,0,0,Kiambu,CENTRAL,1205
LARI,Urban,58,0,0,0,Kiambu,CENTRAL,1206
LARI,Urban,59,0,0,0,Kiambu,CENTRAL,1207
LARI,Urban,60,0,0,0,Kiambu,CENTRAL,1208
LARI,Urban,61,0,0,0,Kiambu,CENTRAL,1209
LARI,Urban,62,0,0,0,Kiambu,CENTRAL,1210
LARI,Urban,63,0,0,0,Kiambu,CENTRAL,1211
LARI,Urban,64,0,0,0,Kiambu,CENTRAL,1212
LARI,Urban,65,0,0,0,Kiambu,CENTRAL,1213
LARI,Urban,66,0,0,0,Kiambu,CENTRAL,1214
LARI,Urban,67,0,0,0,Kiambu,CENTRAL,1215
LARI,Urban,68,0,0,0,Kiambu,CENTRAL,1216
LARI,Urban,69,0,0,0,Kiambu,CENTRAL,1217
LARI,Urban,70,0,0,0,Kiambu,CENTRAL,1218
LARI,Urban,71,0,0,0,Kiambu,CENTRAL,1219
LARI,Urban,72,0,0,0,Kiambu,CENTRAL,1220
LARI,Urban,73,0,0,0,Kiambu,CENTRAL,1221
LARI,Urban,74,0,0,0,Kiambu,CENTRAL,1222
LARI,Urban,75,0,0,0,Kiambu,CENTRAL,1223
LARI,Urban,76,0,0,0,Kiambu,CENTRAL,1224
LARI,Urban,77,0,0,0,Kiambu,CENTRAL,1225
LARI,Urban,78,0,0,0,Kiambu,CENTRAL,1226
LARI,Urban,79,0,0,0,Kiambu,CENTRAL,1227
LARI,Urban,80+,0,0,0,Kiambu,CENTRAL,1228
LARI,Urban,Age NS,0,0,0,Kiambu,CENTRAL,1229
GITHUNGURI,Urban,0,263,272,535,Kiambu,CENTRAL,1230
GITHUNGURI,Urban,1,249,238,487,Kiambu,CENTRAL,1231
GITHUNGURI,Urban,2,250,228,478,Kiambu,CENTRAL,1232
GITHUNGURI,Urban,3,235,250,485,Kiambu,CENTRAL,1233
GITHUNGURI,Urban,4,229,242,471,Kiambu,CENTRAL,1234
GITHUNGURI,Urban,5,245,227,472,Kiambu,CENTRAL,1235
GITHUNGURI,Urban,6,200,205,405,Kiambu,CENTRAL,1236
GITHUNGURI,Urban,7,184,217,401,Kiambu,CENTRAL,1237
GITHUNGURI,Urban,8,189,194,383,Kiambu,CENTRAL,1238
GITHUNGURI,Urban,9,209,215,424,Kiambu,CENTRAL,1239
GITHUNGURI,Urban,10,197,203,400,Kiambu,CENTRAL,1240
GITHUNGURI,Urban,11,163,181,344,Kiambu,CENTRAL,1241
GITHUNGURI,Urban,12,214,204,418,Kiambu,CENTRAL,1242
GITHUNGURI,Urban,13,187,222,409,Kiambu,CENTRAL,1243
GITHUNGURI,Urban,14,172,191,363,Kiambu,CENTRAL,1244
GITHUNGURI,Urban,15,148,168,316,Kiambu,CENTRAL,1245
GITHUNGURI,Urban,16,140,170,310,Kiambu,CENTRAL,1246
GITHUNGURI,Urban,17,185,160,345,Kiambu,CENTRAL,1247
GITHUNGURI,Urban,18,135,171,306,Kiambu,CENTRAL,1248
GITHUNGURI,Urban,19,145,181,326,Kiambu,CENTRAL,1249
GITHUNGURI,Urban,20,201,216,417,Kiambu,CENTRAL,1250
GITHUNGURI,Urban,21,197,232,429,Kiambu,CENTRAL,1251
GITHUNGURI,Urban,22,227,256,483,Kiambu,CENTRAL,1252
GITHUNGURI,Urban,23,197,270,467,Kiambu,CENTRAL,1253
GITHUNGURI,Urban,24,236,297,533,Kiambu,CENTRAL,1254
GITHUNGURI,Urban,25,264,295,559,Kiambu,CENTRAL,1255
GITHUNGURI,Urban,26,208,248,456,Kiambu,CENTRAL,1256
GITHUNGURI,Urban,27,239,211,450,Kiambu,CENTRAL,1257
GITHUNGURI,Urban,28,216,254,470,Kiambu,CENTRAL,1258
GITHUNGURI,Urban,29,176,226,402,Kiambu,CENTRAL,1259
GITHUNGURI,Urban,30,266,290,556,Kiambu,CENTRAL,1260
GITHUNGURI,Urban,31,151,142,293,Kiambu,CENTRAL,1261
GITHUNGURI,Urban,32,189,168,357,Kiambu,CENTRAL,1262
GITHUNGURI,Urban,33,135,145,280,Kiambu,CENTRAL,1263
GITHUNGURI,Urban,34,135,145,280,Kiambu,CENTRAL,1264
GITHUNGURI,Urban,35,233,183,416,Kiambu,CENTRAL,1265
GITHUNGURI,Urban,36,114,121,235,Kiambu,CENTRAL,1266
GITHUNGURI,Urban,37,113,97,210,Kiambu,CENTRAL,1267
GITHUNGURI,Urban,38,132,124,256,Kiambu,CENTRAL,1268
GITHUNGURI,Urban,39,99,121,220,Kiambu,CENTRAL,1269
GITHUNGURI,Urban,40,154,171,325,Kiambu,CENTRAL,1270
GITHUNGURI,Urban,41,80,71,151,Kiambu,CENTRAL,1271
GITHUNGURI,Urban,42,100,82,182,Kiambu,CENTRAL,1272
GITHUNGURI,Urban,43,62,62,124,Kiambu,CENTRAL,1273
GITHUNGURI,Urban,44,69,63,132,Kiambu,CENTRAL,1274
GITHUNGURI,Urban,45,134,112,246,Kiambu,CENTRAL,1275
GITHUNGURI,Urban,46,68,81,149,Kiambu,CENTRAL,1276
GITHUNGURI,Urban,47,57,63,120,Kiambu,CENTRAL,1277
GITHUNGURI,Urban,48,51,64,115,Kiambu,CENTRAL,1278
GITHUNGURI,Urban,49,57,48,105,Kiambu,CENTRAL,1279
GITHUNGURI,Urban,50,83,88,171,Kiambu,CENTRAL,1280
GITHUNGURI,Urban,51,33,29,62,Kiambu,CENTRAL,1281
GITHUNGURI,Urban,52,56,40,96,Kiambu,CENTRAL,1282
GITHUNGURI,Urban,53,27,30,57,Kiambu,CENTRAL,1283
GITHUNGURI,Urban,54,22,21,43,Kiambu,CENTRAL,1284
GITHUNGURI,Urban,55,52,36,88,Kiambu,CENTRAL,1285
GITHUNGURI,Urban,56,31,27,58,Kiambu,CENTRAL,1286
GITHUNGURI,Urban,57,36,43,79,Kiambu,CENTRAL,1287
GITHUNGURI,Urban,58,16,20,36,Kiambu,CENTRAL,1288
GITHUNGURI,Urban,59,23,41,64,Kiambu,CENTRAL,1289
GITHUNGURI,Urban,60,44,53,97,Kiambu,CENTRAL,1290
GITHUNGURI,Urban,61,24,20,44,Kiambu,CENTRAL,1291
GITHUNGURI,Urban,62,21,20,41,Kiambu,CENTRAL,1292
GITHUNGURI,Urban,63,22,23,45,Kiambu,CENTRAL,1293
GITHUNGURI,Urban,64,28,27,55,Kiambu,CENTRAL,1294
GITHUNGURI,Urban,65,20,26,46,Kiambu,CENTRAL,1295
GITHUNGURI,Urban,66,16,29,45,Kiambu,CENTRAL,1296
GITHUNGURI,Urban,67,11,16,27,Kiambu,CENTRAL,1297
GITHUNGURI,Urban,68,13,14,27,Kiambu,CENTRAL,1298
GITHUNGURI,Urban,69,15,15,30,Kiambu,CENTRAL,1299
GITHUNGURI,Urban,70,16,32,48,Kiambu,CENTRAL,1300
GITHUNGURI,Urban,71,10,5,15,Kiambu,CENTRAL,1301
GITHUNGURI,Urban,72,8,13,21,Kiambu,CENTRAL,1302
GITHUNGURI,Urban,73,9,18,27,Kiambu,CENTRAL,1303
GITHUNGURI,Urban,74,8,14,22,Kiambu,CENTRAL,1304
GITHUNGURI,Urban,75,11,26,37,Kiambu,CENTRAL,1305
GITHUNGURI,Urban,76,5,7,12,Kiambu,CENTRAL,1306
GITHUNGURI,Urban,77,7,11,18,Kiambu,CENTRAL,1307
GITHUNGURI,Urban,78,5,7,12,Kiambu,CENTRAL,1308
GITHUNGURI,Urban,79,4,9,13,Kiambu,CENTRAL,1309
GITHUNGURI,Urban,80+,72,104,176,Kiambu,CENTRAL,1310
GITHUNGURI,Urban,Age NS,7,5,12,Kiambu,CENTRAL,1311
THIKA EAST,Urban,0,35,46,81,Kiambu,CENTRAL,1312
THIKA EAST,Urban,1,33,43,76,Kiambu,CENTRAL,1313
THIKA EAST,Urban,2,43,39,82,Kiambu,CENTRAL,1314
THIKA EAST,Urban,3,44,35,79,Kiambu,CENTRAL,1315
THIKA EAST,Urban,4,39,36,75,Kiambu,CENTRAL,1316
THIKA EAST,Urban,5,43,42,85,Kiambu,CENTRAL,1317
THIKA EAST,Urban,6,40,31,71,Kiambu,CENTRAL,1318
THIKA EAST,Urban,7,39,39,78,Kiambu,CENTRAL,1319
THIKA EAST,Urban,8,28,46,74,Kiambu,CENTRAL,1320
THIKA EAST,Urban,9,25,43,68,Kiambu,CENTRAL,1321
THIKA EAST,Urban,10,28,37,65,Kiambu,CENTRAL,1322
THIKA EAST,Urban,11,40,32,72,Kiambu,CENTRAL,1323
THIKA EAST,Urban,12,37,35,72,Kiambu,CENTRAL,1324
THIKA EAST,Urban,13,46,32,78,Kiambu,CENTRAL,1325
THIKA EAST,Urban,14,41,22,63,Kiambu,CENTRAL,1326
THIKA EAST,Urban,15,27,39,66,Kiambu,CENTRAL,1327
THIKA EAST,Urban,16,22,22,44,Kiambu,CENTRAL,1328
THIKA EAST,Urban,17,36,36,72,Kiambu,CENTRAL,1329
THIKA EAST,Urban,18,41,36,77,Kiambu,CENTRAL,1330
THIKA EAST,Urban,19,47,33,80,Kiambu,CENTRAL,1331
THIKA EAST,Urban,20,37,52,89,Kiambu,CENTRAL,1332
THIKA EAST,Urban,21,36,41,77,Kiambu,CENTRAL,1333
THIKA EAST,Urban,22,34,31,65,Kiambu,CENTRAL,1334
THIKA EAST,Urban,23,34,37,71,Kiambu,CENTRAL,1335
THIKA EAST,Urban,24,32,34,66,Kiambu,CENTRAL,1336
THIKA EAST,Urban,25,38,40,78,Kiambu,CENTRAL,1337
THIKA EAST,Urban,26,25,27,52,Kiambu,CENTRAL,1338
THIKA EAST,Urban,27,24,32,56,Kiambu,CENTRAL,1339
THIKA EAST,Urban,28,43,40,83,Kiambu,CENTRAL,1340
THIKA EAST,Urban,29,36,15,51,Kiambu,CENTRAL,1341
THIKA EAST,Urban,30,38,36,74,Kiambu,CENTRAL,1342
THIKA EAST,Urban,31,33,18,51,Kiambu,CENTRAL,1343
THIKA EAST,Urban,32,46,13,59,Kiambu,CENTRAL,1344
THIKA EAST,Urban,33,29,19,48,Kiambu,CENTRAL,1345
THIKA EAST,Urban,34,32,25,57,Kiambu,CENTRAL,1346
THIKA EAST,Urban,35,42,20,62,Kiambu,CENTRAL,1347
THIKA EAST,Urban,36,25,19,44,Kiambu,CENTRAL,1348
THIKA EAST,Urban,37,32,17,49,Kiambu,CENTRAL,1349
THIKA EAST,Urban,38,32,24,56,Kiambu,CENTRAL,1350
THIKA EAST,Urban,39,30,20,50,Kiambu,CENTRAL,1351
THIKA EAST,Urban,40,36,26,62,Kiambu,CENTRAL,1352
THIKA EAST,Urban,41,29,11,40,Kiambu,CENTRAL,1353
THIKA EAST,Urban,42,27,14,41,Kiambu,CENTRAL,1354
THIKA EAST,Urban,43,21,14,35,Kiambu,CENTRAL,1355
THIKA EAST,Urban,44,12,5,17,Kiambu,CENTRAL,1356
THIKA EAST,Urban,45,38,19,57,Kiambu,CENTRAL,1357
THIKA EAST,Urban,46,29,16,45,Kiambu,CENTRAL,1358
THIKA EAST,Urban,47,26,15,41,Kiambu,CENTRAL,1359
THIKA EAST,Urban,48,29,13,42,Kiambu,CENTRAL,1360
THIKA EAST,Urban,49,33,12,45,Kiambu,CENTRAL,1361
THIKA EAST,Urban,50,33,22,55,Kiambu,CENTRAL,1362
THIKA EAST,Urban,51,29,12,41,Kiambu,CENTRAL,1363
THIKA EAST,Urban,52,26,9,35,Kiambu,CENTRAL,1364
THIKA EAST,Urban,53,25,8,33,Kiambu,CENTRAL,1365
THIKA EAST,Urban,54,17,8,25,Kiambu,CENTRAL,1366
THIKA EAST,Urban,55,26,11,37,Kiambu,CENTRAL,1367
THIKA EAST,Urban,56,18,4,22,Kiambu,CENTRAL,1368
THIKA EAST,Urban,57,31,7,38,Kiambu,CENTRAL,1369
THIKA EAST,Urban,58,17,3,20,Kiambu,CENTRAL,1370
THIKA EAST,Urban,59,22,1,23,Kiambu,CENTRAL,1371
THIKA EAST,Urban,60,7,0,7,Kiambu,CENTRAL,1372
THIKA EAST,Urban,61,0,1,1,Kiambu,CENTRAL,1373
THIKA EAST,Urban,62,0,0,0,Kiambu,CENTRAL,1374
THIKA EAST,Urban,63,0,0,0,Kiambu,CENTRAL,1375
THIKA EAST,Urban,64,2,1,3,Kiambu,CENTRAL,1376
THIKA EAST,Urban,65,2,0,2,Kiambu,CENTRAL,1377
THIKA EAST,Urban,66,0,0,0,Kiambu,CENTRAL,1378
THIKA EAST,Urban,67,0,1,1,Kiambu,CENTRAL,1379
THIKA EAST,Urban,68,0,0,0,Kiambu,CENTRAL,1380
THIKA EAST,Urban,69,0,1,1,Kiambu,CENTRAL,1381
THIKA EAST,Urban,70,0,0,0,Kiambu,CENTRAL,1382
THIKA EAST,Urban,71,0,0,0,Kiambu,CENTRAL,1383
THIKA EAST,Urban,72,0,0,0,Kiambu,CENTRAL,1384
THIKA EAST,Urban,73,0,0,0,Kiambu,CENTRAL,1385
THIKA EAST,Urban,74,0,0,0,Kiambu,CENTRAL,1386
THIKA EAST,Urban,75,0,0,0,Kiambu,CENTRAL,1387
THIKA EAST,Urban,76,0,0,0,Kiambu,CENTRAL,1388
THIKA EAST,Urban,77,0,0,0,Kiambu,CENTRAL,1389
THIKA EAST,Urban,78,0,0,0,Kiambu,CENTRAL,1390
THIKA EAST,Urban,79,2,0,2,Kiambu,CENTRAL,1391
THIKA EAST,Urban,80+,1,2,3,Kiambu,CENTRAL,1392
THIKA EAST,Urban,Age NS,0,0,0,Kiambu,CENTRAL,1393
THIKA WEST,Urban,0,2810,2948,5758,Kiambu,CENTRAL,1394
THIKA WEST,Urban,1,2405,2283,4688,Kiambu,CENTRAL,1395
THIKA WEST,Urban,2,2392,2369,4761,Kiambu,CENTRAL,1396
THIKA WEST,Urban,3,2261,2354,4615,Kiambu,CENTRAL,1397
THIKA WEST,Urban,4,2322,2197,4519,Kiambu,CENTRAL,1398
THIKA WEST,Urban,5,2272,2089,4361,Kiambu,CENTRAL,1399
THIKA WEST,Urban,6,1987,2085,4072,Kiambu,CENTRAL,1400
THIKA WEST,Urban,7,1947,1942,3889,Kiambu,CENTRAL,1401
THIKA WEST,Urban,8,1839,1882,3721,Kiambu,CENTRAL,1402
THIKA WEST,Urban,9,1894,1962,3856,Kiambu,CENTRAL,1403
THIKA WEST,Urban,10,2011,1861,3872,Kiambu,CENTRAL,1404
THIKA WEST,Urban,11,1507,1562,3069,Kiambu,CENTRAL,1405
THIKA WEST,Urban,12,1648,1767,3415,Kiambu,CENTRAL,1406
THIKA WEST,Urban,13,1563,1726,3289,Kiambu,CENTRAL,1407
THIKA WEST,Urban,14,1451,1497,2948,Kiambu,CENTRAL,1408
THIKA WEST,Urban,15,1327,1531,2858,Kiambu,CENTRAL,1409
THIKA WEST,Urban,16,1327,1652,2979,Kiambu,CENTRAL,1410
THIKA WEST,Urban,17,1465,1877,3342,Kiambu,CENTRAL,1411
THIKA WEST,Urban,18,1550,2006,3556,Kiambu,CENTRAL,1412
THIKA WEST,Urban,19,1527,2127,3654,Kiambu,CENTRAL,1413
THIKA WEST,Urban,20,2274,3223,5497,Kiambu,CENTRAL,1414
THIKA WEST,Urban,21,2033,2777,4810,Kiambu,CENTRAL,1415
THIKA WEST,Urban,22,2657,3391,6048,Kiambu,CENTRAL,1416
THIKA WEST,Urban,23,2758,3317,6075,Kiambu,CENTRAL,1417
THIKA WEST,Urban,24,2757,3006,5763,Kiambu,CENTRAL,1418
THIKA WEST,Urban,25,3295,3475,6770,Kiambu,CENTRAL,1419
THIKA WEST,Urban,26,2436,2754,5190,Kiambu,CENTRAL,1420
THIKA WEST,Urban,27,2608,2446,5054,Kiambu,CENTRAL,1421
THIKA WEST,Urban,28,2760,2659,5419,Kiambu,CENTRAL,1422
THIKA WEST,Urban,29,2134,1981,4115,Kiambu,CENTRAL,1423
THIKA WEST,Urban,30,3523,3108,6631,Kiambu,CENTRAL,1424
THIKA WEST,Urban,31,1727,1342,3069,Kiambu,CENTRAL,1425
THIKA WEST,Urban,32,2281,1983,4264,Kiambu,CENTRAL,1426
THIKA WEST,Urban,33,1415,1279,2694,Kiambu,CENTRAL,1427
THIKA WEST,Urban,34,1591,1354,2945,Kiambu,CENTRAL,1428
THIKA WEST,Urban,35,2674,1910,4584,Kiambu,CENTRAL,1429
THIKA WEST,Urban,36,1337,1150,2487,Kiambu,CENTRAL,1430
THIKA WEST,Urban,37,1198,1049,2247,Kiambu,CENTRAL,1431
THIKA WEST,Urban,38,1468,1305,2773,Kiambu,CENTRAL,1432
THIKA WEST,Urban,39,1213,976,2189,Kiambu,CENTRAL,1433
THIKA WEST,Urban,40,2007,1516,3523,Kiambu,CENTRAL,1434
THIKA WEST,Urban,41,846,602,1448,Kiambu,CENTRAL,1435
THIKA WEST,Urban,42,1185,864,2049,Kiambu,CENTRAL,1436
THIKA WEST,Urban,43,803,674,1477,Kiambu,CENTRAL,1437
THIKA WEST,Urban,44,652,529,1181,Kiambu,CENTRAL,1438
THIKA WEST,Urban,45,1362,974,2336,Kiambu,CENTRAL,1439
THIKA WEST,Urban,46,803,625,1428,Kiambu,CENTRAL,1440
THIKA WEST,Urban,47,738,554,1292,Kiambu,CENTRAL,1441
THIKA WEST,Urban,48,671,547,1218,Kiambu,CENTRAL,1442
THIKA WEST,Urban,49,665,489,1154,Kiambu,CENTRAL,1443
THIKA WEST,Urban,50,968,754,1722,Kiambu,CENTRAL,1444
THIKA WEST,Urban,51,459,286,745,Kiambu,CENTRAL,1445
THIKA WEST,Urban,52,518,336,854,Kiambu,CENTRAL,1446
THIKA WEST,Urban,53,390,248,638,Kiambu,CENTRAL,1447
THIKA WEST,Urban,54,378,254,632,Kiambu,CENTRAL,1448
THIKA WEST,Urban,55,476,315,791,Kiambu,CENTRAL,1449
THIKA WEST,Urban,56,314,222,536,Kiambu,CENTRAL,1450
THIKA WEST,Urban,57,339,237,576,Kiambu,CENTRAL,1451
THIKA WEST,Urban,58,228,164,392,Kiambu,CENTRAL,1452
THIKA WEST,Urban,59,224,143,367,Kiambu,CENTRAL,1453
THIKA WEST,Urban,60,354,290,644,Kiambu,CENTRAL,1454
THIKA WEST,Urban,61,131,85,216,Kiambu,CENTRAL,1455
THIKA WEST,Urban,62,157,84,241,Kiambu,CENTRAL,1456
THIKA WEST,Urban,63,103,86,189,Kiambu,CENTRAL,1457
THIKA WEST,Urban,64,127,85,212,Kiambu,CENTRAL,1458
THIKA WEST,Urban,65,169,134,303,Kiambu,CENTRAL,1459
THIKA WEST,Urban,66,61,80,141,Kiambu,CENTRAL,1460
THIKA WEST,Urban,67,80,76,156,Kiambu,CENTRAL,1461
THIKA WEST,Urban,68,53,40,93,Kiambu,CENTRAL,1462
THIKA WEST,Urban,69,51,52,103,Kiambu,CENTRAL,1463
THIKA WEST,Urban,70,101,151,252,Kiambu,CENTRAL,1464
THIKA WEST,Urban,71,29,34,63,Kiambu,CENTRAL,1465
THIKA WEST,Urban,72,40,44,84,Kiambu,CENTRAL,1466
THIKA WEST,Urban,73,28,35,63,Kiambu,CENTRAL,1467
THIKA WEST,Urban,74,32,37,69,Kiambu,CENTRAL,1468
THIKA WEST,Urban,75,47,66,113,Kiambu,CENTRAL,1469
THIKA WEST,Urban,76,34,28,62,Kiambu,CENTRAL,1470
THIKA WEST,Urban,77,19,24,43,Kiambu,CENTRAL,1471
THIKA WEST,Urban,78,22,29,51,Kiambu,CENTRAL,1472
THIKA WEST,Urban,79,22,14,36,Kiambu,CENTRAL,1473
THIKA WEST,Urban,80+,185,379,564,Kiambu,CENTRAL,1474
THIKA WEST,Urban,Age NS,100,54,154,Kiambu,CENTRAL,1475
RUIRU,Urban,0,3643,3625,7268,Kiambu,CENTRAL,1476
RUIRU,Urban,1,2945,2976,5921,Kiambu,CENTRAL,1477
RUIRU,Urban,2,3195,3155,6350,Kiambu,CENTRAL,1478
RUIRU,Urban,3,3118,3113,6231,Kiambu,CENTRAL,1479
RUIRU,Urban,4,3018,2868,5886,Kiambu,CENTRAL,1480
RUIRU,Urban,5,2878,2825,5703,Kiambu,CENTRAL,1481
RUIRU,Urban,6,2581,2687,5268,Kiambu,CENTRAL,1482
RUIRU,Urban,7,2546,2472,5018,Kiambu,CENTRAL,1483
RUIRU,Urban,8,2288,2422,4710,Kiambu,CENTRAL,1484
RUIRU,Urban,9,2605,2513,5118,Kiambu,CENTRAL,1485
RUIRU,Urban,10,2445,2406,4851,Kiambu,CENTRAL,1486
RUIRU,Urban,11,1935,2046,3981,Kiambu,CENTRAL,1487
RUIRU,Urban,12,2258,2326,4584,Kiambu,CENTRAL,1488
RUIRU,Urban,13,2217,2171,4388,Kiambu,CENTRAL,1489
RUIRU,Urban,14,1810,2012,3822,Kiambu,CENTRAL,1490
RUIRU,Urban,15,1700,1890,3590,Kiambu,CENTRAL,1491
RUIRU,Urban,16,1639,2049,3688,Kiambu,CENTRAL,1492
RUIRU,Urban,17,1823,2256,4079,Kiambu,CENTRAL,1493
RUIRU,Urban,18,1882,2576,4458,Kiambu,CENTRAL,1494
RUIRU,Urban,19,1727,2599,4326,Kiambu,CENTRAL,1495
RUIRU,Urban,20,2583,3949,6532,Kiambu,CENTRAL,1496
RUIRU,Urban,21,2393,3127,5520,Kiambu,CENTRAL,1497
RUIRU,Urban,22,3127,4198,7325,Kiambu,CENTRAL,1498
RUIRU,Urban,23,3230,4010,7240,Kiambu,CENTRAL,1499
RUIRU,Urban,24,3509,3891,7400,Kiambu,CENTRAL,1500
RUIRU,Urban,25,4017,4466,8483,Kiambu,CENTRAL,1501
RUIRU,Urban,26,3014,3448,6462,Kiambu,CENTRAL,1502
RUIRU,Urban,27,3235,3030,6265,Kiambu,CENTRAL,1503
RUIRU,Urban,28,3131,3411,6542,Kiambu,CENTRAL,1504
RUIRU,Urban,29,2814,2512,5326,Kiambu,CENTRAL,1505
RUIRU,Urban,30,4381,3994,8375,Kiambu,CENTRAL,1506
RUIRU,Urban,31,2061,1603,3664,Kiambu,CENTRAL,1507
RUIRU,Urban,32,2788,2441,5229,Kiambu,CENTRAL,1508
RUIRU,Urban,33,1821,1556,3377,Kiambu,CENTRAL,1509
RUIRU,Urban,34,2053,1680,3733,Kiambu,CENTRAL,1510
RUIRU,Urban,35,3314,2445,5759,Kiambu,CENTRAL,1511
RUIRU,Urban,36,1671,1411,3082,Kiambu,CENTRAL,1512
RUIRU,Urban,37,1591,1236,2827,Kiambu,CENTRAL,1513
RUIRU,Urban,38,1823,1581,3404,Kiambu,CENTRAL,1514
RUIRU,Urban,39,1494,1164,2658,Kiambu,CENTRAL,1515
RUIRU,Urban,40,2471,1837,4308,Kiambu,CENTRAL,1516
RUIRU,Urban,41,965,689,1654,Kiambu,CENTRAL,1517
RUIRU,Urban,42,1380,1003,2383,Kiambu,CENTRAL,1518
RUIRU,Urban,43,971,792,1763,Kiambu,CENTRAL,1519
RUIRU,Urban,44,784,622,1406,Kiambu,CENTRAL,1520
RUIRU,Urban,45,1595,1181,2776,Kiambu,CENTRAL,1521
RUIRU,Urban,46,952,687,1639,Kiambu,CENTRAL,1522
RUIRU,Urban,47,766,568,1334,Kiambu,CENTRAL,1523
RUIRU,Urban,48,836,607,1443,Kiambu,CENTRAL,1524
RUIRU,Urban,49,738,536,1274,Kiambu,CENTRAL,1525
RUIRU,Urban,50,1044,813,1857,Kiambu,CENTRAL,1526
RUIRU,Urban,51,465,286,751,Kiambu,CENTRAL,1527
RUIRU,Urban,52,587,351,938,Kiambu,CENTRAL,1528
RUIRU,Urban,53,398,231,629,Kiambu,CENTRAL,1529
RUIRU,Urban,54,366,269,635,Kiambu,CENTRAL,1530
RUIRU,Urban,55,530,404,934,Kiambu,CENTRAL,1531
RUIRU,Urban,56,348,251,599,Kiambu,CENTRAL,1532
RUIRU,Urban,57,343,292,635,Kiambu,CENTRAL,1533
RUIRU,Urban,58,263,188,451,Kiambu,CENTRAL,1534
RUIRU,Urban,59,211,149,360,Kiambu,CENTRAL,1535
RUIRU,Urban,60,372,337,709,Kiambu,CENTRAL,1536
RUIRU,Urban,61,160,141,301,Kiambu,CENTRAL,1537
RUIRU,Urban,62,183,152,335,Kiambu,CENTRAL,1538
RUIRU,Urban,63,117,109,226,Kiambu,CENTRAL,1539
RUIRU,Urban,64,118,104,222,Kiambu,CENTRAL,1540
RUIRU,Urban,65,173,175,348,Kiambu,CENTRAL,1541
RUIRU,Urban,66,79,131,210,Kiambu,CENTRAL,1542
RUIRU,Urban,67,76,89,165,Kiambu,CENTRAL,1543
RUIRU,Urban,68,67,65,132,Kiambu,CENTRAL,1544
RUIRU,Urban,69,56,48,104,Kiambu,CENTRAL,1545
RUIRU,Urban,70,133,145,278,Kiambu,CENTRAL,1546
RUIRU,Urban,71,51,40,91,Kiambu,CENTRAL,1547
RUIRU,Urban,72,42,45,87,Kiambu,CENTRAL,1548
RUIRU,Urban,73,42,47,89,Kiambu,CENTRAL,1549
RUIRU,Urban,74,33,43,76,Kiambu,CENTRAL,1550
RUIRU,Urban,75,65,85,150,Kiambu,CENTRAL,1551
RUIRU,Urban,76,33,54,87,Kiambu,CENTRAL,1552
RUIRU,Urban,77,27,46,73,Kiambu,CENTRAL,1553
RUIRU,Urban,78,23,37,60,Kiambu,CENTRAL,1554
RUIRU,Urban,79,32,43,75,Kiambu,CENTRAL,1555
RUIRU,Urban,80+,270,576,846,Kiambu,CENTRAL,1556
RUIRU,Urban,Age NS,82,49,131,Kiambu,CENTRAL,1557
GATANGA,Urban,0,9,14,23,Murang'a,CENTRAL,1558
GATANGA,Urban,1,16,11,27,Murang'a,CENTRAL,1559
GATANGA,Urban,2,14,14,28,Murang'a,CENTRAL,1560
GATANGA,Urban,3,11,14,25,Murang'a,CENTRAL,1561
GATANGA,Urban,4,12,11,23,Murang'a,CENTRAL,1562
GATANGA,Urban,5,12,16,28,Murang'a,CENTRAL,1563
GATANGA,Urban,6,14,12,26,Murang'a,CENTRAL,1564
GATANGA,Urban,7,13,13,26,Murang'a,CENTRAL,1565
GATANGA,Urban,8,14,10,24,Murang'a,CENTRAL,1566
GATANGA,Urban,9,12,17,29,Murang'a,CENTRAL,1567
GATANGA,Urban,10,18,13,31,Murang'a,CENTRAL,1568
GATANGA,Urban,11,10,16,26,Murang'a,CENTRAL,1569
GATANGA,Urban,12,17,20,37,Murang'a,CENTRAL,1570
GATANGA,Urban,13,13,13,26,Murang'a,CENTRAL,1571
GATANGA,Urban,14,19,20,39,Murang'a,CENTRAL,1572
GATANGA,Urban,15,11,16,27,Murang'a,CENTRAL,1573
GATANGA,Urban,16,15,20,35,Murang'a,CENTRAL,1574
GATANGA,Urban,17,21,27,48,Murang'a,CENTRAL,1575
GATANGA,Urban,18,14,24,38,Murang'a,CENTRAL,1576
GATANGA,Urban,19,21,30,51,Murang'a,CENTRAL,1577
GATANGA,Urban,20,27,35,62,Murang'a,CENTRAL,1578
GATANGA,Urban,21,21,18,39,Murang'a,CENTRAL,1579
GATANGA,Urban,22,25,30,55,Murang'a,CENTRAL,1580
GATANGA,Urban,23,27,26,53,Murang'a,CENTRAL,1581
GATANGA,Urban,24,34,29,63,Murang'a,CENTRAL,1582
GATANGA,Urban,25,23,34,57,Murang'a,CENTRAL,1583
GATANGA,Urban,26,17,11,28,Murang'a,CENTRAL,1584
GATANGA,Urban,27,22,21,43,Murang'a,CENTRAL,1585
GATANGA,Urban,28,26,20,46,Murang'a,CENTRAL,1586
GATANGA,Urban,29,18,13,31,Murang'a,CENTRAL,1587
GATANGA,Urban,30,26,19,45,Murang'a,CENTRAL,1588
GATANGA,Urban,31,17,17,34,Murang'a,CENTRAL,1589
GATANGA,Urban,32,15,17,32,Murang'a,CENTRAL,1590
GATANGA,Urban,33,14,11,25,Murang'a,CENTRAL,1591
GATANGA,Urban,34,20,7,27,Murang'a,CENTRAL,1592
GATANGA,Urban,35,9,13,22,Murang'a,CENTRAL,1593
GATANGA,Urban,36,12,8,20,Murang'a,CENTRAL,1594
GATANGA,Urban,37,7,10,17,Murang'a,CENTRAL,1595
GATANGA,Urban,38,19,15,34,Murang'a,CENTRAL,1596
GATANGA,Urban,39,13,13,26,Murang'a,CENTRAL,1597
GATANGA,Urban,40,20,16,36,Murang'a,CENTRAL,1598
GATANGA,Urban,41,4,9,13,Murang'a,CENTRAL,1599
GATANGA,Urban,42,17,18,35,Murang'a,CENTRAL,1600
GATANGA,Urban,43,17,14,31,Murang'a,CENTRAL,1601
GATANGA,Urban,44,11,10,21,Murang'a,CENTRAL,1602
GATANGA,Urban,45,21,16,37,Murang'a,CENTRAL,1603
GATANGA,Urban,46,20,5,25,Murang'a,CENTRAL,1604
GATANGA,Urban,47,8,11,19,Murang'a,CENTRAL,1605
GATANGA,Urban,48,19,6,25,Murang'a,CENTRAL,1606
GATANGA,Urban,49,16,4,20,Murang'a,CENTRAL,1607
GATANGA,Urban,50,19,17,36,Murang'a,CENTRAL,1608
GATANGA,Urban,51,10,7,17,Murang'a,CENTRAL,1609
GATANGA,Urban,52,5,8,13,Murang'a,CENTRAL,1610
GATANGA,Urban,53,6,7,13,Murang'a,CENTRAL,1611
GATANGA,Urban,54,13,4,17,Murang'a,CENTRAL,1612
GATANGA,Urban,55,4,5,9,Murang'a,CENTRAL,1613
GATANGA,Urban,56,12,5,17,Murang'a,CENTRAL,1614
GATANGA,Urban,57,11,10,21,Murang'a,CENTRAL,1615
GATANGA,Urban,58,5,4,9,Murang'a,CENTRAL,1616
GATANGA,Urban,59,2,3,5,Murang'a,CENTRAL,1617
GATANGA,Urban,60,12,7,19,Murang'a,CENTRAL,1618
GATANGA,Urban,61,7,0,7,Murang'a,CENTRAL,1619
GATANGA,Urban,62,9,7,16,Murang'a,CENTRAL,1620
GATANGA,Urban,63,6,5,11,Murang'a,CENTRAL,1621
GATANGA,Urban,64,6,4,10,Murang'a,CENTRAL,1622
GATANGA,Urban,65,9,3,12,Murang'a,CENTRAL,1623
GATANGA,Urban,66,7,2,9,Murang'a,CENTRAL,1624
GATANGA,Urban,67,4,0,4,Murang'a,CENTRAL,1625
GATANGA,Urban,68,8,1,9,Murang'a,CENTRAL,1626
GATANGA,Urban,69,4,0,4,Murang'a,CENTRAL,1627
GATANGA,Urban,70,2,5,7,Murang'a,CENTRAL,1628
GATANGA,Urban,71,4,1,5,Murang'a,CENTRAL,1629
GATANGA,Urban,72,2,3,5,Murang'a,CENTRAL,1630
GATANGA,Urban,73,1,1,2,Murang'a,CENTRAL,1631
GATANGA,Urban,74,3,0,3,Murang'a,CENTRAL,1632
GATANGA,Urban,75,2,1,3,Murang'a,CENTRAL,1633
GATANGA,Urban,76,0,0,0,Murang'a,CENTRAL,1634
GATANGA,Urban,77,1,0,1,Murang'a,CENTRAL,1635
GATANGA,Urban,78,1,1,2,Murang'a,CENTRAL,1636
GATANGA,Urban,79,0,0,0,Murang'a,CENTRAL,1637
GATANGA,Urban,80+,7,4,11,Murang'a,CENTRAL,1638
GATANGA,Urban,Age NS,0,1,1,Murang'a,CENTRAL,1639
GATUNDU,Urban,0,110,96,206,Kiambu,CENTRAL,1640
GATUNDU,Urban,1,82,66,148,Kiambu,CENTRAL,1641
GATUNDU,Urban,2,61,68,129,Kiambu,CENTRAL,1642
GATUNDU,Urban,3,68,59,127,Kiambu,CENTRAL,1643
GATUNDU,Urban,4,79,74,153,Kiambu,CENTRAL,1644
GATUNDU,Urban,5,65,69,134,Kiambu,CENTRAL,1645
GATUNDU,Urban,6,67,77,144,Kiambu,CENTRAL,1646
GATUNDU,Urban,7,53,53,106,Kiambu,CENTRAL,1647
GATUNDU,Urban,8,67,66,133,Kiambu,CENTRAL,1648
GATUNDU,Urban,9,66,60,126,Kiambu,CENTRAL,1649
GATUNDU,Urban,10,72,83,155,Kiambu,CENTRAL,1650
GATUNDU,Urban,11,48,67,115,Kiambu,CENTRAL,1651
GATUNDU,Urban,12,57,62,119,Kiambu,CENTRAL,1652
GATUNDU,Urban,13,62,51,113,Kiambu,CENTRAL,1653
GATUNDU,Urban,14,48,43,91,Kiambu,CENTRAL,1654
GATUNDU,Urban,15,30,56,86,Kiambu,CENTRAL,1655
GATUNDU,Urban,16,35,52,87,Kiambu,CENTRAL,1656
GATUNDU,Urban,17,55,58,113,Kiambu,CENTRAL,1657
GATUNDU,Urban,18,50,60,110,Kiambu,CENTRAL,1658
GATUNDU,Urban,19,42,47,89,Kiambu,CENTRAL,1659
GATUNDU,Urban,20,59,71,130,Kiambu,CENTRAL,1660
GATUNDU,Urban,21,51,75,126,Kiambu,CENTRAL,1661
GATUNDU,Urban,22,66,93,159,Kiambu,CENTRAL,1662
GATUNDU,Urban,23,60,107,167,Kiambu,CENTRAL,1663
GATUNDU,Urban,24,66,95,161,Kiambu,CENTRAL,1664
GATUNDU,Urban,25,65,99,164,Kiambu,CENTRAL,1665
GATUNDU,Urban,26,68,100,168,Kiambu,CENTRAL,1666
GATUNDU,Urban,27,63,92,155,Kiambu,CENTRAL,1667
GATUNDU,Urban,28,51,94,145,Kiambu,CENTRAL,1668
GATUNDU,Urban,29,54,71,125,Kiambu,CENTRAL,1669
GATUNDU,Urban,30,102,87,189,Kiambu,CENTRAL,1670
GATUNDU,Urban,31,29,37,66,Kiambu,CENTRAL,1671
GATUNDU,Urban,32,71,63,134,Kiambu,CENTRAL,1672
GATUNDU,Urban,33,39,30,69,Kiambu,CENTRAL,1673
GATUNDU,Urban,34,42,53,95,Kiambu,CENTRAL,1674
GATUNDU,Urban,35,73,66,139,Kiambu,CENTRAL,1675
GATUNDU,Urban,36,32,36,68,Kiambu,CENTRAL,1676
GATUNDU,Urban,37,46,38,84,Kiambu,CENTRAL,1677
GATUNDU,Urban,38,27,54,81,Kiambu,CENTRAL,1678
GATUNDU,Urban,39,33,21,54,Kiambu,CENTRAL,1679
GATUNDU,Urban,40,43,69,112,Kiambu,CENTRAL,1680
GATUNDU,Urban,41,17,25,42,Kiambu,CENTRAL,1681
GATUNDU,Urban,42,31,26,57,Kiambu,CENTRAL,1682
GATUNDU,Urban,43,19,18,37,Kiambu,CENTRAL,1683
GATUNDU,Urban,44,27,27,54,Kiambu,CENTRAL,1684
GATUNDU,Urban,45,35,46,81,Kiambu,CENTRAL,1685
GATUNDU,Urban,46,25,41,66,Kiambu,CENTRAL,1686
GATUNDU,Urban,47,17,18,35,Kiambu,CENTRAL,1687
GATUNDU,Urban,48,19,30,49,Kiambu,CENTRAL,1688
GATUNDU,Urban,49,19,19,38,Kiambu,CENTRAL,1689
GATUNDU,Urban,50,28,38,66,Kiambu,CENTRAL,1690
GATUNDU,Urban,51,13,19,32,Kiambu,CENTRAL,1691
GATUNDU,Urban,52,9,14,23,Kiambu,CENTRAL,1692
GATUNDU,Urban,53,8,2,10,Kiambu,CENTRAL,1693
GATUNDU,Urban,54,15,8,23,Kiambu,CENTRAL,1694
GATUNDU,Urban,55,9,14,23,Kiambu,CENTRAL,1695
GATUNDU,Urban,56,19,7,26,Kiambu,CENTRAL,1696
GATUNDU,Urban,57,9,14,23,Kiambu,CENTRAL,1697
GATUNDU,Urban,58,9,8,17,Kiambu,CENTRAL,1698
GATUNDU,Urban,59,7,2,9,Kiambu,CENTRAL,1699
GATUNDU,Urban,60,10,17,27,Kiambu,CENTRAL,1700
GATUNDU,Urban,61,6,6,12,Kiambu,CENTRAL,1701
GATUNDU,Urban,62,4,8,12,Kiambu,CENTRAL,1702
GATUNDU,Urban,63,8,9,17,Kiambu,CENTRAL,1703
GATUNDU,Urban,64,5,1,6,Kiambu,CENTRAL,1704
GATUNDU,Urban,65,2,9,11,Kiambu,CENTRAL,1705
GATUNDU,Urban,66,9,3,12,Kiambu,CENTRAL,1706
GATUNDU,Urban,67,4,5,9,Kiambu,CENTRAL,1707
GATUNDU,Urban,68,3,7,10,Kiambu,CENTRAL,1708
GATUNDU,Urban,69,2,3,5,Kiambu,CENTRAL,1709
GATUNDU,Urban,70,4,9,13,Kiambu,CENTRAL,1710
GATUNDU,Urban,71,3,3,6,Kiambu,CENTRAL,1711
GATUNDU,Urban,72,1,1,2,Kiambu,CENTRAL,1712
GATUNDU,Urban,73,3,0,3,Kiambu,CENTRAL,1713
GATUNDU,Urban,74,2,4,6,Kiambu,CENTRAL,1714
GATUNDU,Urban,75,3,2,5,Kiambu,CENTRAL,1715
GATUNDU,Urban,76,2,3,5,Kiambu,CENTRAL,1716
GATUNDU,Urban,77,0,0,0,Kiambu,CENTRAL,1717
GATUNDU,Urban,78,2,0,2,Kiambu,CENTRAL,1718
GATUNDU,Urban,79,0,2,2,Kiambu,CENTRAL,1719
GATUNDU,Urban,80+,16,37,53,Kiambu,CENTRAL,1720
GATUNDU,Urban,Age NS,2,1,3,Kiambu,CENTRAL,1721
MOMBASA,Urban,0,7804,7638,15442,Mombasa,COAST,1722
MOMBASA,Urban,1,6652,6252,12904,Mombasa,COAST,1723
MOMBASA,Urban,2,6754,6528,13282,Mombasa,COAST,1724
MOMBASA,Urban,3,6685,6572,13257,Mombasa,COAST,1725
MOMBASA,Urban,4,6332,6176,12508,Mombasa,COAST,1726
MOMBASA,Urban,5,5950,5794,11744,Mombasa,COAST,1727
MOMBASA,Urban,6,5461,5626,11087,Mombasa,COAST,1728
MOMBASA,Urban,7,5457,5326,10783,Mombasa,COAST,1729
MOMBASA,Urban,8,5037,5187,10224,Mombasa,COAST,1730
MOMBASA,Urban,9,5541,5541,11082,Mombasa,COAST,1731
MOMBASA,Urban,10,5258,5282,10540,Mombasa,COAST,1732
MOMBASA,Urban,11,3998,4081,8079,Mombasa,COAST,1733
MOMBASA,Urban,12,5067,4951,10018,Mombasa,COAST,1734
MOMBASA,Urban,13,4792,5091,9883,Mombasa,COAST,1735
MOMBASA,Urban,14,4366,4764,9130,Mombasa,COAST,1736
MOMBASA,Urban,15,4415,4794,9209,Mombasa,COAST,1737
MOMBASA,Urban,16,4263,4814,9077,Mombasa,COAST,1738
MOMBASA,Urban,17,4766,5344,10110,Mombasa,COAST,1739
MOMBASA,Urban,18,5341,6325,11666,Mombasa,COAST,1740
MOMBASA,Urban,19,4775,5906,10681,Mombasa,COAST,1741
MOMBASA,Urban,20,6334,8796,15130,Mombasa,COAST,1742
MOMBASA,Urban,21,4956,6032,10988,Mombasa,COAST,1743
MOMBASA,Urban,22,6494,7944,14438,Mombasa,COAST,1744
MOMBASA,Urban,23,6319,7360,13679,Mombasa,COAST,1745
MOMBASA,Urban,24,6444,7201,13645,Mombasa,COAST,1746
MOMBASA,Urban,25,8055,8580,16635,Mombasa,COAST,1747
MOMBASA,Urban,26,6174,6297,12471,Mombasa,COAST,1748
MOMBASA,Urban,27,6623,6130,12753,Mombasa,COAST,1749
MOMBASA,Urban,28,6479,6236,12715,Mombasa,COAST,1750
MOMBASA,Urban,29,5633,4949,10582,Mombasa,COAST,1751
MOMBASA,Urban,30,8993,7648,16641,Mombasa,COAST,1752
MOMBASA,Urban,31,4243,3277,7520,Mombasa,COAST,1753
MOMBASA,Urban,32,5937,4743,10680,Mombasa,COAST,1754
MOMBASA,Urban,33,3807,2997,6804,Mombasa,COAST,1755
MOMBASA,Urban,34,4255,3229,7484,Mombasa,COAST,1756
MOMBASA,Urban,35,6728,4856,11584,Mombasa,COAST,1757
MOMBASA,Urban,36,3734,2844,6578,Mombasa,COAST,1758
MOMBASA,Urban,37,3726,2744,6470,Mombasa,COAST,1759
MOMBASA,Urban,38,3995,3133,7128,Mombasa,COAST,1760
MOMBASA,Urban,39,3370,2390,5760,Mombasa,COAST,1761
MOMBASA,Urban,40,5802,4015,9817,Mombasa,COAST,1762
MOMBASA,Urban,41,2118,1360,3478,Mombasa,COAST,1763
MOMBASA,Urban,42,3005,1988,4993,Mombasa,COAST,1764
MOMBASA,Urban,43,2071,1473,3544,Mombasa,COAST,1765
MOMBASA,Urban,44,1806,1304,3110,Mombasa,COAST,1766
MOMBASA,Urban,45,3520,2449,5969,Mombasa,COAST,1767
MOMBASA,Urban,46,2195,1499,3694,Mombasa,COAST,1768
MOMBASA,Urban,47,1996,1263,3259,Mombasa,COAST,1769
MOMBASA,Urban,48,1805,1416,3221,Mombasa,COAST,1770
MOMBASA,Urban,49,1712,1193,2905,Mombasa,COAST,1771
MOMBASA,Urban,50,2649,2188,4837,Mombasa,COAST,1772
MOMBASA,Urban,51,1145,743,1888,Mombasa,COAST,1773
MOMBASA,Urban,52,1535,1025,2560,Mombasa,COAST,1774
MOMBASA,Urban,53,1084,749,1833,Mombasa,COAST,1775
MOMBASA,Urban,54,1156,851,2007,Mombasa,COAST,1776
MOMBASA,Urban,55,1461,1132,2593,Mombasa,COAST,1777
MOMBASA,Urban,56,979,744,1723,Mombasa,COAST,1778
MOMBASA,Urban,57,913,637,1550,Mombasa,COAST,1779
MOMBASA,Urban,58,757,624,1381,Mombasa,COAST,1780
MOMBASA,Urban,59,713,467,1180,Mombasa,COAST,1781
MOMBASA,Urban,60,1333,1380,2713,Mombasa,COAST,1782
MOMBASA,Urban,61,504,379,883,Mombasa,COAST,1783
MOMBASA,Urban,62,541,453,994,Mombasa,COAST,1784
MOMBASA,Urban,63,462,339,801,Mombasa,COAST,1785
MOMBASA,Urban,64,416,384,800,Mombasa,COAST,1786
MOMBASA,Urban,65,695,733,1428,Mombasa,COAST,1787
MOMBASA,Urban,66,271,248,519,Mombasa,COAST,1788
MOMBASA,Urban,67,320,273,593,Mombasa,COAST,1789
MOMBASA,Urban,68,323,289,612,Mombasa,COAST,1790
MOMBASA,Urban,69,277,242,519,Mombasa,COAST,1791
MOMBASA,Urban,70,622,763,1385,Mombasa,COAST,1792
MOMBASA,Urban,71,170,150,320,Mombasa,COAST,1793
MOMBASA,Urban,72,244,215,459,Mombasa,COAST,1794
MOMBASA,Urban,73,182,154,336,Mombasa,COAST,1795
MOMBASA,Urban,74,149,147,296,Mombasa,COAST,1796
MOMBASA,Urban,75,266,297,563,Mombasa,COAST,1797
MOMBASA,Urban,76,134,140,274,Mombasa,COAST,1798
MOMBASA,Urban,77,118,98,216,Mombasa,COAST,1799
MOMBASA,Urban,78,120,142,262,Mombasa,COAST,1800
MOMBASA,Urban,79,121,107,228,Mombasa,COAST,1801
MOMBASA,Urban,80+,970,1464,2434,Mombasa,COAST,1802
MOMBASA,Urban,Age NS,365,250,615,Mombasa,COAST,1803
KILINDINI,Urban,0,7153,7118,14271,Mombasa,COAST,1804
KILINDINI,Urban,1,5878,5720,11598,Mombasa,COAST,1805
KILINDINI,Urban,2,5905,5736,11641,Mombasa,COAST,1806
KILINDINI,Urban,3,5766,5950,11716,Mombasa,COAST,1807
KILINDINI,Urban,4,5388,5312,10700,Mombasa,COAST,1808
KILINDINI,Urban,5,4878,4972,9850,Mombasa,COAST,1809
KILINDINI,Urban,6,4526,4689,9215,Mombasa,COAST,1810
KILINDINI,Urban,7,4623,4345,8968,Mombasa,COAST,1811
KILINDINI,Urban,8,4042,4257,8299,Mombasa,COAST,1812
KILINDINI,Urban,9,4321,4344,8665,Mombasa,COAST,1813
KILINDINI,Urban,10,4077,4110,8187,Mombasa,COAST,1814
KILINDINI,Urban,11,3001,3179,6180,Mombasa,COAST,1815
KILINDINI,Urban,12,3794,3896,7690,Mombasa,COAST,1816
KILINDINI,Urban,13,3281,3558,6839,Mombasa,COAST,1817
KILINDINI,Urban,14,3026,3309,6335,Mombasa,COAST,1818
KILINDINI,Urban,15,3170,3349,6519,Mombasa,COAST,1819
KILINDINI,Urban,16,2869,3483,6352,Mombasa,COAST,1820
KILINDINI,Urban,17,3233,3706,6939,Mombasa,COAST,1821
KILINDINI,Urban,18,3756,4470,8226,Mombasa,COAST,1822
KILINDINI,Urban,19,3507,4449,7956,Mombasa,COAST,1823
KILINDINI,Urban,20,5085,7258,12343,Mombasa,COAST,1824
KILINDINI,Urban,21,4031,4979,9010,Mombasa,COAST,1825
KILINDINI,Urban,22,5597,6709,12306,Mombasa,COAST,1826
KILINDINI,Urban,23,5820,6675,12495,Mombasa,COAST,1827
KILINDINI,Urban,24,5925,6303,12228,Mombasa,COAST,1828
KILINDINI,Urban,25,7632,7708,15340,Mombasa,COAST,1829
KILINDINI,Urban,26,5804,5686,11490,Mombasa,COAST,1830
KILINDINI,Urban,27,6196,5365,11561,Mombasa,COAST,1831
KILINDINI,Urban,28,5937,5575,11512,Mombasa,COAST,1832
KILINDINI,Urban,29,5156,4250,9406,Mombasa,COAST,1833
KILINDINI,Urban,30,8385,6553,14938,Mombasa,COAST,1834
KILINDINI,Urban,31,3852,2445,6297,Mombasa,COAST,1835
KILINDINI,Urban,32,5450,3733,9183,Mombasa,COAST,1836
KILINDINI,Urban,33,3483,2134,5617,Mombasa,COAST,1837
KILINDINI,Urban,34,3773,2372,6145,Mombasa,COAST,1838
KILINDINI,Urban,35,6038,3477,9515,Mombasa,COAST,1839
KILINDINI,Urban,36,3322,2033,5355,Mombasa,COAST,1840
KILINDINI,Urban,37,3112,1809,4921,Mombasa,COAST,1841
KILINDINI,Urban,38,3248,2108,5356,Mombasa,COAST,1842
KILINDINI,Urban,39,2695,1495,4190,Mombasa,COAST,1843
KILINDINI,Urban,40,4479,2661,7140,Mombasa,COAST,1844
KILINDINI,Urban,41,1683,795,2478,Mombasa,COAST,1845
KILINDINI,Urban,42,2162,1154,3316,Mombasa,COAST,1846
KILINDINI,Urban,43,1466,771,2237,Mombasa,COAST,1847
KILINDINI,Urban,44,1245,679,1924,Mombasa,COAST,1848
KILINDINI,Urban,45,2646,1425,4071,Mombasa,COAST,1849
KILINDINI,Urban,46,1549,771,2320,Mombasa,COAST,1850
KILINDINI,Urban,47,1351,686,2037,Mombasa,COAST,1851
KILINDINI,Urban,48,1291,787,2078,Mombasa,COAST,1852
KILINDINI,Urban,49,1205,600,1805,Mombasa,COAST,1853
KILINDINI,Urban,50,1946,1220,3166,Mombasa,COAST,1854
KILINDINI,Urban,51,780,336,1116,Mombasa,COAST,1855
KILINDINI,Urban,52,978,530,1508,Mombasa,COAST,1856
KILINDINI,Urban,53,714,332,1046,Mombasa,COAST,1857
KILINDINI,Urban,54,829,415,1244,Mombasa,COAST,1858
KILINDINI,Urban,55,1061,561,1622,Mombasa,COAST,1859
KILINDINI,Urban,56,705,338,1043,Mombasa,COAST,1860
KILINDINI,Urban,57,615,306,921,Mombasa,COAST,1861
KILINDINI,Urban,58,461,255,716,Mombasa,COAST,1862
KILINDINI,Urban,59,387,236,623,Mombasa,COAST,1863
KILINDINI,Urban,60,754,613,1367,Mombasa,COAST,1864
KILINDINI,Urban,61,297,137,434,Mombasa,COAST,1865
KILINDINI,Urban,62,323,179,502,Mombasa,COAST,1866
KILINDINI,Urban,63,247,126,373,Mombasa,COAST,1867
KILINDINI,Urban,64,225,134,359,Mombasa,COAST,1868
KILINDINI,Urban,65,306,277,583,Mombasa,COAST,1869
KILINDINI,Urban,66,154,102,256,Mombasa,COAST,1870
KILINDINI,Urban,67,176,114,290,Mombasa,COAST,1871
KILINDINI,Urban,68,140,141,281,Mombasa,COAST,1872
KILINDINI,Urban,69,139,142,281,Mombasa,COAST,1873
KILINDINI,Urban,70,305,326,631,Mombasa,COAST,1874
KILINDINI,Urban,71,98,70,168,Mombasa,COAST,1875
KILINDINI,Urban,72,120,92,212,Mombasa,COAST,1876
KILINDINI,Urban,73,101,89,190,Mombasa,COAST,1877
KILINDINI,Urban,74,108,72,180,Mombasa,COAST,1878
KILINDINI,Urban,75,157,144,301,Mombasa,COAST,1879
KILINDINI,Urban,76,81,69,150,Mombasa,COAST,1880
KILINDINI,Urban,77,83,67,150,Mombasa,COAST,1881
KILINDINI,Urban,78,67,74,141,Mombasa,COAST,1882
KILINDINI,Urban,79,73,73,146,Mombasa,COAST,1883
KILINDINI,Urban,80+,476,696,1172,Mombasa,COAST,1884
KILINDINI,Urban,Age NS,168,87,255,Mombasa,COAST,1885
KWALE,Urban,0,314,286,600,Kwale ,COAST,1886
KWALE,Urban,1,288,302,590,Kwale ,COAST,1887
KWALE,Urban,2,320,336,656,Kwale ,COAST,1888
KWALE,Urban,3,355,329,684,Kwale ,COAST,1889
KWALE,Urban,4,286,323,609,Kwale ,COAST,1890
KWALE,Urban,5,277,283,560,Kwale ,COAST,1891
KWALE,Urban,6,245,307,552,Kwale ,COAST,1892
KWALE,Urban,7,280,304,584,Kwale ,COAST,1893
KWALE,Urban,8,253,261,514,Kwale ,COAST,1894
KWALE,Urban,9,327,289,616,Kwale ,COAST,1895
KWALE,Urban,10,281,272,553,Kwale ,COAST,1896
KWALE,Urban,11,215,210,425,Kwale ,COAST,1897
KWALE,Urban,12,265,285,550,Kwale ,COAST,1898
KWALE,Urban,13,281,314,595,Kwale ,COAST,1899
KWALE,Urban,14,215,256,471,Kwale ,COAST,1900
KWALE,Urban,15,223,251,474,Kwale ,COAST,1901
KWALE,Urban,16,227,242,469,Kwale ,COAST,1902
KWALE,Urban,17,200,259,459,Kwale ,COAST,1903
KWALE,Urban,18,225,302,527,Kwale ,COAST,1904
KWALE,Urban,19,162,259,421,Kwale ,COAST,1905
KWALE,Urban,20,200,262,462,Kwale ,COAST,1906
KWALE,Urban,21,146,148,294,Kwale ,COAST,1907
KWALE,Urban,22,183,219,402,Kwale ,COAST,1908
KWALE,Urban,23,154,178,332,Kwale ,COAST,1909
KWALE,Urban,24,149,191,340,Kwale ,COAST,1910
KWALE,Urban,25,202,191,393,Kwale ,COAST,1911
KWALE,Urban,26,151,166,317,Kwale ,COAST,1912
KWALE,Urban,27,147,152,299,Kwale ,COAST,1913
KWALE,Urban,28,124,152,276,Kwale ,COAST,1914
KWALE,Urban,29,136,146,282,Kwale ,COAST,1915
KWALE,Urban,30,210,266,476,Kwale ,COAST,1916
KWALE,Urban,31,98,100,198,Kwale ,COAST,1917
KWALE,Urban,32,127,140,267,Kwale ,COAST,1918
KWALE,Urban,33,76,81,157,Kwale ,COAST,1919
KWALE,Urban,34,122,102,224,Kwale ,COAST,1920
KWALE,Urban,35,147,134,281,Kwale ,COAST,1921
KWALE,Urban,36,97,99,196,Kwale ,COAST,1922
KWALE,Urban,37,94,77,171,Kwale ,COAST,1923
KWALE,Urban,38,94,102,196,Kwale ,COAST,1924
KWALE,Urban,39,84,62,146,Kwale ,COAST,1925
KWALE,Urban,40,131,179,310,Kwale ,COAST,1926
KWALE,Urban,41,61,50,111,Kwale ,COAST,1927
KWALE,Urban,42,93,68,161,Kwale ,COAST,1928
KWALE,Urban,43,52,48,100,Kwale ,COAST,1929
KWALE,Urban,44,56,25,81,Kwale ,COAST,1930
KWALE,Urban,45,100,95,195,Kwale ,COAST,1931
KWALE,Urban,46,72,56,128,Kwale ,COAST,1932
KWALE,Urban,47,69,49,118,Kwale ,COAST,1933
KWALE,Urban,48,54,54,108,Kwale ,COAST,1934
KWALE,Urban,49,51,45,96,Kwale ,COAST,1935
KWALE,Urban,50,90,101,191,Kwale ,COAST,1936
KWALE,Urban,51,43,36,79,Kwale ,COAST,1937
KWALE,Urban,52,59,49,108,Kwale ,COAST,1938
KWALE,Urban,53,46,37,83,Kwale ,COAST,1939
KWALE,Urban,54,36,29,65,Kwale ,COAST,1940
KWALE,Urban,55,56,57,113,Kwale ,COAST,1941
KWALE,Urban,56,52,37,89,Kwale ,COAST,1942
KWALE,Urban,57,46,31,77,Kwale ,COAST,1943
KWALE,Urban,58,33,30,63,Kwale ,COAST,1944
KWALE,Urban,59,24,40,64,Kwale ,COAST,1945
KWALE,Urban,60,57,74,131,Kwale ,COAST,1946
KWALE,Urban,61,26,19,45,Kwale ,COAST,1947
KWALE,Urban,62,25,18,43,Kwale ,COAST,1948
KWALE,Urban,63,21,12,33,Kwale ,COAST,1949
KWALE,Urban,64,25,25,50,Kwale ,COAST,1950
KWALE,Urban,65,43,37,80,Kwale ,COAST,1951
KWALE,Urban,66,14,12,26,Kwale ,COAST,1952
KWALE,Urban,67,22,15,37,Kwale ,COAST,1953
KWALE,Urban,68,21,12,33,Kwale ,COAST,1954
KWALE,Urban,69,17,12,29,Kwale ,COAST,1955
KWALE,Urban,70,37,44,81,Kwale ,COAST,1956
KWALE,Urban,71,11,5,16,Kwale ,COAST,1957
KWALE,Urban,72,12,15,27,Kwale ,COAST,1958
KWALE,Urban,73,10,7,17,Kwale ,COAST,1959
KWALE,Urban,74,12,4,16,Kwale ,COAST,1960
KWALE,Urban,75,14,25,39,Kwale ,COAST,1961
KWALE,Urban,76,11,4,15,Kwale ,COAST,1962
KWALE,Urban,77,9,10,19,Kwale ,COAST,1963
KWALE,Urban,78,8,9,17,Kwale ,COAST,1964
KWALE,Urban,79,5,9,14,Kwale ,COAST,1965
KWALE,Urban,80+,65,80,145,Kwale ,COAST,1966
KWALE,Urban,Age NS,5,4,9,Kwale ,COAST,1967
KINANGO,Urban,0,151,124,275,Kwale ,COAST,1968
KINANGO,Urban,1,113,105,218,Kwale ,COAST,1969
KINANGO,Urban,2,132,115,247,Kwale ,COAST,1970
KINANGO,Urban,3,112,126,238,Kwale ,COAST,1971
KINANGO,Urban,4,125,110,235,Kwale ,COAST,1972
KINANGO,Urban,5,115,99,214,Kwale ,COAST,1973
KINANGO,Urban,6,109,101,210,Kwale ,COAST,1974
KINANGO,Urban,7,110,100,210,Kwale ,COAST,1975
KINANGO,Urban,8,98,90,188,Kwale ,COAST,1976
KINANGO,Urban,9,113,115,228,Kwale ,COAST,1977
KINANGO,Urban,10,118,141,259,Kwale ,COAST,1978
KINANGO,Urban,11,96,90,186,Kwale ,COAST,1979
KINANGO,Urban,12,122,140,262,Kwale ,COAST,1980
KINANGO,Urban,13,105,106,211,Kwale ,COAST,1981
KINANGO,Urban,14,112,110,222,Kwale ,COAST,1982
KINANGO,Urban,15,102,119,221,Kwale ,COAST,1983
KINANGO,Urban,16,96,96,192,Kwale ,COAST,1984
KINANGO,Urban,17,114,95,209,Kwale ,COAST,1985
KINANGO,Urban,18,95,87,182,Kwale ,COAST,1986
KINANGO,Urban,19,84,89,173,Kwale ,COAST,1987
KINANGO,Urban,20,83,112,195,Kwale ,COAST,1988
KINANGO,Urban,21,58,71,129,Kwale ,COAST,1989
KINANGO,Urban,22,58,78,136,Kwale ,COAST,1990
KINANGO,Urban,23,65,65,130,Kwale ,COAST,1991
KINANGO,Urban,24,53,72,125,Kwale ,COAST,1992
KINANGO,Urban,25,60,107,167,Kwale ,COAST,1993
KINANGO,Urban,26,46,53,99,Kwale ,COAST,1994
KINANGO,Urban,27,49,44,93,Kwale ,COAST,1995
KINANGO,Urban,28,48,72,120,Kwale ,COAST,1996
KINANGO,Urban,29,52,38,90,Kwale ,COAST,1997
KINANGO,Urban,30,68,92,160,Kwale ,COAST,1998
KINANGO,Urban,31,36,36,72,Kwale ,COAST,1999
KINANGO,Urban,32,38,48,86,Kwale ,COAST,2000
KINANGO,Urban,33,35,33,68,Kwale ,COAST,2001
KINANGO,Urban,34,28,38,66,Kwale ,COAST,2002
KINANGO,Urban,35,60,66,126,Kwale ,COAST,2003
KINANGO,Urban,36,35,43,78,Kwale ,COAST,2004
KINANGO,Urban,37,29,37,66,Kwale ,COAST,2005
KINANGO,Urban,38,33,38,71,Kwale ,COAST,2006
KINANGO,Urban,39,28,37,65,Kwale ,COAST,2007
KINANGO,Urban,40,56,69,125,Kwale ,COAST,2008
KINANGO,Urban,41,22,18,40,Kwale ,COAST,2009
KINANGO,Urban,42,28,43,71,Kwale ,COAST,2010
KINANGO,Urban,43,16,17,33,Kwale ,COAST,2011
KINANGO,Urban,44,27,14,41,Kwale ,COAST,2012
KINANGO,Urban,45,52,41,93,Kwale ,COAST,2013
KINANGO,Urban,46,29,29,58,Kwale ,COAST,2014
KINANGO,Urban,47,27,17,44,Kwale ,COAST,2015
KINANGO,Urban,48,19,21,40,Kwale ,COAST,2016
KINANGO,Urban,49,33,28,61,Kwale ,COAST,2017
KINANGO,Urban,50,42,49,91,Kwale ,COAST,2018
KINANGO,Urban,51,20,14,34,Kwale ,COAST,2019
KINANGO,Urban,52,19,16,35,Kwale ,COAST,2020
KINANGO,Urban,53,18,20,38,Kwale ,COAST,2021
KINANGO,Urban,54,23,15,38,Kwale ,COAST,2022
KINANGO,Urban,55,31,33,64,Kwale ,COAST,2023
KINANGO,Urban,56,21,10,31,Kwale ,COAST,2024
KINANGO,Urban,57,24,12,36,Kwale ,COAST,2025
KINANGO,Urban,58,10,9,19,Kwale ,COAST,2026
KINANGO,Urban,59,9,21,30,Kwale ,COAST,2027
KINANGO,Urban,60,29,45,74,Kwale ,COAST,2028
KINANGO,Urban,61,6,7,13,Kwale ,COAST,2029
KINANGO,Urban,62,9,14,23,Kwale ,COAST,2030
KINANGO,Urban,63,7,7,14,Kwale ,COAST,2031
KINANGO,Urban,64,9,4,13,Kwale ,COAST,2032
KINANGO,Urban,65,11,23,34,Kwale ,COAST,2033
KINANGO,Urban,66,5,3,8,Kwale ,COAST,2034
KINANGO,Urban,67,9,8,17,Kwale ,COAST,2035
KINANGO,Urban,68,6,7,13,Kwale ,COAST,2036
KINANGO,Urban,69,5,8,13,Kwale ,COAST,2037
KINANGO,Urban,70,19,25,44,Kwale ,COAST,2038
KINANGO,Urban,71,3,5,8,Kwale ,COAST,2039
KINANGO,Urban,72,6,6,12,Kwale ,COAST,2040
KINANGO,Urban,73,2,2,4,Kwale ,COAST,2041
KINANGO,Urban,74,1,3,4,Kwale ,COAST,2042
KINANGO,Urban,75,4,12,16,Kwale ,COAST,2043
KINANGO,Urban,76,4,5,9,Kwale ,COAST,2044
KINANGO,Urban,77,4,4,8,Kwale ,COAST,2045
KINANGO,Urban,78,3,7,10,Kwale ,COAST,2046
KINANGO,Urban,79,6,5,11,Kwale ,COAST,2047
KINANGO,Urban,80+,35,55,90,Kwale ,COAST,2048
KINANGO,Urban,Age NS,4,3,7,Kwale ,COAST,2049
MSAMBWENI,Urban,0,1436,1417,2853,Kwale ,COAST,2050
MSAMBWENI,Urban,1,1172,1154,2326,Kwale ,COAST,2051
MSAMBWENI,Urban,2,1225,1205,2430,Kwale ,COAST,2052
MSAMBWENI,Urban,3,1342,1323,2665,Kwale ,COAST,2053
MSAMBWENI,Urban,4,1250,1204,2454,Kwale ,COAST,2054
MSAMBWENI,Urban,5,1156,1120,2276,Kwale ,COAST,2055
MSAMBWENI,Urban,6,1090,1070,2160,Kwale ,COAST,2056
MSAMBWENI,Urban,7,1073,1090,2163,Kwale ,COAST,2057
MSAMBWENI,Urban,8,1046,1056,2102,Kwale ,COAST,2058
MSAMBWENI,Urban,9,1122,1132,2254,Kwale ,COAST,2059
MSAMBWENI,Urban,10,1099,1087,2186,Kwale ,COAST,2060
MSAMBWENI,Urban,11,715,785,1500,Kwale ,COAST,2061
MSAMBWENI,Urban,12,1037,1024,2061,Kwale ,COAST,2062
MSAMBWENI,Urban,13,986,1042,2028,Kwale ,COAST,2063
MSAMBWENI,Urban,14,924,945,1869,Kwale ,COAST,2064
MSAMBWENI,Urban,15,923,944,1867,Kwale ,COAST,2065
MSAMBWENI,Urban,16,846,896,1742,Kwale ,COAST,2066
MSAMBWENI,Urban,17,823,859,1682,Kwale ,COAST,2067
MSAMBWENI,Urban,18,911,1018,1929,Kwale ,COAST,2068
MSAMBWENI,Urban,19,692,892,1584,Kwale ,COAST,2069
MSAMBWENI,Urban,20,984,1374,2358,Kwale ,COAST,2070
MSAMBWENI,Urban,21,615,829,1444,Kwale ,COAST,2071
MSAMBWENI,Urban,22,932,1105,2037,Kwale ,COAST,2072
MSAMBWENI,Urban,23,848,1074,1922,Kwale ,COAST,2073
MSAMBWENI,Urban,24,882,1163,2045,Kwale ,COAST,2074
MSAMBWENI,Urban,25,1266,1542,2808,Kwale ,COAST,2075
MSAMBWENI,Urban,26,940,1044,1984,Kwale ,COAST,2076
MSAMBWENI,Urban,27,959,976,1935,Kwale ,COAST,2077
MSAMBWENI,Urban,28,968,1018,1986,Kwale ,COAST,2078
MSAMBWENI,Urban,29,738,797,1535,Kwale ,COAST,2079
MSAMBWENI,Urban,30,1541,1476,3017,Kwale ,COAST,2080
MSAMBWENI,Urban,31,627,478,1105,Kwale ,COAST,2081
MSAMBWENI,Urban,32,866,777,1643,Kwale ,COAST,2082
MSAMBWENI,Urban,33,571,475,1046,Kwale ,COAST,2083
MSAMBWENI,Urban,34,619,462,1081,Kwale ,COAST,2084
MSAMBWENI,Urban,35,1184,895,2079,Kwale ,COAST,2085
MSAMBWENI,Urban,36,579,492,1071,Kwale ,COAST,2086
MSAMBWENI,Urban,37,568,373,941,Kwale ,COAST,2087
MSAMBWENI,Urban,38,592,488,1080,Kwale ,COAST,2088
MSAMBWENI,Urban,39,487,333,820,Kwale ,COAST,2089
MSAMBWENI,Urban,40,1092,850,1942,Kwale ,COAST,2090
MSAMBWENI,Urban,41,313,180,493,Kwale ,COAST,2091
MSAMBWENI,Urban,42,489,272,761,Kwale ,COAST,2092
MSAMBWENI,Urban,43,264,199,463,Kwale ,COAST,2093
MSAMBWENI,Urban,44,272,156,428,Kwale ,COAST,2094
MSAMBWENI,Urban,45,647,415,1062,Kwale ,COAST,2095
MSAMBWENI,Urban,46,328,212,540,Kwale ,COAST,2096
MSAMBWENI,Urban,47,270,182,452,Kwale ,COAST,2097
MSAMBWENI,Urban,48,305,229,534,Kwale ,COAST,2098
MSAMBWENI,Urban,49,287,147,434,Kwale ,COAST,2099
MSAMBWENI,Urban,50,514,508,1022,Kwale ,COAST,2100
MSAMBWENI,Urban,51,173,113,286,Kwale ,COAST,2101
MSAMBWENI,Urban,52,222,155,377,Kwale ,COAST,2102
MSAMBWENI,Urban,53,148,88,236,Kwale ,COAST,2103
MSAMBWENI,Urban,54,145,104,249,Kwale ,COAST,2104
MSAMBWENI,Urban,55,249,201,450,Kwale ,COAST,2105
MSAMBWENI,Urban,56,194,110,304,Kwale ,COAST,2106
MSAMBWENI,Urban,57,162,94,256,Kwale ,COAST,2107
MSAMBWENI,Urban,58,140,77,217,Kwale ,COAST,2108
MSAMBWENI,Urban,59,126,73,199,Kwale ,COAST,2109
MSAMBWENI,Urban,60,266,311,577,Kwale ,COAST,2110
MSAMBWENI,Urban,61,76,48,124,Kwale ,COAST,2111
MSAMBWENI,Urban,62,91,53,144,Kwale ,COAST,2112
MSAMBWENI,Urban,63,68,46,114,Kwale ,COAST,2113
MSAMBWENI,Urban,64,84,53,137,Kwale ,COAST,2114
MSAMBWENI,Urban,65,128,127,255,Kwale ,COAST,2115
MSAMBWENI,Urban,66,52,40,92,Kwale ,COAST,2116
MSAMBWENI,Urban,67,65,37,102,Kwale ,COAST,2117
MSAMBWENI,Urban,68,55,58,113,Kwale ,COAST,2118
MSAMBWENI,Urban,69,40,60,100,Kwale ,COAST,2119
MSAMBWENI,Urban,70,137,169,306,Kwale ,COAST,2120
MSAMBWENI,Urban,71,30,21,51,Kwale ,COAST,2121
MSAMBWENI,Urban,72,32,38,70,Kwale ,COAST,2122
MSAMBWENI,Urban,73,25,27,52,Kwale ,COAST,2123
MSAMBWENI,Urban,74,30,18,48,Kwale ,COAST,2124
MSAMBWENI,Urban,75,47,57,104,Kwale ,COAST,2125
MSAMBWENI,Urban,76,25,14,39,Kwale ,COAST,2126
MSAMBWENI,Urban,77,14,11,25,Kwale ,COAST,2127
MSAMBWENI,Urban,78,15,23,38,Kwale ,COAST,2128
MSAMBWENI,Urban,79,20,18,38,Kwale ,COAST,2129
MSAMBWENI,Urban,80+,189,269,458,Kwale ,COAST,2130
MSAMBWENI,Urban,Age NS,27,20,47,Kwale ,COAST,2131
KILIFI,Urban,0,1835,1845,3680,Kilifi,COAST,2132
KILIFI,Urban,1,1472,1481,2953,Kilifi,COAST,2133
KILIFI,Urban,2,1530,1563,3093,Kilifi,COAST,2134
KILIFI,Urban,3,1529,1545,3074,Kilifi,COAST,2135
KILIFI,Urban,4,1531,1517,3048,Kilifi,COAST,2136
KILIFI,Urban,5,1450,1372,2822,Kilifi,COAST,2137
KILIFI,Urban,6,1386,1393,2779,Kilifi,COAST,2138
KILIFI,Urban,7,1408,1386,2794,Kilifi,COAST,2139
KILIFI,Urban,8,1240,1231,2471,Kilifi,COAST,2140
KILIFI,Urban,9,1404,1457,2861,Kilifi,COAST,2141
KILIFI,Urban,10,1322,1339,2661,Kilifi,COAST,2142
KILIFI,Urban,11,973,989,1962,Kilifi,COAST,2143
KILIFI,Urban,12,1213,1239,2452,Kilifi,COAST,2144
KILIFI,Urban,13,1199,1240,2439,Kilifi,COAST,2145
KILIFI,Urban,14,1045,1106,2151,Kilifi,COAST,2146
KILIFI,Urban,15,1059,1134,2193,Kilifi,COAST,2147
KILIFI,Urban,16,989,1080,2069,Kilifi,COAST,2148
KILIFI,Urban,17,1034,1081,2115,Kilifi,COAST,2149
KILIFI,Urban,18,1085,1290,2375,Kilifi,COAST,2150
KILIFI,Urban,19,904,1219,2123,Kilifi,COAST,2151
KILIFI,Urban,20,1237,1781,3018,Kilifi,COAST,2152
KILIFI,Urban,21,910,1077,1987,Kilifi,COAST,2153
KILIFI,Urban,22,1073,1511,2584,Kilifi,COAST,2154
KILIFI,Urban,23,1067,1553,2620,Kilifi,COAST,2155
KILIFI,Urban,24,1149,1483,2632,Kilifi,COAST,2156
KILIFI,Urban,25,1497,1722,3219,Kilifi,COAST,2157
KILIFI,Urban,26,1071,1326,2397,Kilifi,COAST,2158
KILIFI,Urban,27,1150,1197,2347,Kilifi,COAST,2159
KILIFI,Urban,28,1122,1324,2446,Kilifi,COAST,2160
KILIFI,Urban,29,941,1063,2004,Kilifi,COAST,2161
KILIFI,Urban,30,1660,1623,3283,Kilifi,COAST,2162
KILIFI,Urban,31,727,664,1391,Kilifi,COAST,2163
KILIFI,Urban,32,1034,1020,2054,Kilifi,COAST,2164
KILIFI,Urban,33,666,607,1273,Kilifi,COAST,2165
KILIFI,Urban,34,760,613,1373,Kilifi,COAST,2166
KILIFI,Urban,35,1174,952,2126,Kilifi,COAST,2167
KILIFI,Urban,36,692,541,1233,Kilifi,COAST,2168
KILIFI,Urban,37,643,535,1178,Kilifi,COAST,2169
KILIFI,Urban,38,650,602,1252,Kilifi,COAST,2170
KILIFI,Urban,39,552,451,1003,Kilifi,COAST,2171
KILIFI,Urban,40,965,778,1743,Kilifi,COAST,2172
KILIFI,Urban,41,364,318,682,Kilifi,COAST,2173
KILIFI,Urban,42,491,365,856,Kilifi,COAST,2174
KILIFI,Urban,43,344,282,626,Kilifi,COAST,2175
KILIFI,Urban,44,297,238,535,Kilifi,COAST,2176
KILIFI,Urban,45,578,387,965,Kilifi,COAST,2177
KILIFI,Urban,46,389,267,656,Kilifi,COAST,2178
KILIFI,Urban,47,343,213,556,Kilifi,COAST,2179
KILIFI,Urban,48,289,254,543,Kilifi,COAST,2180
KILIFI,Urban,49,305,255,560,Kilifi,COAST,2181
KILIFI,Urban,50,478,471,949,Kilifi,COAST,2182
KILIFI,Urban,51,195,163,358,Kilifi,COAST,2183
KILIFI,Urban,52,236,212,448,Kilifi,COAST,2184
KILIFI,Urban,53,167,133,300,Kilifi,COAST,2185
KILIFI,Urban,54,190,141,331,Kilifi,COAST,2186
KILIFI,Urban,55,246,187,433,Kilifi,COAST,2187
KILIFI,Urban,56,152,131,283,Kilifi,COAST,2188
KILIFI,Urban,57,161,98,259,Kilifi,COAST,2189
KILIFI,Urban,58,108,94,202,Kilifi,COAST,2190
KILIFI,Urban,59,123,109,232,Kilifi,COAST,2191
KILIFI,Urban,60,181,220,401,Kilifi,COAST,2192
KILIFI,Urban,61,91,69,160,Kilifi,COAST,2193
KILIFI,Urban,62,84,62,146,Kilifi,COAST,2194
KILIFI,Urban,63,72,51,123,Kilifi,COAST,2195
KILIFI,Urban,64,76,66,142,Kilifi,COAST,2196
KILIFI,Urban,65,106,141,247,Kilifi,COAST,2197
KILIFI,Urban,66,41,48,89,Kilifi,COAST,2198
KILIFI,Urban,67,54,46,100,Kilifi,COAST,2199
KILIFI,Urban,68,50,58,108,Kilifi,COAST,2200
KILIFI,Urban,69,46,55,101,Kilifi,COAST,2201
KILIFI,Urban,70,80,153,233,Kilifi,COAST,2202
KILIFI,Urban,71,27,43,70,Kilifi,COAST,2203
KILIFI,Urban,72,46,43,89,Kilifi,COAST,2204
KILIFI,Urban,73,24,24,48,Kilifi,COAST,2205
KILIFI,Urban,74,40,35,75,Kilifi,COAST,2206
KILIFI,Urban,75,45,72,117,Kilifi,COAST,2207
KILIFI,Urban,76,24,27,51,Kilifi,COAST,2208
KILIFI,Urban,77,17,24,41,Kilifi,COAST,2209
KILIFI,Urban,78,24,34,58,Kilifi,COAST,2210
KILIFI,Urban,79,38,34,72,Kilifi,COAST,2211
KILIFI,Urban,80+,238,351,589,Kilifi,COAST,2212
KILIFI,Urban,Age NS,61,31,92,Kilifi,COAST,2213
KALOLENI,Urban,0,635,651,1286,Kilifi,COAST,2214
KALOLENI,Urban,1,552,475,1027,Kilifi,COAST,2215
KALOLENI,Urban,2,542,510,1052,Kilifi,COAST,2216
KALOLENI,Urban,3,580,521,1101,Kilifi,COAST,2217
KALOLENI,Urban,4,556,510,1066,Kilifi,COAST,2218
KALOLENI,Urban,5,495,456,951,Kilifi,COAST,2219
KALOLENI,Urban,6,455,433,888,Kilifi,COAST,2220
KALOLENI,Urban,7,429,405,834,Kilifi,COAST,2221
KALOLENI,Urban,8,426,434,860,Kilifi,COAST,2222
KALOLENI,Urban,9,473,448,921,Kilifi,COAST,2223
KALOLENI,Urban,10,416,386,802,Kilifi,COAST,2224
KALOLENI,Urban,11,312,306,618,Kilifi,COAST,2225
KALOLENI,Urban,12,401,440,841,Kilifi,COAST,2226
KALOLENI,Urban,13,358,402,760,Kilifi,COAST,2227
KALOLENI,Urban,14,352,370,722,Kilifi,COAST,2228
KALOLENI,Urban,15,315,346,661,Kilifi,COAST,2229
KALOLENI,Urban,16,305,386,691,Kilifi,COAST,2230
KALOLENI,Urban,17,373,382,755,Kilifi,COAST,2231
KALOLENI,Urban,18,386,402,788,Kilifi,COAST,2232
KALOLENI,Urban,19,337,425,762,Kilifi,COAST,2233
KALOLENI,Urban,20,414,607,1021,Kilifi,COAST,2234
KALOLENI,Urban,21,348,415,763,Kilifi,COAST,2235
KALOLENI,Urban,22,455,589,1044,Kilifi,COAST,2236
KALOLENI,Urban,23,392,522,914,Kilifi,COAST,2237
KALOLENI,Urban,24,385,506,891,Kilifi,COAST,2238
KALOLENI,Urban,25,525,648,1173,Kilifi,COAST,2239
KALOLENI,Urban,26,373,421,794,Kilifi,COAST,2240
KALOLENI,Urban,27,425,387,812,Kilifi,COAST,2241
KALOLENI,Urban,28,345,432,777,Kilifi,COAST,2242
KALOLENI,Urban,29,333,345,678,Kilifi,COAST,2243
KALOLENI,Urban,30,517,488,1005,Kilifi,COAST,2244
KALOLENI,Urban,31,255,218,473,Kilifi,COAST,2245
KALOLENI,Urban,32,334,320,654,Kilifi,COAST,2246
KALOLENI,Urban,33,178,195,373,Kilifi,COAST,2247
KALOLENI,Urban,34,235,206,441,Kilifi,COAST,2248
KALOLENI,Urban,35,403,293,696,Kilifi,COAST,2249
KALOLENI,Urban,36,210,191,401,Kilifi,COAST,2250
KALOLENI,Urban,37,203,172,375,Kilifi,COAST,2251
KALOLENI,Urban,38,204,176,380,Kilifi,COAST,2252
KALOLENI,Urban,39,178,139,317,Kilifi,COAST,2253
KALOLENI,Urban,40,318,276,594,Kilifi,COAST,2254
KALOLENI,Urban,41,129,84,213,Kilifi,COAST,2255
KALOLENI,Urban,42,177,139,316,Kilifi,COAST,2256
KALOLENI,Urban,43,134,78,212,Kilifi,COAST,2257
KALOLENI,Urban,44,88,82,170,Kilifi,COAST,2258
KALOLENI,Urban,45,195,147,342,Kilifi,COAST,2259
KALOLENI,Urban,46,135,93,228,Kilifi,COAST,2260
KALOLENI,Urban,47,95,79,174,Kilifi,COAST,2261
KALOLENI,Urban,48,91,68,159,Kilifi,COAST,2262
KALOLENI,Urban,49,85,83,168,Kilifi,COAST,2263
KALOLENI,Urban,50,155,152,307,Kilifi,COAST,2264
KALOLENI,Urban,51,73,42,115,Kilifi,COAST,2265
KALOLENI,Urban,52,90,54,144,Kilifi,COAST,2266
KALOLENI,Urban,53,65,45,110,Kilifi,COAST,2267
KALOLENI,Urban,54,73,48,121,Kilifi,COAST,2268
KALOLENI,Urban,55,95,68,163,Kilifi,COAST,2269
KALOLENI,Urban,56,84,39,123,Kilifi,COAST,2270
KALOLENI,Urban,57,50,36,86,Kilifi,COAST,2271
KALOLENI,Urban,58,44,28,72,Kilifi,COAST,2272
KALOLENI,Urban,59,35,34,69,Kilifi,COAST,2273
KALOLENI,Urban,60,70,103,173,Kilifi,COAST,2274
KALOLENI,Urban,61,44,23,67,Kilifi,COAST,2275
KALOLENI,Urban,62,33,29,62,Kilifi,COAST,2276
KALOLENI,Urban,63,22,13,35,Kilifi,COAST,2277
KALOLENI,Urban,64,17,24,41,Kilifi,COAST,2278
KALOLENI,Urban,65,33,56,89,Kilifi,COAST,2279
KALOLENI,Urban,66,9,14,23,Kilifi,COAST,2280
KALOLENI,Urban,67,26,29,55,Kilifi,COAST,2281
KALOLENI,Urban,68,22,18,40,Kilifi,COAST,2282
KALOLENI,Urban,69,23,22,45,Kilifi,COAST,2283
KALOLENI,Urban,70,48,64,112,Kilifi,COAST,2284
KALOLENI,Urban,71,12,5,17,Kilifi,COAST,2285
KALOLENI,Urban,72,18,22,40,Kilifi,COAST,2286
KALOLENI,Urban,73,11,13,24,Kilifi,COAST,2287
KALOLENI,Urban,74,9,15,24,Kilifi,COAST,2288
KALOLENI,Urban,75,16,23,39,Kilifi,COAST,2289
KALOLENI,Urban,76,8,10,18,Kilifi,COAST,2290
KALOLENI,Urban,77,7,21,28,Kilifi,COAST,2291
KALOLENI,Urban,78,3,15,18,Kilifi,COAST,2292
KALOLENI,Urban,79,6,13,19,Kilifi,COAST,2293
KALOLENI,Urban,80+,116,159,275,Kilifi,COAST,2294
KALOLENI,Urban,Age NS,22,19,41,Kilifi,COAST,2295
MALINDI,Urban,0,2484,2441,4925,Kilifi,COAST,2296
MALINDI,Urban,1,2068,1969,4037,Kilifi,COAST,2297
MALINDI,Urban,2,2126,2079,4205,Kilifi,COAST,2298
MALINDI,Urban,3,2089,2114,4203,Kilifi,COAST,2299
MALINDI,Urban,4,1883,2028,3911,Kilifi,COAST,2300
MALINDI,Urban,5,1946,1930,3876,Kilifi,COAST,2301
MALINDI,Urban,6,1775,1818,3593,Kilifi,COAST,2302
MALINDI,Urban,7,1772,1734,3506,Kilifi,COAST,2303
MALINDI,Urban,8,1609,1737,3346,Kilifi,COAST,2304
MALINDI,Urban,9,1800,1808,3608,Kilifi,COAST,2305
MALINDI,Urban,10,1738,1649,3387,Kilifi,COAST,2306
MALINDI,Urban,11,1208,1258,2466,Kilifi,COAST,2307
MALINDI,Urban,12,1597,1620,3217,Kilifi,COAST,2308
MALINDI,Urban,13,1386,1481,2867,Kilifi,COAST,2309
MALINDI,Urban,14,1268,1458,2726,Kilifi,COAST,2310
MALINDI,Urban,15,1377,1437,2814,Kilifi,COAST,2311
MALINDI,Urban,16,1344,1405,2749,Kilifi,COAST,2312
MALINDI,Urban,17,1297,1394,2691,Kilifi,COAST,2313
MALINDI,Urban,18,1481,1726,3207,Kilifi,COAST,2314
MALINDI,Urban,19,1283,1520,2803,Kilifi,COAST,2315
MALINDI,Urban,20,1670,2348,4018,Kilifi,COAST,2316
MALINDI,Urban,21,1137,1398,2535,Kilifi,COAST,2317
MALINDI,Urban,22,1511,1931,3442,Kilifi,COAST,2318
MALINDI,Urban,23,1457,1887,3344,Kilifi,COAST,2319
MALINDI,Urban,24,1434,1764,3198,Kilifi,COAST,2320
MALINDI,Urban,25,2024,2131,4155,Kilifi,COAST,2321
MALINDI,Urban,26,1341,1465,2806,Kilifi,COAST,2322
MALINDI,Urban,27,1418,1414,2832,Kilifi,COAST,2323
MALINDI,Urban,28,1420,1532,2952,Kilifi,COAST,2324
MALINDI,Urban,29,1177,1150,2327,Kilifi,COAST,2325
MALINDI,Urban,30,2198,2071,4269,Kilifi,COAST,2326
MALINDI,Urban,31,979,893,1872,Kilifi,COAST,2327
MALINDI,Urban,32,1364,1134,2498,Kilifi,COAST,2328
MALINDI,Urban,33,810,742,1552,Kilifi,COAST,2329
MALINDI,Urban,34,942,815,1757,Kilifi,COAST,2330
MALINDI,Urban,35,1708,1294,3002,Kilifi,COAST,2331
MALINDI,Urban,36,852,662,1514,Kilifi,COAST,2332
MALINDI,Urban,37,805,612,1417,Kilifi,COAST,2333
MALINDI,Urban,38,897,778,1675,Kilifi,COAST,2334
MALINDI,Urban,39,733,571,1304,Kilifi,COAST,2335
MALINDI,Urban,40,1440,1088,2528,Kilifi,COAST,2336
MALINDI,Urban,41,550,349,899,Kilifi,COAST,2337
MALINDI,Urban,42,590,482,1072,Kilifi,COAST,2338
MALINDI,Urban,43,395,301,696,Kilifi,COAST,2339
MALINDI,Urban,44,409,268,677,Kilifi,COAST,2340
MALINDI,Urban,45,826,636,1462,Kilifi,COAST,2341
MALINDI,Urban,46,492,330,822,Kilifi,COAST,2342
MALINDI,Urban,47,371,307,678,Kilifi,COAST,2343
MALINDI,Urban,48,406,362,768,Kilifi,COAST,2344
MALINDI,Urban,49,362,284,646,Kilifi,COAST,2345
MALINDI,Urban,50,644,611,1255,Kilifi,COAST,2346
MALINDI,Urban,51,242,207,449,Kilifi,COAST,2347
MALINDI,Urban,52,327,250,577,Kilifi,COAST,2348
MALINDI,Urban,53,249,157,406,Kilifi,COAST,2349
MALINDI,Urban,54,211,187,398,Kilifi,COAST,2350
MALINDI,Urban,55,348,266,614,Kilifi,COAST,2351
MALINDI,Urban,56,227,172,399,Kilifi,COAST,2352
MALINDI,Urban,57,229,142,371,Kilifi,COAST,2353
MALINDI,Urban,58,191,144,335,Kilifi,COAST,2354
MALINDI,Urban,59,139,136,275,Kilifi,COAST,2355
MALINDI,Urban,60,329,395,724,Kilifi,COAST,2356
MALINDI,Urban,61,142,98,240,Kilifi,COAST,2357
MALINDI,Urban,62,111,95,206,Kilifi,COAST,2358
MALINDI,Urban,63,93,78,171,Kilifi,COAST,2359
MALINDI,Urban,64,103,84,187,Kilifi,COAST,2360
MALINDI,Urban,65,200,213,413,Kilifi,COAST,2361
MALINDI,Urban,66,68,59,127,Kilifi,COAST,2362
MALINDI,Urban,67,93,75,168,Kilifi,COAST,2363
MALINDI,Urban,68,85,77,162,Kilifi,COAST,2364
MALINDI,Urban,69,78,98,176,Kilifi,COAST,2365
MALINDI,Urban,70,211,220,431,Kilifi,COAST,2366
MALINDI,Urban,71,43,42,85,Kilifi,COAST,2367
MALINDI,Urban,72,55,50,105,Kilifi,COAST,2368
MALINDI,Urban,73,49,32,81,Kilifi,COAST,2369
MALINDI,Urban,74,41,36,77,Kilifi,COAST,2370
MALINDI,Urban,75,70,105,175,Kilifi,COAST,2371
MALINDI,Urban,76,38,39,77,Kilifi,COAST,2372
MALINDI,Urban,77,34,37,71,Kilifi,COAST,2373
MALINDI,Urban,78,35,31,66,Kilifi,COAST,2374
MALINDI,Urban,79,37,43,80,Kilifi,COAST,2375
MALINDI,Urban,80+,345,538,883,Kilifi,COAST,2376
MALINDI,Urban,Age NS,57,44,101,Kilifi,COAST,2377
TANA RIVER,Urban,0,684,675,1359,Tana River,COAST,2378
TANA RIVER,Urban,1,597,622,1219,Tana River,COAST,2379
TANA RIVER,Urban,2,645,580,1225,Tana River,COAST,2380
TANA RIVER,Urban,3,646,612,1258,Tana River,COAST,2381
TANA RIVER,Urban,4,593,533,1126,Tana River,COAST,2382
TANA RIVER,Urban,5,644,613,1257,Tana River,COAST,2383
TANA RIVER,Urban,6,550,483,1033,Tana River,COAST,2384
TANA RIVER,Urban,7,489,512,1001,Tana River,COAST,2385
TANA RIVER,Urban,8,465,491,956,Tana River,COAST,2386
TANA RIVER,Urban,9,464,432,896,Tana River,COAST,2387
TANA RIVER,Urban,10,438,435,873,Tana River,COAST,2388
TANA RIVER,Urban,11,321,348,669,Tana River,COAST,2389
TANA RIVER,Urban,12,441,449,890,Tana River,COAST,2390
TANA RIVER,Urban,13,382,415,797,Tana River,COAST,2391
TANA RIVER,Urban,14,389,374,763,Tana River,COAST,2392
TANA RIVER,Urban,15,367,357,724,Tana River,COAST,2393
TANA RIVER,Urban,16,317,319,636,Tana River,COAST,2394
TANA RIVER,Urban,17,361,367,728,Tana River,COAST,2395
TANA RIVER,Urban,18,365,464,829,Tana River,COAST,2396
TANA RIVER,Urban,19,334,377,711,Tana River,COAST,2397
TANA RIVER,Urban,20,354,443,797,Tana River,COAST,2398
TANA RIVER,Urban,21,263,293,556,Tana River,COAST,2399
TANA RIVER,Urban,22,297,336,633,Tana River,COAST,2400
TANA RIVER,Urban,23,272,278,550,Tana River,COAST,2401
TANA RIVER,Urban,24,342,378,720,Tana River,COAST,2402
TANA RIVER,Urban,25,361,416,777,Tana River,COAST,2403
TANA RIVER,Urban,26,243,256,499,Tana River,COAST,2404
TANA RIVER,Urban,27,292,249,541,Tana River,COAST,2405
TANA RIVER,Urban,28,231,284,515,Tana River,COAST,2406
TANA RIVER,Urban,29,252,275,527,Tana River,COAST,2407
TANA RIVER,Urban,30,338,328,666,Tana River,COAST,2408
TANA RIVER,Urban,31,171,126,297,Tana River,COAST,2409
TANA RIVER,Urban,32,208,144,352,Tana River,COAST,2410
TANA RIVER,Urban,33,114,110,224,Tana River,COAST,2411
TANA RIVER,Urban,34,225,198,423,Tana River,COAST,2412
TANA RIVER,Urban,35,282,244,526,Tana River,COAST,2413
TANA RIVER,Urban,36,123,118,241,Tana River,COAST,2414
TANA RIVER,Urban,37,140,98,238,Tana River,COAST,2415
TANA RIVER,Urban,38,119,136,255,Tana River,COAST,2416
TANA RIVER,Urban,39,153,182,335,Tana River,COAST,2417
TANA RIVER,Urban,40,186,203,389,Tana River,COAST,2418
TANA RIVER,Urban,41,94,56,150,Tana River,COAST,2419
TANA RIVER,Urban,42,83,70,153,Tana River,COAST,2420
TANA RIVER,Urban,43,63,59,122,Tana River,COAST,2421
TANA RIVER,Urban,44,111,91,202,Tana River,COAST,2422
TANA RIVER,Urban,45,162,132,294,Tana River,COAST,2423
TANA RIVER,Urban,46,86,72,158,Tana River,COAST,2424
TANA RIVER,Urban,47,99,90,189,Tana River,COAST,2425
TANA RIVER,Urban,48,94,96,190,Tana River,COAST,2426
TANA RIVER,Urban,49,136,101,237,Tana River,COAST,2427
TANA RIVER,Urban,50,125,126,251,Tana River,COAST,2428
TANA RIVER,Urban,51,53,48,101,Tana River,COAST,2429
TANA RIVER,Urban,52,64,43,107,Tana River,COAST,2430
TANA RIVER,Urban,53,47,43,90,Tana River,COAST,2431
TANA RIVER,Urban,54,66,58,124,Tana River,COAST,2432
TANA RIVER,Urban,55,76,70,146,Tana River,COAST,2433
TANA RIVER,Urban,56,46,44,90,Tana River,COAST,2434
TANA RIVER,Urban,57,45,41,86,Tana River,COAST,2435
TANA RIVER,Urban,58,68,27,95,Tana River,COAST,2436
TANA RIVER,Urban,59,45,69,114,Tana River,COAST,2437
TANA RIVER,Urban,60,81,88,169,Tana River,COAST,2438
TANA RIVER,Urban,61,30,28,58,Tana River,COAST,2439
TANA RIVER,Urban,62,28,27,55,Tana River,COAST,2440
TANA RIVER,Urban,63,15,22,37,Tana River,COAST,2441
TANA RIVER,Urban,64,37,39,76,Tana River,COAST,2442
TANA RIVER,Urban,65,29,42,71,Tana River,COAST,2443
TANA RIVER,Urban,66,25,17,42,Tana River,COAST,2444
TANA RIVER,Urban,67,24,13,37,Tana River,COAST,2445
TANA RIVER,Urban,68,31,17,48,Tana River,COAST,2446
TANA RIVER,Urban,69,31,54,85,Tana River,COAST,2447
TANA RIVER,Urban,70,30,49,79,Tana River,COAST,2448
TANA RIVER,Urban,71,10,9,19,Tana River,COAST,2449
TANA RIVER,Urban,72,16,11,27,Tana River,COAST,2450
TANA RIVER,Urban,73,9,12,21,Tana River,COAST,2451
TANA RIVER,Urban,74,19,15,34,Tana River,COAST,2452
TANA RIVER,Urban,75,15,20,35,Tana River,COAST,2453
TANA RIVER,Urban,76,12,6,18,Tana River,COAST,2454
TANA RIVER,Urban,77,7,7,14,Tana River,COAST,2455
TANA RIVER,Urban,78,9,11,20,Tana River,COAST,2456
TANA RIVER,Urban,79,13,18,31,Tana River,COAST,2457
TANA RIVER,Urban,80+,123,139,262,Tana River,COAST,2458
TANA RIVER,Urban,Age NS,7,6,13,Tana River,COAST,2459
TANA DELTA,Urban,0,53,53,106,Tana River,COAST,2460
TANA DELTA,Urban,1,30,46,76,Tana River,COAST,2461
TANA DELTA,Urban,2,50,37,87,Tana River,COAST,2462
TANA DELTA,Urban,3,56,44,100,Tana River,COAST,2463
TANA DELTA,Urban,4,49,47,96,Tana River,COAST,2464
TANA DELTA,Urban,5,45,53,98,Tana River,COAST,2465
TANA DELTA,Urban,6,46,45,91,Tana River,COAST,2466
TANA DELTA,Urban,7,36,31,67,Tana River,COAST,2467
TANA DELTA,Urban,8,47,46,93,Tana River,COAST,2468
TANA DELTA,Urban,9,33,35,68,Tana River,COAST,2469
TANA DELTA,Urban,10,37,48,85,Tana River,COAST,2470
TANA DELTA,Urban,11,14,30,44,Tana River,COAST,2471
TANA DELTA,Urban,12,47,41,88,Tana River,COAST,2472
TANA DELTA,Urban,13,33,43,76,Tana River,COAST,2473
TANA DELTA,Urban,14,28,31,59,Tana River,COAST,2474
TANA DELTA,Urban,15,23,31,54,Tana River,COAST,2475
TANA DELTA,Urban,16,33,22,55,Tana River,COAST,2476
TANA DELTA,Urban,17,27,23,50,Tana River,COAST,2477
TANA DELTA,Urban,18,41,43,84,Tana River,COAST,2478
TANA DELTA,Urban,19,21,31,52,Tana River,COAST,2479
TANA DELTA,Urban,20,53,49,102,Tana River,COAST,2480
TANA DELTA,Urban,21,21,19,40,Tana River,COAST,2481
TANA DELTA,Urban,22,38,36,74,Tana River,COAST,2482
TANA DELTA,Urban,23,29,35,64,Tana River,COAST,2483
TANA DELTA,Urban,24,23,20,43,Tana River,COAST,2484
TANA DELTA,Urban,25,33,49,82,Tana River,COAST,2485
TANA DELTA,Urban,26,27,23,50,Tana River,COAST,2486
TANA DELTA,Urban,27,29,17,46,Tana River,COAST,2487
TANA DELTA,Urban,28,23,19,42,Tana River,COAST,2488
TANA DELTA,Urban,29,18,17,35,Tana River,COAST,2489
TANA DELTA,Urban,30,40,49,89,Tana River,COAST,2490
TANA DELTA,Urban,31,19,12,31,Tana River,COAST,2491
TANA DELTA,Urban,32,20,12,32,Tana River,COAST,2492
TANA DELTA,Urban,33,3,8,11,Tana River,COAST,2493
TANA DELTA,Urban,34,14,9,23,Tana River,COAST,2494
TANA DELTA,Urban,35,32,31,63,Tana River,COAST,2495
TANA DELTA,Urban,36,9,13,22,Tana River,COAST,2496
TANA DELTA,Urban,37,17,5,22,Tana River,COAST,2497
TANA DELTA,Urban,38,13,10,23,Tana River,COAST,2498
TANA DELTA,Urban,39,15,8,23,Tana River,COAST,2499
TANA DELTA,Urban,40,28,35,63,Tana River,COAST,2500
TANA DELTA,Urban,41,13,5,18,Tana River,COAST,2501
TANA DELTA,Urban,42,12,7,19,Tana River,COAST,2502
TANA DELTA,Urban,43,11,9,20,Tana River,COAST,2503
TANA DELTA,Urban,44,4,5,9,Tana River,COAST,2504
TANA DELTA,Urban,45,23,10,33,Tana River,COAST,2505
TANA DELTA,Urban,46,13,7,20,Tana River,COAST,2506
TANA DELTA,Urban,47,9,6,15,Tana River,COAST,2507
TANA DELTA,Urban,48,16,6,22,Tana River,COAST,2508
TANA DELTA,Urban,49,9,2,11,Tana River,COAST,2509
TANA DELTA,Urban,50,19,11,30,Tana River,COAST,2510
TANA DELTA,Urban,51,5,5,10,Tana River,COAST,2511
TANA DELTA,Urban,52,7,7,14,Tana River,COAST,2512
TANA DELTA,Urban,53,5,1,6,Tana River,COAST,2513
TANA DELTA,Urban,54,6,4,10,Tana River,COAST,2514
TANA DELTA,Urban,55,8,7,15,Tana River,COAST,2515
TANA DELTA,Urban,56,11,5,16,Tana River,COAST,2516
TANA DELTA,Urban,57,3,3,6,Tana River,COAST,2517
TANA DELTA,Urban,58,4,2,6,Tana River,COAST,2518
TANA DELTA,Urban,59,2,1,3,Tana River,COAST,2519
TANA DELTA,Urban,60,13,12,25,Tana River,COAST,2520
TANA DELTA,Urban,61,5,2,7,Tana River,COAST,2521
TANA DELTA,Urban,62,1,4,5,Tana River,COAST,2522
TANA DELTA,Urban,63,1,0,1,Tana River,COAST,2523
TANA DELTA,Urban,64,3,1,4,Tana River,COAST,2524
TANA DELTA,Urban,65,6,6,12,Tana River,COAST,2525
TANA DELTA,Urban,66,0,1,1,Tana River,COAST,2526
TANA DELTA,Urban,67,0,0,0,Tana River,COAST,2527
TANA DELTA,Urban,68,1,2,3,Tana River,COAST,2528
TANA DELTA,Urban,69,1,3,4,Tana River,COAST,2529
TANA DELTA,Urban,70,3,9,12,Tana River,COAST,2530
TANA DELTA,Urban,71,3,4,7,Tana River,COAST,2531
TANA DELTA,Urban,72,2,0,2,Tana River,COAST,2532
TANA DELTA,Urban,73,1,2,3,Tana River,COAST,2533
TANA DELTA,Urban,74,1,1,2,Tana River,COAST,2534
TANA DELTA,Urban,75,3,2,5,Tana River,COAST,2535
TANA DELTA,Urban,76,0,1,1,Tana River,COAST,2536
TANA DELTA,Urban,77,1,1,2,Tana River,COAST,2537
TANA DELTA,Urban,78,0,0,0,Tana River,COAST,2538
TANA DELTA,Urban,79,0,0,0,Tana River,COAST,2539
TANA DELTA,Urban,80+,4,10,14,Tana River,COAST,2540
TANA DELTA,Urban,Age NS,2,0,2,Tana River,COAST,2541
LAMU,Urban,0,313,288,601,Lamu,COAST,2542
LAMU,Urban,1,285,265,550,Lamu,COAST,2543
LAMU,Urban,2,316,294,610,Lamu,COAST,2544
LAMU,Urban,3,318,308,626,Lamu,COAST,2545
LAMU,Urban,4,265,262,527,Lamu,COAST,2546
LAMU,Urban,5,242,262,504,Lamu,COAST,2547
LAMU,Urban,6,259,240,499,Lamu,COAST,2548
LAMU,Urban,7,236,250,486,Lamu,COAST,2549
LAMU,Urban,8,238,231,469,Lamu,COAST,2550
LAMU,Urban,9,217,248,465,Lamu,COAST,2551
LAMU,Urban,10,248,220,468,Lamu,COAST,2552
LAMU,Urban,11,169,159,328,Lamu,COAST,2553
LAMU,Urban,12,240,220,460,Lamu,COAST,2554
LAMU,Urban,13,218,253,471,Lamu,COAST,2555
LAMU,Urban,14,200,195,395,Lamu,COAST,2556
LAMU,Urban,15,198,175,373,Lamu,COAST,2557
LAMU,Urban,16,168,219,387,Lamu,COAST,2558
LAMU,Urban,17,210,214,424,Lamu,COAST,2559
LAMU,Urban,18,265,300,565,Lamu,COAST,2560
LAMU,Urban,19,189,218,407,Lamu,COAST,2561
LAMU,Urban,20,243,349,592,Lamu,COAST,2562
LAMU,Urban,21,166,176,342,Lamu,COAST,2563
LAMU,Urban,22,189,243,432,Lamu,COAST,2564
LAMU,Urban,23,195,204,399,Lamu,COAST,2565
LAMU,Urban,24,214,212,426,Lamu,COAST,2566
LAMU,Urban,25,281,315,596,Lamu,COAST,2567
LAMU,Urban,26,202,188,390,Lamu,COAST,2568
LAMU,Urban,27,178,189,367,Lamu,COAST,2569
LAMU,Urban,28,200,189,389,Lamu,COAST,2570
LAMU,Urban,29,150,142,292,Lamu,COAST,2571
LAMU,Urban,30,330,306,636,Lamu,COAST,2572
LAMU,Urban,31,129,87,216,Lamu,COAST,2573
LAMU,Urban,32,156,153,309,Lamu,COAST,2574
LAMU,Urban,33,100,90,190,Lamu,COAST,2575
LAMU,Urban,34,114,93,207,Lamu,COAST,2576
LAMU,Urban,35,259,229,488,Lamu,COAST,2577
LAMU,Urban,36,119,108,227,Lamu,COAST,2578
LAMU,Urban,37,112,81,193,Lamu,COAST,2579
LAMU,Urban,38,118,118,236,Lamu,COAST,2580
LAMU,Urban,39,92,70,162,Lamu,COAST,2581
LAMU,Urban,40,223,228,451,Lamu,COAST,2582
LAMU,Urban,41,68,47,115,Lamu,COAST,2583
LAMU,Urban,42,116,72,188,Lamu,COAST,2584
LAMU,Urban,43,59,44,103,Lamu,COAST,2585
LAMU,Urban,44,52,42,94,Lamu,COAST,2586
LAMU,Urban,45,168,147,315,Lamu,COAST,2587
LAMU,Urban,46,93,56,149,Lamu,COAST,2588
LAMU,Urban,47,56,43,99,Lamu,COAST,2589
LAMU,Urban,48,75,52,127,Lamu,COAST,2590
LAMU,Urban,49,45,42,87,Lamu,COAST,2591
LAMU,Urban,50,168,150,318,Lamu,COAST,2592
LAMU,Urban,51,39,38,77,Lamu,COAST,2593
LAMU,Urban,52,56,34,90,Lamu,COAST,2594
LAMU,Urban,53,22,28,50,Lamu,COAST,2595
LAMU,Urban,54,43,24,67,Lamu,COAST,2596
LAMU,Urban,55,67,77,144,Lamu,COAST,2597
LAMU,Urban,56,43,35,78,Lamu,COAST,2598
LAMU,Urban,57,22,20,42,Lamu,COAST,2599
LAMU,Urban,58,19,23,42,Lamu,COAST,2600
LAMU,Urban,59,18,11,29,Lamu,COAST,2601
LAMU,Urban,60,105,81,186,Lamu,COAST,2602
LAMU,Urban,61,12,13,25,Lamu,COAST,2603
LAMU,Urban,62,17,11,28,Lamu,COAST,2604
LAMU,Urban,63,14,8,22,Lamu,COAST,2605
LAMU,Urban,64,12,16,28,Lamu,COAST,2606
LAMU,Urban,65,29,36,65,Lamu,COAST,2607
LAMU,Urban,66,17,17,34,Lamu,COAST,2608
LAMU,Urban,67,15,6,21,Lamu,COAST,2609
LAMU,Urban,68,8,11,19,Lamu,COAST,2610
LAMU,Urban,69,11,6,17,Lamu,COAST,2611
LAMU,Urban,70,65,80,145,Lamu,COAST,2612
LAMU,Urban,71,4,6,10,Lamu,COAST,2613
LAMU,Urban,72,11,6,17,Lamu,COAST,2614
LAMU,Urban,73,5,4,9,Lamu,COAST,2615
LAMU,Urban,74,2,6,8,Lamu,COAST,2616
LAMU,Urban,75,15,16,31,Lamu,COAST,2617
LAMU,Urban,76,6,6,12,Lamu,COAST,2618
LAMU,Urban,77,2,3,5,Lamu,COAST,2619
LAMU,Urban,78,5,1,6,Lamu,COAST,2620
LAMU,Urban,79,2,2,4,Lamu,COAST,2621
LAMU,Urban,80+,72,93,165,Lamu,COAST,2622
LAMU,Urban,Age NS,10,2,12,Lamu,COAST,2623
TAITA,Urban,0,676,662,1338,Taita Taveta,COAST,2624
TAITA,Urban,1,557,588,1145,Taita Taveta,COAST,2625
TAITA,Urban,2,554,562,1116,Taita Taveta,COAST,2626
TAITA,Urban,3,588,579,1167,Taita Taveta,COAST,2627
TAITA,Urban,4,593,560,1153,Taita Taveta,COAST,2628
TAITA,Urban,5,542,509,1051,Taita Taveta,COAST,2629
TAITA,Urban,6,450,502,952,Taita Taveta,COAST,2630
TAITA,Urban,7,501,455,956,Taita Taveta,COAST,2631
TAITA,Urban,8,427,441,868,Taita Taveta,COAST,2632
TAITA,Urban,9,474,479,953,Taita Taveta,COAST,2633
TAITA,Urban,10,441,452,893,Taita Taveta,COAST,2634
TAITA,Urban,11,407,436,843,Taita Taveta,COAST,2635
TAITA,Urban,12,464,462,926,Taita Taveta,COAST,2636
TAITA,Urban,13,450,528,978,Taita Taveta,COAST,2637
TAITA,Urban,14,417,421,838,Taita Taveta,COAST,2638
TAITA,Urban,15,405,406,811,Taita Taveta,COAST,2639
TAITA,Urban,16,359,412,771,Taita Taveta,COAST,2640
TAITA,Urban,17,433,471,904,Taita Taveta,COAST,2641
TAITA,Urban,18,459,498,957,Taita Taveta,COAST,2642
TAITA,Urban,19,426,444,870,Taita Taveta,COAST,2643
TAITA,Urban,20,473,655,1128,Taita Taveta,COAST,2644
TAITA,Urban,21,444,503,947,Taita Taveta,COAST,2645
TAITA,Urban,22,514,582,1096,Taita Taveta,COAST,2646
TAITA,Urban,23,522,610,1132,Taita Taveta,COAST,2647
TAITA,Urban,24,502,545,1047,Taita Taveta,COAST,2648
TAITA,Urban,25,549,600,1149,Taita Taveta,COAST,2649
TAITA,Urban,26,474,448,922,Taita Taveta,COAST,2650
TAITA,Urban,27,532,471,1003,Taita Taveta,COAST,2651
TAITA,Urban,28,437,456,893,Taita Taveta,COAST,2652
TAITA,Urban,29,466,405,871,Taita Taveta,COAST,2653
TAITA,Urban,30,642,547,1189,Taita Taveta,COAST,2654
TAITA,Urban,31,331,297,628,Taita Taveta,COAST,2655
TAITA,Urban,32,431,375,806,Taita Taveta,COAST,2656
TAITA,Urban,33,327,292,619,Taita Taveta,COAST,2657
TAITA,Urban,34,324,294,618,Taita Taveta,COAST,2658
TAITA,Urban,35,478,387,865,Taita Taveta,COAST,2659
TAITA,Urban,36,292,279,571,Taita Taveta,COAST,2660
TAITA,Urban,37,304,277,581,Taita Taveta,COAST,2661
TAITA,Urban,38,312,259,571,Taita Taveta,COAST,2662
TAITA,Urban,39,265,212,477,Taita Taveta,COAST,2663
TAITA,Urban,40,403,337,740,Taita Taveta,COAST,2664
TAITA,Urban,41,192,161,353,Taita Taveta,COAST,2665
TAITA,Urban,42,215,186,401,Taita Taveta,COAST,2666
TAITA,Urban,43,201,156,357,Taita Taveta,COAST,2667
TAITA,Urban,44,182,153,335,Taita Taveta,COAST,2668
TAITA,Urban,45,272,210,482,Taita Taveta,COAST,2669
TAITA,Urban,46,205,166,371,Taita Taveta,COAST,2670
TAITA,Urban,47,194,155,349,Taita Taveta,COAST,2671
TAITA,Urban,48,155,113,268,Taita Taveta,COAST,2672
TAITA,Urban,49,177,129,306,Taita Taveta,COAST,2673
TAITA,Urban,50,205,162,367,Taita Taveta,COAST,2674
TAITA,Urban,51,123,88,211,Taita Taveta,COAST,2675
TAITA,Urban,52,103,94,197,Taita Taveta,COAST,2676
TAITA,Urban,53,112,93,205,Taita Taveta,COAST,2677
TAITA,Urban,54,106,96,202,Taita Taveta,COAST,2678
TAITA,Urban,55,115,143,258,Taita Taveta,COAST,2679
TAITA,Urban,56,107,74,181,Taita Taveta,COAST,2680
TAITA,Urban,57,102,83,185,Taita Taveta,COAST,2681
TAITA,Urban,58,60,51,111,Taita Taveta,COAST,2682
TAITA,Urban,59,61,61,122,Taita Taveta,COAST,2683
TAITA,Urban,60,86,116,202,Taita Taveta,COAST,2684
TAITA,Urban,61,61,51,112,Taita Taveta,COAST,2685
TAITA,Urban,62,44,37,81,Taita Taveta,COAST,2686
TAITA,Urban,63,42,49,91,Taita Taveta,COAST,2687
TAITA,Urban,64,27,67,94,Taita Taveta,COAST,2688
TAITA,Urban,65,68,80,148,Taita Taveta,COAST,2689
TAITA,Urban,66,23,38,61,Taita Taveta,COAST,2690
TAITA,Urban,67,33,34,67,Taita Taveta,COAST,2691
TAITA,Urban,68,23,30,53,Taita Taveta,COAST,2692
TAITA,Urban,69,23,42,65,Taita Taveta,COAST,2693
TAITA,Urban,70,43,77,120,Taita Taveta,COAST,2694
TAITA,Urban,71,14,23,37,Taita Taveta,COAST,2695
TAITA,Urban,72,20,26,46,Taita Taveta,COAST,2696
TAITA,Urban,73,27,27,54,Taita Taveta,COAST,2697
TAITA,Urban,74,17,23,40,Taita Taveta,COAST,2698
TAITA,Urban,75,28,28,56,Taita Taveta,COAST,2699
TAITA,Urban,76,13,18,31,Taita Taveta,COAST,2700
TAITA,Urban,77,18,15,33,Taita Taveta,COAST,2701
TAITA,Urban,78,13,11,24,Taita Taveta,COAST,2702
TAITA,Urban,79,24,25,49,Taita Taveta,COAST,2703
TAITA,Urban,80+,133,208,341,Taita Taveta,COAST,2704
TAITA,Urban,Age NS,7,8,15,Taita Taveta,COAST,2705
TAVETA,Urban,0,312,301,613,Taita Taveta,COAST,2706
TAVETA,Urban,1,241,278,519,Taita Taveta,COAST,2707
TAVETA,Urban,2,302,244,546,Taita Taveta,COAST,2708
TAVETA,Urban,3,289,274,563,Taita Taveta,COAST,2709
TAVETA,Urban,4,281,302,583,Taita Taveta,COAST,2710
TAVETA,Urban,5,258,287,545,Taita Taveta,COAST,2711
TAVETA,Urban,6,277,235,512,Taita Taveta,COAST,2712
TAVETA,Urban,7,265,245,510,Taita Taveta,COAST,2713
TAVETA,Urban,8,245,234,479,Taita Taveta,COAST,2714
TAVETA,Urban,9,249,254,503,Taita Taveta,COAST,2715
TAVETA,Urban,10,248,250,498,Taita Taveta,COAST,2716
TAVETA,Urban,11,168,218,386,Taita Taveta,COAST,2717
TAVETA,Urban,12,224,229,453,Taita Taveta,COAST,2718
TAVETA,Urban,13,205,225,430,Taita Taveta,COAST,2719
TAVETA,Urban,14,197,213,410,Taita Taveta,COAST,2720
TAVETA,Urban,15,198,228,426,Taita Taveta,COAST,2721
TAVETA,Urban,16,177,204,381,Taita Taveta,COAST,2722
TAVETA,Urban,17,188,216,404,Taita Taveta,COAST,2723
TAVETA,Urban,18,207,184,391,Taita Taveta,COAST,2724
TAVETA,Urban,19,155,225,380,Taita Taveta,COAST,2725
TAVETA,Urban,20,216,279,495,Taita Taveta,COAST,2726
TAVETA,Urban,21,178,177,355,Taita Taveta,COAST,2727
TAVETA,Urban,22,188,240,428,Taita Taveta,COAST,2728
TAVETA,Urban,23,183,214,397,Taita Taveta,COAST,2729
TAVETA,Urban,24,188,187,375,Taita Taveta,COAST,2730
TAVETA,Urban,25,221,267,488,Taita Taveta,COAST,2731
TAVETA,Urban,26,178,203,381,Taita Taveta,COAST,2732
TAVETA,Urban,27,171,194,365,Taita Taveta,COAST,2733
TAVETA,Urban,28,177,194,371,Taita Taveta,COAST,2734
TAVETA,Urban,29,191,167,358,Taita Taveta,COAST,2735
TAVETA,Urban,30,296,220,516,Taita Taveta,COAST,2736
TAVETA,Urban,31,149,101,250,Taita Taveta,COAST,2737
TAVETA,Urban,32,164,172,336,Taita Taveta,COAST,2738
TAVETA,Urban,33,117,91,208,Taita Taveta,COAST,2739
TAVETA,Urban,34,151,117,268,Taita Taveta,COAST,2740
TAVETA,Urban,35,214,199,413,Taita Taveta,COAST,2741
TAVETA,Urban,36,138,114,252,Taita Taveta,COAST,2742
TAVETA,Urban,37,133,108,241,Taita Taveta,COAST,2743
TAVETA,Urban,38,124,123,247,Taita Taveta,COAST,2744
TAVETA,Urban,39,110,112,222,Taita Taveta,COAST,2745
TAVETA,Urban,40,176,158,334,Taita Taveta,COAST,2746
TAVETA,Urban,41,75,71,146,Taita Taveta,COAST,2747
TAVETA,Urban,42,102,80,182,Taita Taveta,COAST,2748
TAVETA,Urban,43,75,62,137,Taita Taveta,COAST,2749
TAVETA,Urban,44,86,50,136,Taita Taveta,COAST,2750
TAVETA,Urban,45,142,88,230,Taita Taveta,COAST,2751
TAVETA,Urban,46,97,64,161,Taita Taveta,COAST,2752
TAVETA,Urban,47,71,65,136,Taita Taveta,COAST,2753
TAVETA,Urban,48,76,65,141,Taita Taveta,COAST,2754
TAVETA,Urban,49,72,46,118,Taita Taveta,COAST,2755
TAVETA,Urban,50,85,87,172,Taita Taveta,COAST,2756
TAVETA,Urban,51,56,41,97,Taita Taveta,COAST,2757
TAVETA,Urban,52,64,31,95,Taita Taveta,COAST,2758
TAVETA,Urban,53,41,28,69,Taita Taveta,COAST,2759
TAVETA,Urban,54,34,31,65,Taita Taveta,COAST,2760
TAVETA,Urban,55,55,33,88,Taita Taveta,COAST,2761
TAVETA,Urban,56,37,32,69,Taita Taveta,COAST,2762
TAVETA,Urban,57,36,28,64,Taita Taveta,COAST,2763
TAVETA,Urban,58,16,26,42,Taita Taveta,COAST,2764
TAVETA,Urban,59,29,27,56,Taita Taveta,COAST,2765
TAVETA,Urban,60,52,55,107,Taita Taveta,COAST,2766
TAVETA,Urban,61,33,16,49,Taita Taveta,COAST,2767
TAVETA,Urban,62,31,13,44,Taita Taveta,COAST,2768
TAVETA,Urban,63,23,12,35,Taita Taveta,COAST,2769
TAVETA,Urban,64,29,15,44,Taita Taveta,COAST,2770
TAVETA,Urban,65,24,24,48,Taita Taveta,COAST,2771
TAVETA,Urban,66,20,6,26,Taita Taveta,COAST,2772
TAVETA,Urban,67,24,17,41,Taita Taveta,COAST,2773
TAVETA,Urban,68,18,5,23,Taita Taveta,COAST,2774
TAVETA,Urban,69,12,17,29,Taita Taveta,COAST,2775
TAVETA,Urban,70,22,27,49,Taita Taveta,COAST,2776
TAVETA,Urban,71,7,11,18,Taita Taveta,COAST,2777
TAVETA,Urban,72,12,12,24,Taita Taveta,COAST,2778
TAVETA,Urban,73,11,10,21,Taita Taveta,COAST,2779
TAVETA,Urban,74,12,10,22,Taita Taveta,COAST,2780
TAVETA,Urban,75,12,9,21,Taita Taveta,COAST,2781
TAVETA,Urban,76,5,8,13,Taita Taveta,COAST,2782
TAVETA,Urban,77,11,3,14,Taita Taveta,COAST,2783
TAVETA,Urban,78,7,6,13,Taita Taveta,COAST,2784
TAVETA,Urban,79,9,11,20,Taita Taveta,COAST,2785
TAVETA,Urban,80+,67,89,156,Taita Taveta,COAST,2786
TAVETA,Urban,Age NS,9,3,12,Taita Taveta,COAST,2787
MARSABIT,Urban,0,223,208,431,Marsabit,EASTERN,2788
MARSABIT,Urban,1,163,158,321,Marsabit,EASTERN,2789
MARSABIT,Urban,2,223,212,435,Marsabit,EASTERN,2790
MARSABIT,Urban,3,225,214,439,Marsabit,EASTERN,2791
MARSABIT,Urban,4,194,203,397,Marsabit,EASTERN,2792
MARSABIT,Urban,5,225,195,420,Marsabit,EASTERN,2793
MARSABIT,Urban,6,197,190,387,Marsabit,EASTERN,2794
MARSABIT,Urban,7,227,238,465,Marsabit,EASTERN,2795
MARSABIT,Urban,8,203,222,425,Marsabit,EASTERN,2796
MARSABIT,Urban,9,189,208,397,Marsabit,EASTERN,2797
MARSABIT,Urban,10,245,250,495,Marsabit,EASTERN,2798
MARSABIT,Urban,11,167,163,330,Marsabit,EASTERN,2799
MARSABIT,Urban,12,236,228,464,Marsabit,EASTERN,2800
MARSABIT,Urban,13,201,237,438,Marsabit,EASTERN,2801
MARSABIT,Urban,14,186,187,373,Marsabit,EASTERN,2802
MARSABIT,Urban,15,184,254,438,Marsabit,EASTERN,2803
MARSABIT,Urban,16,188,189,377,Marsabit,EASTERN,2804
MARSABIT,Urban,17,200,185,385,Marsabit,EASTERN,2805
MARSABIT,Urban,18,214,213,427,Marsabit,EASTERN,2806
MARSABIT,Urban,19,125,140,265,Marsabit,EASTERN,2807
MARSABIT,Urban,20,176,237,413,Marsabit,EASTERN,2808
MARSABIT,Urban,21,104,99,203,Marsabit,EASTERN,2809
MARSABIT,Urban,22,165,135,300,Marsabit,EASTERN,2810
MARSABIT,Urban,23,150,124,274,Marsabit,EASTERN,2811
MARSABIT,Urban,24,140,148,288,Marsabit,EASTERN,2812
MARSABIT,Urban,25,188,192,380,Marsabit,EASTERN,2813
MARSABIT,Urban,26,116,106,222,Marsabit,EASTERN,2814
MARSABIT,Urban,27,117,91,208,Marsabit,EASTERN,2815
MARSABIT,Urban,28,100,121,221,Marsabit,EASTERN,2816
MARSABIT,Urban,29,74,67,141,Marsabit,EASTERN,2817
MARSABIT,Urban,30,196,211,407,Marsabit,EASTERN,2818
MARSABIT,Urban,31,65,46,111,Marsabit,EASTERN,2819
MARSABIT,Urban,32,94,77,171,Marsabit,EASTERN,2820
MARSABIT,Urban,33,60,51,111,Marsabit,EASTERN,2821
MARSABIT,Urban,34,74,51,125,Marsabit,EASTERN,2822
MARSABIT,Urban,35,157,139,296,Marsabit,EASTERN,2823
MARSABIT,Urban,36,69,67,136,Marsabit,EASTERN,2824
MARSABIT,Urban,37,67,44,111,Marsabit,EASTERN,2825
MARSABIT,Urban,38,81,68,149,Marsabit,EASTERN,2826
MARSABIT,Urban,39,39,36,75,Marsabit,EASTERN,2827
MARSABIT,Urban,40,109,160,269,Marsabit,EASTERN,2828
MARSABIT,Urban,41,39,14,53,Marsabit,EASTERN,2829
MARSABIT,Urban,42,60,43,103,Marsabit,EASTERN,2830
MARSABIT,Urban,43,36,28,64,Marsabit,EASTERN,2831
MARSABIT,Urban,44,33,27,60,Marsabit,EASTERN,2832
MARSABIT,Urban,45,103,88,191,Marsabit,EASTERN,2833
MARSABIT,Urban,46,53,33,86,Marsabit,EASTERN,2834
MARSABIT,Urban,47,47,34,81,Marsabit,EASTERN,2835
MARSABIT,Urban,48,48,49,97,Marsabit,EASTERN,2836
MARSABIT,Urban,49,37,28,65,Marsabit,EASTERN,2837
MARSABIT,Urban,50,99,104,203,Marsabit,EASTERN,2838
MARSABIT,Urban,51,29,19,48,Marsabit,EASTERN,2839
MARSABIT,Urban,52,41,26,67,Marsabit,EASTERN,2840
MARSABIT,Urban,53,22,16,38,Marsabit,EASTERN,2841
MARSABIT,Urban,54,28,19,47,Marsabit,EASTERN,2842
MARSABIT,Urban,55,40,37,77,Marsabit,EASTERN,2843
MARSABIT,Urban,56,30,19,49,Marsabit,EASTERN,2844
MARSABIT,Urban,57,25,16,41,Marsabit,EASTERN,2845
MARSABIT,Urban,58,23,11,34,Marsabit,EASTERN,2846
MARSABIT,Urban,59,13,17,30,Marsabit,EASTERN,2847
MARSABIT,Urban,60,53,72,125,Marsabit,EASTERN,2848
MARSABIT,Urban,61,8,14,22,Marsabit,EASTERN,2849
MARSABIT,Urban,62,18,11,29,Marsabit,EASTERN,2850
MARSABIT,Urban,63,8,11,19,Marsabit,EASTERN,2851
MARSABIT,Urban,64,14,8,22,Marsabit,EASTERN,2852
MARSABIT,Urban,65,30,29,59,Marsabit,EASTERN,2853
MARSABIT,Urban,66,14,4,18,Marsabit,EASTERN,2854
MARSABIT,Urban,67,13,6,19,Marsabit,EASTERN,2855
MARSABIT,Urban,68,9,11,20,Marsabit,EASTERN,2856
MARSABIT,Urban,69,7,5,12,Marsabit,EASTERN,2857
MARSABIT,Urban,70,36,45,81,Marsabit,EASTERN,2858
MARSABIT,Urban,71,5,4,9,Marsabit,EASTERN,2859
MARSABIT,Urban,72,18,9,27,Marsabit,EASTERN,2860
MARSABIT,Urban,73,13,7,20,Marsabit,EASTERN,2861
MARSABIT,Urban,74,8,0,8,Marsabit,EASTERN,2862
MARSABIT,Urban,75,15,12,27,Marsabit,EASTERN,2863
MARSABIT,Urban,76,6,2,8,Marsabit,EASTERN,2864
MARSABIT,Urban,77,5,6,11,Marsabit,EASTERN,2865
MARSABIT,Urban,78,3,2,5,Marsabit,EASTERN,2866
MARSABIT,Urban,79,7,3,10,Marsabit,EASTERN,2867
MARSABIT,Urban,80+,71,129,200,Marsabit,EASTERN,2868
MARSABIT,Urban,Age NS,2,0,2,Marsabit,EASTERN,2869
CHALBI,Urban,0,0,0,0,Marsabit,EASTERN,2870
CHALBI,Urban,1,0,0,0,Marsabit,EASTERN,2871
CHALBI,Urban,2,0,0,0,Marsabit,EASTERN,2872
CHALBI,Urban,3,0,0,0,Marsabit,EASTERN,2873
CHALBI,Urban,4,0,0,0,Marsabit,EASTERN,2874
CHALBI,Urban,5,0,0,0,Marsabit,EASTERN,2875
CHALBI,Urban,6,0,0,0,Marsabit,EASTERN,2876
CHALBI,Urban,7,0,0,0,Marsabit,EASTERN,2877
CHALBI,Urban,8,0,0,0,Marsabit,EASTERN,2878
CHALBI,Urban,9,0,0,0,Marsabit,EASTERN,2879
CHALBI,Urban,10,0,0,0,Marsabit,EASTERN,2880
CHALBI,Urban,11,0,0,0,Marsabit,EASTERN,2881
CHALBI,Urban,12,0,0,0,Marsabit,EASTERN,2882
CHALBI,Urban,13,0,0,0,Marsabit,EASTERN,2883
CHALBI,Urban,14,0,0,0,Marsabit,EASTERN,2884
CHALBI,Urban,15,0,0,0,Marsabit,EASTERN,2885
CHALBI,Urban,16,0,0,0,Marsabit,EASTERN,2886
CHALBI,Urban,17,0,0,0,Marsabit,EASTERN,2887
CHALBI,Urban,18,0,0,0,Marsabit,EASTERN,2888
CHALBI,Urban,19,0,0,0,Marsabit,EASTERN,2889
CHALBI,Urban,20,0,0,0,Marsabit,EASTERN,2890
CHALBI,Urban,21,0,0,0,Marsabit,EASTERN,2891
CHALBI,Urban,22,0,0,0,Marsabit,EASTERN,2892
CHALBI,Urban,23,0,0,0,Marsabit,EASTERN,2893
CHALBI,Urban,24,0,0,0,Marsabit,EASTERN,2894
CHALBI,Urban,25,0,0,0,Marsabit,EASTERN,2895
CHALBI,Urban,26,0,0,0,Marsabit,EASTERN,2896
CHALBI,Urban,27,0,0,0,Marsabit,EASTERN,2897
CHALBI,Urban,28,0,0,0,Marsabit,EASTERN,2898
CHALBI,Urban,29,0,0,0,Marsabit,EASTERN,2899
CHALBI,Urban,30,0,0,0,Marsabit,EASTERN,2900
CHALBI,Urban,31,0,0,0,Marsabit,EASTERN,2901
CHALBI,Urban,32,0,0,0,Marsabit,EASTERN,2902
CHALBI,Urban,33,0,0,0,Marsabit,EASTERN,2903
CHALBI,Urban,34,0,0,0,Marsabit,EASTERN,2904
CHALBI,Urban,35,0,0,0,Marsabit,EASTERN,2905
CHALBI,Urban,36,0,0,0,Marsabit,EASTERN,2906
CHALBI,Urban,37,0,0,0,Marsabit,EASTERN,2907
CHALBI,Urban,38,0,0,0,Marsabit,EASTERN,2908
CHALBI,Urban,39,0,0,0,Marsabit,EASTERN,2909
CHALBI,Urban,40,0,0,0,Marsabit,EASTERN,2910
CHALBI,Urban,41,0,0,0,Marsabit,EASTERN,2911
CHALBI,Urban,42,0,0,0,Marsabit,EASTERN,2912
CHALBI,Urban,43,0,0,0,Marsabit,EASTERN,2913
CHALBI,Urban,44,0,0,0,Marsabit,EASTERN,2914
CHALBI,Urban,45,0,0,0,Marsabit,EASTERN,2915
CHALBI,Urban,46,0,0,0,Marsabit,EASTERN,2916
CHALBI,Urban,47,0,0,0,Marsabit,EASTERN,2917
CHALBI,Urban,48,0,0,0,Marsabit,EASTERN,2918
CHALBI,Urban,49,0,0,0,Marsabit,EASTERN,2919
CHALBI,Urban,50,0,0,0,Marsabit,EASTERN,2920
CHALBI,Urban,51,0,0,0,Marsabit,EASTERN,2921
CHALBI,Urban,52,0,0,0,Marsabit,EASTERN,2922
CHALBI,Urban,53,0,0,0,Marsabit,EASTERN,2923
CHALBI,Urban,54,0,0,0,Marsabit,EASTERN,2924
CHALBI,Urban,55,0,0,0,Marsabit,EASTERN,2925
CHALBI,Urban,56,0,0,0,Marsabit,EASTERN,2926
CHALBI,Urban,57,0,0,0,Marsabit,EASTERN,2927
CHALBI,Urban,58,0,0,0,Marsabit,EASTERN,2928
CHALBI,Urban,59,0,0,0,Marsabit,EASTERN,2929
CHALBI,Urban,60,0,0,0,Marsabit,EASTERN,2930
CHALBI,Urban,61,0,0,0,Marsabit,EASTERN,2931
CHALBI,Urban,62,0,0,0,Marsabit,EASTERN,2932
CHALBI,Urban,63,0,0,0,Marsabit,EASTERN,2933
CHALBI,Urban,64,0,0,0,Marsabit,EASTERN,2934
CHALBI,Urban,65,0,0,0,Marsabit,EASTERN,2935
CHALBI,Urban,66,0,0,0,Marsabit,EASTERN,2936
CHALBI,Urban,67,0,0,0,Marsabit,EASTERN,2937
CHALBI,Urban,68,0,0,0,Marsabit,EASTERN,2938
CHALBI,Urban,69,0,0,0,Marsabit,EASTERN,2939
CHALBI,Urban,70,0,0,0,Marsabit,EASTERN,2940
CHALBI,Urban,71,0,0,0,Marsabit,EASTERN,2941
CHALBI,Urban,72,0,0,0,Marsabit,EASTERN,2942
CHALBI,Urban,73,0,0,0,Marsabit,EASTERN,2943
CHALBI,Urban,74,0,0,0,Marsabit,EASTERN,2944
CHALBI,Urban,75,0,0,0,Marsabit,EASTERN,2945
CHALBI,Urban,76,0,0,0,Marsabit,EASTERN,2946
CHALBI,Urban,77,0,0,0,Marsabit,EASTERN,2947
CHALBI,Urban,78,0,0,0,Marsabit,EASTERN,2948
CHALBI,Urban,79,0,0,0,Marsabit,EASTERN,2949
CHALBI,Urban,80+,0,0,0,Marsabit,EASTERN,2950
CHALBI,Urban,Age NS,0,0,0,Marsabit,EASTERN,2951
LAISAMIS,Urban,0,124,110,234,Marsabit,EASTERN,2952
LAISAMIS,Urban,1,130,122,252,Marsabit,EASTERN,2953
LAISAMIS,Urban,2,155,133,288,Marsabit,EASTERN,2954
LAISAMIS,Urban,3,130,144,274,Marsabit,EASTERN,2955
LAISAMIS,Urban,4,127,127,254,Marsabit,EASTERN,2956
LAISAMIS,Urban,5,138,115,253,Marsabit,EASTERN,2957
LAISAMIS,Urban,6,101,119,220,Marsabit,EASTERN,2958
LAISAMIS,Urban,7,99,102,201,Marsabit,EASTERN,2959
LAISAMIS,Urban,8,91,102,193,Marsabit,EASTERN,2960
LAISAMIS,Urban,9,71,77,148,Marsabit,EASTERN,2961
LAISAMIS,Urban,10,108,138,246,Marsabit,EASTERN,2962
LAISAMIS,Urban,11,60,67,127,Marsabit,EASTERN,2963
LAISAMIS,Urban,12,75,113,188,Marsabit,EASTERN,2964
LAISAMIS,Urban,13,69,83,152,Marsabit,EASTERN,2965
LAISAMIS,Urban,14,66,89,155,Marsabit,EASTERN,2966
LAISAMIS,Urban,15,79,99,178,Marsabit,EASTERN,2967
LAISAMIS,Urban,16,78,65,143,Marsabit,EASTERN,2968
LAISAMIS,Urban,17,71,61,132,Marsabit,EASTERN,2969
LAISAMIS,Urban,18,71,67,138,Marsabit,EASTERN,2970
LAISAMIS,Urban,19,54,38,92,Marsabit,EASTERN,2971
LAISAMIS,Urban,20,60,93,153,Marsabit,EASTERN,2972
LAISAMIS,Urban,21,46,79,125,Marsabit,EASTERN,2973
LAISAMIS,Urban,22,45,46,91,Marsabit,EASTERN,2974
LAISAMIS,Urban,23,59,61,120,Marsabit,EASTERN,2975
LAISAMIS,Urban,24,51,66,117,Marsabit,EASTERN,2976
LAISAMIS,Urban,25,56,56,112,Marsabit,EASTERN,2977
LAISAMIS,Urban,26,47,43,90,Marsabit,EASTERN,2978
LAISAMIS,Urban,27,37,17,54,Marsabit,EASTERN,2979
LAISAMIS,Urban,28,31,56,87,Marsabit,EASTERN,2980
LAISAMIS,Urban,29,21,20,41,Marsabit,EASTERN,2981
LAISAMIS,Urban,30,64,77,141,Marsabit,EASTERN,2982
LAISAMIS,Urban,31,28,19,47,Marsabit,EASTERN,2983
LAISAMIS,Urban,32,38,59,97,Marsabit,EASTERN,2984
LAISAMIS,Urban,33,24,23,47,Marsabit,EASTERN,2985
LAISAMIS,Urban,34,23,17,40,Marsabit,EASTERN,2986
LAISAMIS,Urban,35,37,43,80,Marsabit,EASTERN,2987
LAISAMIS,Urban,36,24,43,67,Marsabit,EASTERN,2988
LAISAMIS,Urban,37,12,18,30,Marsabit,EASTERN,2989
LAISAMIS,Urban,38,18,33,51,Marsabit,EASTERN,2990
LAISAMIS,Urban,39,9,13,22,Marsabit,EASTERN,2991
LAISAMIS,Urban,40,45,63,108,Marsabit,EASTERN,2992
LAISAMIS,Urban,41,17,20,37,Marsabit,EASTERN,2993
LAISAMIS,Urban,42,17,22,39,Marsabit,EASTERN,2994
LAISAMIS,Urban,43,8,11,19,Marsabit,EASTERN,2995
LAISAMIS,Urban,44,12,17,29,Marsabit,EASTERN,2996
LAISAMIS,Urban,45,30,36,66,Marsabit,EASTERN,2997
LAISAMIS,Urban,46,15,14,29,Marsabit,EASTERN,2998
LAISAMIS,Urban,47,14,13,27,Marsabit,EASTERN,2999
LAISAMIS,Urban,48,24,18,42,Marsabit,EASTERN,3000
LAISAMIS,Urban,49,19,14,33,Marsabit,EASTERN,3001
LAISAMIS,Urban,50,30,44,74,Marsabit,EASTERN,3002
LAISAMIS,Urban,51,9,12,21,Marsabit,EASTERN,3003
LAISAMIS,Urban,52,13,15,28,Marsabit,EASTERN,3004
LAISAMIS,Urban,53,8,12,20,Marsabit,EASTERN,3005
LAISAMIS,Urban,54,12,15,27,Marsabit,EASTERN,3006
LAISAMIS,Urban,55,14,19,33,Marsabit,EASTERN,3007
LAISAMIS,Urban,56,9,9,18,Marsabit,EASTERN,3008
LAISAMIS,Urban,57,13,9,22,Marsabit,EASTERN,3009
LAISAMIS,Urban,58,5,9,14,Marsabit,EASTERN,3010
LAISAMIS,Urban,59,4,8,12,Marsabit,EASTERN,3011
LAISAMIS,Urban,60,14,27,41,Marsabit,EASTERN,3012
LAISAMIS,Urban,61,11,14,25,Marsabit,EASTERN,3013
LAISAMIS,Urban,62,10,13,23,Marsabit,EASTERN,3014
LAISAMIS,Urban,63,5,6,11,Marsabit,EASTERN,3015
LAISAMIS,Urban,64,5,10,15,Marsabit,EASTERN,3016
LAISAMIS,Urban,65,15,15,30,Marsabit,EASTERN,3017
LAISAMIS,Urban,66,4,8,12,Marsabit,EASTERN,3018
LAISAMIS,Urban,67,7,6,13,Marsabit,EASTERN,3019
LAISAMIS,Urban,68,7,9,16,Marsabit,EASTERN,3020
LAISAMIS,Urban,69,7,3,10,Marsabit,EASTERN,3021
LAISAMIS,Urban,70,16,39,55,Marsabit,EASTERN,3022
LAISAMIS,Urban,71,6,4,10,Marsabit,EASTERN,3023
LAISAMIS,Urban,72,4,5,9,Marsabit,EASTERN,3024
LAISAMIS,Urban,73,4,4,8,Marsabit,EASTERN,3025
LAISAMIS,Urban,74,6,6,12,Marsabit,EASTERN,3026
LAISAMIS,Urban,75,6,14,20,Marsabit,EASTERN,3027
LAISAMIS,Urban,76,1,8,9,Marsabit,EASTERN,3028
LAISAMIS,Urban,77,0,5,5,Marsabit,EASTERN,3029
LAISAMIS,Urban,78,2,9,11,Marsabit,EASTERN,3030
LAISAMIS,Urban,79,3,5,8,Marsabit,EASTERN,3031
LAISAMIS,Urban,80+,29,56,85,Marsabit,EASTERN,3032
LAISAMIS,Urban,Age NS,3,1,4,Marsabit,EASTERN,3033
MOYALE,Urban,0,607,589,1196,Marsabit,EASTERN,3034
MOYALE,Urban,1,492,469,961,Marsabit,EASTERN,3035
MOYALE,Urban,2,734,604,1338,Marsabit,EASTERN,3036
MOYALE,Urban,3,669,662,1331,Marsabit,EASTERN,3037
MOYALE,Urban,4,756,664,1420,Marsabit,EASTERN,3038
MOYALE,Urban,5,625,638,1263,Marsabit,EASTERN,3039
MOYALE,Urban,6,767,697,1464,Marsabit,EASTERN,3040
MOYALE,Urban,7,675,655,1330,Marsabit,EASTERN,3041
MOYALE,Urban,8,827,827,1654,Marsabit,EASTERN,3042
MOYALE,Urban,9,583,604,1187,Marsabit,EASTERN,3043
MOYALE,Urban,10,904,902,1806,Marsabit,EASTERN,3044
MOYALE,Urban,11,461,468,929,Marsabit,EASTERN,3045
MOYALE,Urban,12,816,774,1590,Marsabit,EASTERN,3046
MOYALE,Urban,13,637,700,1337,Marsabit,EASTERN,3047
MOYALE,Urban,14,704,661,1365,Marsabit,EASTERN,3048
MOYALE,Urban,15,737,777,1514,Marsabit,EASTERN,3049
MOYALE,Urban,16,728,647,1375,Marsabit,EASTERN,3050
MOYALE,Urban,17,610,483,1093,Marsabit,EASTERN,3051
MOYALE,Urban,18,860,773,1633,Marsabit,EASTERN,3052
MOYALE,Urban,19,384,319,703,Marsabit,EASTERN,3053
MOYALE,Urban,20,806,733,1539,Marsabit,EASTERN,3054
MOYALE,Urban,21,240,211,451,Marsabit,EASTERN,3055
MOYALE,Urban,22,398,386,784,Marsabit,EASTERN,3056
MOYALE,Urban,23,262,224,486,Marsabit,EASTERN,3057
MOYALE,Urban,24,260,260,520,Marsabit,EASTERN,3058
MOYALE,Urban,25,487,565,1052,Marsabit,EASTERN,3059
MOYALE,Urban,26,204,202,406,Marsabit,EASTERN,3060
MOYALE,Urban,27,194,214,408,Marsabit,EASTERN,3061
MOYALE,Urban,28,253,291,544,Marsabit,EASTERN,3062
MOYALE,Urban,29,121,89,210,Marsabit,EASTERN,3063
MOYALE,Urban,30,519,574,1093,Marsabit,EASTERN,3064
MOYALE,Urban,31,98,96,194,Marsabit,EASTERN,3065
MOYALE,Urban,32,166,178,344,Marsabit,EASTERN,3066
MOYALE,Urban,33,110,105,215,Marsabit,EASTERN,3067
MOYALE,Urban,34,97,96,193,Marsabit,EASTERN,3068
MOYALE,Urban,35,319,429,748,Marsabit,EASTERN,3069
MOYALE,Urban,36,122,109,231,Marsabit,EASTERN,3070
MOYALE,Urban,37,101,94,195,Marsabit,EASTERN,3071
MOYALE,Urban,38,129,181,310,Marsabit,EASTERN,3072
MOYALE,Urban,39,50,52,102,Marsabit,EASTERN,3073
MOYALE,Urban,40,411,439,850,Marsabit,EASTERN,3074
MOYALE,Urban,41,68,47,115,Marsabit,EASTERN,3075
MOYALE,Urban,42,113,85,198,Marsabit,EASTERN,3076
MOYALE,Urban,43,44,52,96,Marsabit,EASTERN,3077
MOYALE,Urban,44,54,37,91,Marsabit,EASTERN,3078
MOYALE,Urban,45,241,278,519,Marsabit,EASTERN,3079
MOYALE,Urban,46,71,59,130,Marsabit,EASTERN,3080
MOYALE,Urban,47,60,54,114,Marsabit,EASTERN,3081
MOYALE,Urban,48,75,96,171,Marsabit,EASTERN,3082
MOYALE,Urban,49,49,46,95,Marsabit,EASTERN,3083
MOYALE,Urban,50,305,346,651,Marsabit,EASTERN,3084
MOYALE,Urban,51,41,42,83,Marsabit,EASTERN,3085
MOYALE,Urban,52,72,62,134,Marsabit,EASTERN,3086
MOYALE,Urban,53,37,25,62,Marsabit,EASTERN,3087
MOYALE,Urban,54,44,26,70,Marsabit,EASTERN,3088
MOYALE,Urban,55,113,98,211,Marsabit,EASTERN,3089
MOYALE,Urban,56,48,33,81,Marsabit,EASTERN,3090
MOYALE,Urban,57,57,23,80,Marsabit,EASTERN,3091
MOYALE,Urban,58,46,30,76,Marsabit,EASTERN,3092
MOYALE,Urban,59,28,16,44,Marsabit,EASTERN,3093
MOYALE,Urban,60,202,222,424,Marsabit,EASTERN,3094
MOYALE,Urban,61,9,27,36,Marsabit,EASTERN,3095
MOYALE,Urban,62,33,36,69,Marsabit,EASTERN,3096
MOYALE,Urban,63,21,16,37,Marsabit,EASTERN,3097
MOYALE,Urban,64,23,21,44,Marsabit,EASTERN,3098
MOYALE,Urban,65,71,66,137,Marsabit,EASTERN,3099
MOYALE,Urban,66,23,25,48,Marsabit,EASTERN,3100
MOYALE,Urban,67,18,14,32,Marsabit,EASTERN,3101
MOYALE,Urban,68,39,7,46,Marsabit,EASTERN,3102
MOYALE,Urban,69,7,17,24,Marsabit,EASTERN,3103
MOYALE,Urban,70,140,242,382,Marsabit,EASTERN,3104
MOYALE,Urban,71,12,17,29,Marsabit,EASTERN,3105
MOYALE,Urban,72,25,23,48,Marsabit,EASTERN,3106
MOYALE,Urban,73,12,20,32,Marsabit,EASTERN,3107
MOYALE,Urban,74,11,9,20,Marsabit,EASTERN,3108
MOYALE,Urban,75,39,43,82,Marsabit,EASTERN,3109
MOYALE,Urban,76,20,8,28,Marsabit,EASTERN,3110
MOYALE,Urban,77,9,10,19,Marsabit,EASTERN,3111
MOYALE,Urban,78,25,17,42,Marsabit,EASTERN,3112
MOYALE,Urban,79,13,3,16,Marsabit,EASTERN,3113
MOYALE,Urban,80+,213,292,505,Marsabit,EASTERN,3114
MOYALE,Urban,Age NS,5,2,7,Marsabit,EASTERN,3115
ISIOLO,Urban,0,850,804,1654,Isiolo,EASTERN,3116
ISIOLO,Urban,1,747,663,1410,Isiolo,EASTERN,3117
ISIOLO,Urban,2,823,752,1575,Isiolo,EASTERN,3118
ISIOLO,Urban,3,904,830,1734,Isiolo,EASTERN,3119
ISIOLO,Urban,4,791,772,1563,Isiolo,EASTERN,3120
ISIOLO,Urban,5,791,738,1529,Isiolo,EASTERN,3121
ISIOLO,Urban,6,735,725,1460,Isiolo,EASTERN,3122
ISIOLO,Urban,7,752,711,1463,Isiolo,EASTERN,3123
ISIOLO,Urban,8,704,729,1433,Isiolo,EASTERN,3124
ISIOLO,Urban,9,675,650,1325,Isiolo,EASTERN,3125
ISIOLO,Urban,10,805,731,1536,Isiolo,EASTERN,3126
ISIOLO,Urban,11,519,566,1085,Isiolo,EASTERN,3127
ISIOLO,Urban,12,768,727,1495,Isiolo,EASTERN,3128
ISIOLO,Urban,13,678,705,1383,Isiolo,EASTERN,3129
ISIOLO,Urban,14,636,658,1294,Isiolo,EASTERN,3130
ISIOLO,Urban,15,632,696,1328,Isiolo,EASTERN,3131
ISIOLO,Urban,16,603,677,1280,Isiolo,EASTERN,3132
ISIOLO,Urban,17,605,611,1216,Isiolo,EASTERN,3133
ISIOLO,Urban,18,679,741,1420,Isiolo,EASTERN,3134
ISIOLO,Urban,19,413,516,929,Isiolo,EASTERN,3135
ISIOLO,Urban,20,650,877,1527,Isiolo,EASTERN,3136
ISIOLO,Urban,21,397,461,858,Isiolo,EASTERN,3137
ISIOLO,Urban,22,515,673,1188,Isiolo,EASTERN,3138
ISIOLO,Urban,23,422,620,1042,Isiolo,EASTERN,3139
ISIOLO,Urban,24,481,525,1006,Isiolo,EASTERN,3140
ISIOLO,Urban,25,656,847,1503,Isiolo,EASTERN,3141
ISIOLO,Urban,26,406,448,854,Isiolo,EASTERN,3142
ISIOLO,Urban,27,428,455,883,Isiolo,EASTERN,3143
ISIOLO,Urban,28,432,495,927,Isiolo,EASTERN,3144
ISIOLO,Urban,29,327,342,669,Isiolo,EASTERN,3145
ISIOLO,Urban,30,735,775,1510,Isiolo,EASTERN,3146
ISIOLO,Urban,31,229,189,418,Isiolo,EASTERN,3147
ISIOLO,Urban,32,339,360,699,Isiolo,EASTERN,3148
ISIOLO,Urban,33,182,194,376,Isiolo,EASTERN,3149
ISIOLO,Urban,34,204,191,395,Isiolo,EASTERN,3150
ISIOLO,Urban,35,540,574,1114,Isiolo,EASTERN,3151
ISIOLO,Urban,36,219,199,418,Isiolo,EASTERN,3152
ISIOLO,Urban,37,200,187,387,Isiolo,EASTERN,3153
ISIOLO,Urban,38,233,265,498,Isiolo,EASTERN,3154
ISIOLO,Urban,39,164,153,317,Isiolo,EASTERN,3155
ISIOLO,Urban,40,479,553,1032,Isiolo,EASTERN,3156
ISIOLO,Urban,41,118,84,202,Isiolo,EASTERN,3157
ISIOLO,Urban,42,187,184,371,Isiolo,EASTERN,3158
ISIOLO,Urban,43,138,120,258,Isiolo,EASTERN,3159
ISIOLO,Urban,44,107,114,221,Isiolo,EASTERN,3160
ISIOLO,Urban,45,370,346,716,Isiolo,EASTERN,3161
ISIOLO,Urban,46,147,150,297,Isiolo,EASTERN,3162
ISIOLO,Urban,47,139,140,279,Isiolo,EASTERN,3163
ISIOLO,Urban,48,191,154,345,Isiolo,EASTERN,3164
ISIOLO,Urban,49,160,112,272,Isiolo,EASTERN,3165
ISIOLO,Urban,50,338,370,708,Isiolo,EASTERN,3166
ISIOLO,Urban,51,102,83,185,Isiolo,EASTERN,3167
ISIOLO,Urban,52,145,101,246,Isiolo,EASTERN,3168
ISIOLO,Urban,53,106,80,186,Isiolo,EASTERN,3169
ISIOLO,Urban,54,86,54,140,Isiolo,EASTERN,3170
ISIOLO,Urban,55,164,169,333,Isiolo,EASTERN,3171
ISIOLO,Urban,56,102,72,174,Isiolo,EASTERN,3172
ISIOLO,Urban,57,77,56,133,Isiolo,EASTERN,3173
ISIOLO,Urban,58,74,48,122,Isiolo,EASTERN,3174
ISIOLO,Urban,59,57,55,112,Isiolo,EASTERN,3175
ISIOLO,Urban,60,213,257,470,Isiolo,EASTERN,3176
ISIOLO,Urban,61,30,36,66,Isiolo,EASTERN,3177
ISIOLO,Urban,62,41,56,97,Isiolo,EASTERN,3178
ISIOLO,Urban,63,42,32,74,Isiolo,EASTERN,3179
ISIOLO,Urban,64,35,33,68,Isiolo,EASTERN,3180
ISIOLO,Urban,65,102,90,192,Isiolo,EASTERN,3181
ISIOLO,Urban,66,25,28,53,Isiolo,EASTERN,3182
ISIOLO,Urban,67,48,18,66,Isiolo,EASTERN,3183
ISIOLO,Urban,68,30,37,67,Isiolo,EASTERN,3184
ISIOLO,Urban,69,22,24,46,Isiolo,EASTERN,3185
ISIOLO,Urban,70,152,196,348,Isiolo,EASTERN,3186
ISIOLO,Urban,71,14,23,37,Isiolo,EASTERN,3187
ISIOLO,Urban,72,29,26,55,Isiolo,EASTERN,3188
ISIOLO,Urban,73,20,17,37,Isiolo,EASTERN,3189
ISIOLO,Urban,74,25,31,56,Isiolo,EASTERN,3190
ISIOLO,Urban,75,46,43,89,Isiolo,EASTERN,3191
ISIOLO,Urban,76,23,29,52,Isiolo,EASTERN,3192
ISIOLO,Urban,77,17,17,34,Isiolo,EASTERN,3193
ISIOLO,Urban,78,29,14,43,Isiolo,EASTERN,3194
ISIOLO,Urban,79,23,25,48,Isiolo,EASTERN,3195
ISIOLO,Urban,80+,233,328,561,Isiolo,EASTERN,3196
ISIOLO,Urban,Age NS,28,20,48,Isiolo,EASTERN,3197
GARBATULLA,Urban,0,135,127,262,Isiolo,EASTERN,3198
GARBATULLA,Urban,1,123,101,224,Isiolo,EASTERN,3199
GARBATULLA,Urban,2,148,157,305,Isiolo,EASTERN,3200
GARBATULLA,Urban,3,158,136,294,Isiolo,EASTERN,3201
GARBATULLA,Urban,4,177,142,319,Isiolo,EASTERN,3202
GARBATULLA,Urban,5,139,145,284,Isiolo,EASTERN,3203
GARBATULLA,Urban,6,148,136,284,Isiolo,EASTERN,3204
GARBATULLA,Urban,7,133,139,272,Isiolo,EASTERN,3205
GARBATULLA,Urban,8,149,116,265,Isiolo,EASTERN,3206
GARBATULLA,Urban,9,131,88,219,Isiolo,EASTERN,3207
GARBATULLA,Urban,10,137,133,270,Isiolo,EASTERN,3208
GARBATULLA,Urban,11,104,87,191,Isiolo,EASTERN,3209
GARBATULLA,Urban,12,148,123,271,Isiolo,EASTERN,3210
GARBATULLA,Urban,13,140,124,264,Isiolo,EASTERN,3211
GARBATULLA,Urban,14,140,115,255,Isiolo,EASTERN,3212
GARBATULLA,Urban,15,106,119,225,Isiolo,EASTERN,3213
GARBATULLA,Urban,16,120,110,230,Isiolo,EASTERN,3214
GARBATULLA,Urban,17,112,96,208,Isiolo,EASTERN,3215
GARBATULLA,Urban,18,108,95,203,Isiolo,EASTERN,3216
GARBATULLA,Urban,19,72,59,131,Isiolo,EASTERN,3217
GARBATULLA,Urban,20,121,124,245,Isiolo,EASTERN,3218
GARBATULLA,Urban,21,63,53,116,Isiolo,EASTERN,3219
GARBATULLA,Urban,22,73,83,156,Isiolo,EASTERN,3220
GARBATULLA,Urban,23,63,69,132,Isiolo,EASTERN,3221
GARBATULLA,Urban,24,62,63,125,Isiolo,EASTERN,3222
GARBATULLA,Urban,25,91,118,209,Isiolo,EASTERN,3223
GARBATULLA,Urban,26,68,60,128,Isiolo,EASTERN,3224
GARBATULLA,Urban,27,50,49,99,Isiolo,EASTERN,3225
GARBATULLA,Urban,28,64,65,129,Isiolo,EASTERN,3226
GARBATULLA,Urban,29,31,34,65,Isiolo,EASTERN,3227
GARBATULLA,Urban,30,89,90,179,Isiolo,EASTERN,3228
GARBATULLA,Urban,31,34,35,69,Isiolo,EASTERN,3229
GARBATULLA,Urban,32,41,33,74,Isiolo,EASTERN,3230
GARBATULLA,Urban,33,19,22,41,Isiolo,EASTERN,3231
GARBATULLA,Urban,34,19,23,42,Isiolo,EASTERN,3232
GARBATULLA,Urban,35,57,84,141,Isiolo,EASTERN,3233
GARBATULLA,Urban,36,42,34,76,Isiolo,EASTERN,3234
GARBATULLA,Urban,37,21,14,35,Isiolo,EASTERN,3235
GARBATULLA,Urban,38,38,41,79,Isiolo,EASTERN,3236
GARBATULLA,Urban,39,9,15,24,Isiolo,EASTERN,3237
GARBATULLA,Urban,40,63,84,147,Isiolo,EASTERN,3238
GARBATULLA,Urban,41,12,8,20,Isiolo,EASTERN,3239
GARBATULLA,Urban,42,18,30,48,Isiolo,EASTERN,3240
GARBATULLA,Urban,43,14,15,29,Isiolo,EASTERN,3241
GARBATULLA,Urban,44,12,15,27,Isiolo,EASTERN,3242
GARBATULLA,Urban,45,45,54,99,Isiolo,EASTERN,3243
GARBATULLA,Urban,46,29,25,54,Isiolo,EASTERN,3244
GARBATULLA,Urban,47,28,24,52,Isiolo,EASTERN,3245
GARBATULLA,Urban,48,39,25,64,Isiolo,EASTERN,3246
GARBATULLA,Urban,49,9,16,25,Isiolo,EASTERN,3247
GARBATULLA,Urban,50,55,86,141,Isiolo,EASTERN,3248
GARBATULLA,Urban,51,14,20,34,Isiolo,EASTERN,3249
GARBATULLA,Urban,52,23,15,38,Isiolo,EASTERN,3250
GARBATULLA,Urban,53,11,12,23,Isiolo,EASTERN,3251
GARBATULLA,Urban,54,16,15,31,Isiolo,EASTERN,3252
GARBATULLA,Urban,55,31,23,54,Isiolo,EASTERN,3253
GARBATULLA,Urban,56,23,13,36,Isiolo,EASTERN,3254
GARBATULLA,Urban,57,15,7,22,Isiolo,EASTERN,3255
GARBATULLA,Urban,58,15,14,29,Isiolo,EASTERN,3256
GARBATULLA,Urban,59,7,8,15,Isiolo,EASTERN,3257
GARBATULLA,Urban,60,39,42,81,Isiolo,EASTERN,3258
GARBATULLA,Urban,61,6,9,15,Isiolo,EASTERN,3259
GARBATULLA,Urban,62,11,24,35,Isiolo,EASTERN,3260
GARBATULLA,Urban,63,13,7,20,Isiolo,EASTERN,3261
GARBATULLA,Urban,64,12,8,20,Isiolo,EASTERN,3262
GARBATULLA,Urban,65,23,18,41,Isiolo,EASTERN,3263
GARBATULLA,Urban,66,12,7,19,Isiolo,EASTERN,3264
GARBATULLA,Urban,67,9,3,12,Isiolo,EASTERN,3265
GARBATULLA,Urban,68,9,9,18,Isiolo,EASTERN,3266
GARBATULLA,Urban,69,4,5,9,Isiolo,EASTERN,3267
GARBATULLA,Urban,70,22,42,64,Isiolo,EASTERN,3268
GARBATULLA,Urban,71,8,6,14,Isiolo,EASTERN,3269
GARBATULLA,Urban,72,9,6,15,Isiolo,EASTERN,3270
GARBATULLA,Urban,73,5,7,12,Isiolo,EASTERN,3271
GARBATULLA,Urban,74,5,8,13,Isiolo,EASTERN,3272
GARBATULLA,Urban,75,9,10,19,Isiolo,EASTERN,3273
GARBATULLA,Urban,76,11,11,22,Isiolo,EASTERN,3274
GARBATULLA,Urban,77,6,2,8,Isiolo,EASTERN,3275
GARBATULLA,Urban,78,7,15,22,Isiolo,EASTERN,3276
GARBATULLA,Urban,79,7,5,12,Isiolo,EASTERN,3277
GARBATULLA,Urban,80+,60,73,133,Isiolo,EASTERN,3278
GARBATULLA,Urban,Age NS,2,0,2,Isiolo,EASTERN,3279
MERU CENTRAL,Urban,0,0,0,0,Meru,EASTERN,3280
MERU CENTRAL,Urban,1,0,0,0,Meru,EASTERN,3281
MERU CENTRAL,Urban,2,0,0,0,Meru,EASTERN,3282
MERU CENTRAL,Urban,3,0,0,0,Meru,EASTERN,3283
MERU CENTRAL,Urban,4,0,0,0,Meru,EASTERN,3284
MERU CENTRAL,Urban,5,0,0,0,Meru,EASTERN,3285
MERU CENTRAL,Urban,6,0,0,0,Meru,EASTERN,3286
MERU CENTRAL,Urban,7,0,0,0,Meru,EASTERN,3287
MERU CENTRAL,Urban,8,0,0,0,Meru,EASTERN,3288
MERU CENTRAL,Urban,9,0,0,0,Meru,EASTERN,3289
MERU CENTRAL,Urban,10,0,0,0,Meru,EASTERN,3290
MERU CENTRAL,Urban,11,0,0,0,Meru,EASTERN,3291
MERU CENTRAL,Urban,12,0,0,0,Meru,EASTERN,3292
MERU CENTRAL,Urban,13,0,0,0,Meru,EASTERN,3293
MERU CENTRAL,Urban,14,0,0,0,Meru,EASTERN,3294
MERU CENTRAL,Urban,15,0,0,0,Meru,EASTERN,3295
MERU CENTRAL,Urban,16,0,0,0,Meru,EASTERN,3296
MERU CENTRAL,Urban,17,0,0,0,Meru,EASTERN,3297
MERU CENTRAL,Urban,18,0,0,0,Meru,EASTERN,3298
MERU CENTRAL,Urban,19,0,0,0,Meru,EASTERN,3299
MERU CENTRAL,Urban,20,0,0,0,Meru,EASTERN,3300
MERU CENTRAL,Urban,21,0,0,0,Meru,EASTERN,3301
MERU CENTRAL,Urban,22,0,0,0,Meru,EASTERN,3302
MERU CENTRAL,Urban,23,0,0,0,Meru,EASTERN,3303
MERU CENTRAL,Urban,24,0,0,0,Meru,EASTERN,3304
MERU CENTRAL,Urban,25,0,0,0,Meru,EASTERN,3305
MERU CENTRAL,Urban,26,0,0,0,Meru,EASTERN,3306
MERU CENTRAL,Urban,27,0,0,0,Meru,EASTERN,3307
MERU CENTRAL,Urban,28,0,0,0,Meru,EASTERN,3308
MERU CENTRAL,Urban,29,0,0,0,Meru,EASTERN,3309
MERU CENTRAL,Urban,30,0,0,0,Meru,EASTERN,3310
MERU CENTRAL,Urban,31,0,0,0,Meru,EASTERN,3311
MERU CENTRAL,Urban,32,0,0,0,Meru,EASTERN,3312
MERU CENTRAL,Urban,33,0,0,0,Meru,EASTERN,3313
MERU CENTRAL,Urban,34,0,0,0,Meru,EASTERN,3314
MERU CENTRAL,Urban,35,0,0,0,Meru,EASTERN,3315
MERU CENTRAL,Urban,36,0,0,0,Meru,EASTERN,3316
MERU CENTRAL,Urban,37,0,0,0,Meru,EASTERN,3317
MERU CENTRAL,Urban,38,0,0,0,Meru,EASTERN,3318
MERU CENTRAL,Urban,39,0,0,0,Meru,EASTERN,3319
MERU CENTRAL,Urban,40,0,0,0,Meru,EASTERN,3320
MERU CENTRAL,Urban,41,0,0,0,Meru,EASTERN,3321
MERU CENTRAL,Urban,42,0,0,0,Meru,EASTERN,3322
MERU CENTRAL,Urban,43,0,0,0,Meru,EASTERN,3323
MERU CENTRAL,Urban,44,0,0,0,Meru,EASTERN,3324
MERU CENTRAL,Urban,45,0,0,0,Meru,EASTERN,3325
MERU CENTRAL,Urban,46,0,0,0,Meru,EASTERN,3326
MERU CENTRAL,Urban,47,0,0,0,Meru,EASTERN,3327
MERU CENTRAL,Urban,48,0,0,0,Meru,EASTERN,3328
MERU CENTRAL,Urban,49,0,0,0,Meru,EASTERN,3329
MERU CENTRAL,Urban,50,0,0,0,Meru,EASTERN,3330
MERU CENTRAL,Urban,51,0,0,0,Meru,EASTERN,3331
MERU CENTRAL,Urban,52,0,0,0,Meru,EASTERN,3332
MERU CENTRAL,Urban,53,0,0,0,Meru,EASTERN,3333
MERU CENTRAL,Urban,54,0,0,0,Meru,EASTERN,3334
MERU CENTRAL,Urban,55,0,0,0,Meru,EASTERN,3335
MERU CENTRAL,Urban,56,0,0,0,Meru,EASTERN,3336
MERU CENTRAL,Urban,57,0,0,0,Meru,EASTERN,3337
MERU CENTRAL,Urban,58,0,0,0,Meru,EASTERN,3338
MERU CENTRAL,Urban,59,0,0,0,Meru,EASTERN,3339
MERU CENTRAL,Urban,60,0,0,0,Meru,EASTERN,3340
MERU CENTRAL,Urban,61,0,0,0,Meru,EASTERN,3341
MERU CENTRAL,Urban,62,0,0,0,Meru,EASTERN,3342
MERU CENTRAL,Urban,63,0,0,0,Meru,EASTERN,3343
MERU CENTRAL,Urban,64,0,0,0,Meru,EASTERN,3344
MERU CENTRAL,Urban,65,0,0,0,Meru,EASTERN,3345
MERU CENTRAL,Urban,66,0,0,0,Meru,EASTERN,3346
MERU CENTRAL,Urban,67,0,0,0,Meru,EASTERN,3347
MERU CENTRAL,Urban,68,0,0,0,Meru,EASTERN,3348
MERU CENTRAL,Urban,69,0,0,0,Meru,EASTERN,3349
MERU CENTRAL,Urban,70,0,0,0,Meru,EASTERN,3350
MERU CENTRAL,Urban,71,0,0,0,Meru,EASTERN,3351
MERU CENTRAL,Urban,72,0,0,0,Meru,EASTERN,3352
MERU CENTRAL,Urban,73,0,0,0,Meru,EASTERN,3353
MERU CENTRAL,Urban,74,0,0,0,Meru,EASTERN,3354
MERU CENTRAL,Urban,75,0,0,0,Meru,EASTERN,3355
MERU CENTRAL,Urban,76,0,0,0,Meru,EASTERN,3356
MERU CENTRAL,Urban,77,0,0,0,Meru,EASTERN,3357
MERU CENTRAL,Urban,78,0,0,0,Meru,EASTERN,3358
MERU CENTRAL,Urban,79,0,0,0,Meru,EASTERN,3359
MERU CENTRAL,Urban,80+,0,0,0,Meru,EASTERN,3360
MERU CENTRAL,Urban,Age NS,0,0,0,Meru,EASTERN,3361
IMENTI NORTH,Urban,0,934,940,1874,Meru,EASTERN,3362
IMENTI NORTH,Urban,1,741,716,1457,Meru,EASTERN,3363
IMENTI NORTH,Urban,2,782,813,1595,Meru,EASTERN,3364
IMENTI NORTH,Urban,3,724,745,1469,Meru,EASTERN,3365
IMENTI NORTH,Urban,4,720,735,1455,Meru,EASTERN,3366
IMENTI NORTH,Urban,5,726,715,1441,Meru,EASTERN,3367
IMENTI NORTH,Urban,6,665,690,1355,Meru,EASTERN,3368
IMENTI NORTH,Urban,7,659,646,1305,Meru,EASTERN,3369
IMENTI NORTH,Urban,8,641,616,1257,Meru,EASTERN,3370
IMENTI NORTH,Urban,9,656,669,1325,Meru,EASTERN,3371
IMENTI NORTH,Urban,10,683,683,1366,Meru,EASTERN,3372
IMENTI NORTH,Urban,11,535,509,1044,Meru,EASTERN,3373
IMENTI NORTH,Urban,12,661,619,1280,Meru,EASTERN,3374
IMENTI NORTH,Urban,13,564,639,1203,Meru,EASTERN,3375
IMENTI NORTH,Urban,14,594,586,1180,Meru,EASTERN,3376
IMENTI NORTH,Urban,15,550,581,1131,Meru,EASTERN,3377
IMENTI NORTH,Urban,16,484,647,1131,Meru,EASTERN,3378
IMENTI NORTH,Urban,17,502,655,1157,Meru,EASTERN,3379
IMENTI NORTH,Urban,18,599,753,1352,Meru,EASTERN,3380
IMENTI NORTH,Urban,19,552,686,1238,Meru,EASTERN,3381
IMENTI NORTH,Urban,20,759,1083,1842,Meru,EASTERN,3382
IMENTI NORTH,Urban,21,578,810,1388,Meru,EASTERN,3383
IMENTI NORTH,Urban,22,746,1019,1765,Meru,EASTERN,3384
IMENTI NORTH,Urban,23,759,1000,1759,Meru,EASTERN,3385
IMENTI NORTH,Urban,24,843,1031,1874,Meru,EASTERN,3386
IMENTI NORTH,Urban,25,1053,1247,2300,Meru,EASTERN,3387
IMENTI NORTH,Urban,26,808,952,1760,Meru,EASTERN,3388
IMENTI NORTH,Urban,27,875,967,1842,Meru,EASTERN,3389
IMENTI NORTH,Urban,28,872,985,1857,Meru,EASTERN,3390
IMENTI NORTH,Urban,29,776,760,1536,Meru,EASTERN,3391
IMENTI NORTH,Urban,30,1327,1236,2563,Meru,EASTERN,3392
IMENTI NORTH,Urban,31,621,428,1049,Meru,EASTERN,3393
IMENTI NORTH,Urban,32,786,705,1491,Meru,EASTERN,3394
IMENTI NORTH,Urban,33,531,422,953,Meru,EASTERN,3395
IMENTI NORTH,Urban,34,570,470,1040,Meru,EASTERN,3396
IMENTI NORTH,Urban,35,923,770,1693,Meru,EASTERN,3397
IMENTI NORTH,Urban,36,457,390,847,Meru,EASTERN,3398
IMENTI NORTH,Urban,37,429,331,760,Meru,EASTERN,3399
IMENTI NORTH,Urban,38,497,487,984,Meru,EASTERN,3400
IMENTI NORTH,Urban,39,409,291,700,Meru,EASTERN,3401
IMENTI NORTH,Urban,40,701,629,1330,Meru,EASTERN,3402
IMENTI NORTH,Urban,41,264,200,464,Meru,EASTERN,3403
IMENTI NORTH,Urban,42,344,290,634,Meru,EASTERN,3404
IMENTI NORTH,Urban,43,222,232,454,Meru,EASTERN,3405
IMENTI NORTH,Urban,44,245,183,428,Meru,EASTERN,3406
IMENTI NORTH,Urban,45,407,419,826,Meru,EASTERN,3407
IMENTI NORTH,Urban,46,251,243,494,Meru,EASTERN,3408
IMENTI NORTH,Urban,47,243,174,417,Meru,EASTERN,3409
IMENTI NORTH,Urban,48,241,227,468,Meru,EASTERN,3410
IMENTI NORTH,Urban,49,222,193,415,Meru,EASTERN,3411
IMENTI NORTH,Urban,50,344,339,683,Meru,EASTERN,3412
IMENTI NORTH,Urban,51,137,125,262,Meru,EASTERN,3413
IMENTI NORTH,Urban,52,165,173,338,Meru,EASTERN,3414
IMENTI NORTH,Urban,53,141,100,241,Meru,EASTERN,3415
IMENTI NORTH,Urban,54,113,109,222,Meru,EASTERN,3416
IMENTI NORTH,Urban,55,177,159,336,Meru,EASTERN,3417
IMENTI NORTH,Urban,56,114,112,226,Meru,EASTERN,3418
IMENTI NORTH,Urban,57,132,91,223,Meru,EASTERN,3419
IMENTI NORTH,Urban,58,97,54,151,Meru,EASTERN,3420
IMENTI NORTH,Urban,59,96,69,165,Meru,EASTERN,3421
IMENTI NORTH,Urban,60,183,177,360,Meru,EASTERN,3422
IMENTI NORTH,Urban,61,55,60,115,Meru,EASTERN,3423
IMENTI NORTH,Urban,62,76,55,131,Meru,EASTERN,3424
IMENTI NORTH,Urban,63,53,41,94,Meru,EASTERN,3425
IMENTI NORTH,Urban,64,62,48,110,Meru,EASTERN,3426
IMENTI NORTH,Urban,65,71,83,154,Meru,EASTERN,3427
IMENTI NORTH,Urban,66,31,28,59,Meru,EASTERN,3428
IMENTI NORTH,Urban,67,48,53,101,Meru,EASTERN,3429
IMENTI NORTH,Urban,68,36,39,75,Meru,EASTERN,3430
IMENTI NORTH,Urban,69,34,31,65,Meru,EASTERN,3431
IMENTI NORTH,Urban,70,91,119,210,Meru,EASTERN,3432
IMENTI NORTH,Urban,71,29,14,43,Meru,EASTERN,3433
IMENTI NORTH,Urban,72,24,21,45,Meru,EASTERN,3434
IMENTI NORTH,Urban,73,34,22,56,Meru,EASTERN,3435
IMENTI NORTH,Urban,74,33,24,57,Meru,EASTERN,3436
IMENTI NORTH,Urban,75,38,35,73,Meru,EASTERN,3437
IMENTI NORTH,Urban,76,22,22,44,Meru,EASTERN,3438
IMENTI NORTH,Urban,77,15,12,27,Meru,EASTERN,3439
IMENTI NORTH,Urban,78,18,27,45,Meru,EASTERN,3440
IMENTI NORTH,Urban,79,21,30,51,Meru,EASTERN,3441
IMENTI NORTH,Urban,80+,198,311,509,Meru,EASTERN,3442
IMENTI NORTH,Urban,Age NS,41,28,69,Meru,EASTERN,3443
IMENTI SOUTH,Urban,0,188,185,373,Meru,EASTERN,3444
IMENTI SOUTH,Urban,1,145,159,304,Meru,EASTERN,3445
IMENTI SOUTH,Urban,2,123,146,269,Meru,EASTERN,3446
IMENTI SOUTH,Urban,3,129,146,275,Meru,EASTERN,3447
IMENTI SOUTH,Urban,4,132,154,286,Meru,EASTERN,3448
IMENTI SOUTH,Urban,5,135,129,264,Meru,EASTERN,3449
IMENTI SOUTH,Urban,6,127,121,248,Meru,EASTERN,3450
IMENTI SOUTH,Urban,7,110,122,232,Meru,EASTERN,3451
IMENTI SOUTH,Urban,8,101,98,199,Meru,EASTERN,3452
IMENTI SOUTH,Urban,9,87,129,216,Meru,EASTERN,3453
IMENTI SOUTH,Urban,10,106,147,253,Meru,EASTERN,3454
IMENTI SOUTH,Urban,11,88,97,185,Meru,EASTERN,3455
IMENTI SOUTH,Urban,12,108,157,265,Meru,EASTERN,3456
IMENTI SOUTH,Urban,13,78,124,202,Meru,EASTERN,3457
IMENTI SOUTH,Urban,14,97,117,214,Meru,EASTERN,3458
IMENTI SOUTH,Urban,15,118,90,208,Meru,EASTERN,3459
IMENTI SOUTH,Urban,16,172,100,272,Meru,EASTERN,3460
IMENTI SOUTH,Urban,17,231,105,336,Meru,EASTERN,3461
IMENTI SOUTH,Urban,18,231,114,345,Meru,EASTERN,3462
IMENTI SOUTH,Urban,19,164,128,292,Meru,EASTERN,3463
IMENTI SOUTH,Urban,20,157,221,378,Meru,EASTERN,3464
IMENTI SOUTH,Urban,21,141,188,329,Meru,EASTERN,3465
IMENTI SOUTH,Urban,22,147,209,356,Meru,EASTERN,3466
IMENTI SOUTH,Urban,23,170,236,406,Meru,EASTERN,3467
IMENTI SOUTH,Urban,24,144,188,332,Meru,EASTERN,3468
IMENTI SOUTH,Urban,25,229,256,485,Meru,EASTERN,3469
IMENTI SOUTH,Urban,26,160,194,354,Meru,EASTERN,3470
IMENTI SOUTH,Urban,27,177,184,361,Meru,EASTERN,3471
IMENTI SOUTH,Urban,28,182,201,383,Meru,EASTERN,3472
IMENTI SOUTH,Urban,29,164,149,313,Meru,EASTERN,3473
IMENTI SOUTH,Urban,30,266,268,534,Meru,EASTERN,3474
IMENTI SOUTH,Urban,31,137,95,232,Meru,EASTERN,3475
IMENTI SOUTH,Urban,32,140,129,269,Meru,EASTERN,3476
IMENTI SOUTH,Urban,33,109,85,194,Meru,EASTERN,3477
IMENTI SOUTH,Urban,34,119,99,218,Meru,EASTERN,3478
IMENTI SOUTH,Urban,35,167,147,314,Meru,EASTERN,3479
IMENTI SOUTH,Urban,36,85,86,171,Meru,EASTERN,3480
IMENTI SOUTH,Urban,37,73,74,147,Meru,EASTERN,3481
IMENTI SOUTH,Urban,38,78,80,158,Meru,EASTERN,3482
IMENTI SOUTH,Urban,39,79,62,141,Meru,EASTERN,3483
IMENTI SOUTH,Urban,40,111,102,213,Meru,EASTERN,3484
IMENTI SOUTH,Urban,41,56,41,97,Meru,EASTERN,3485
IMENTI SOUTH,Urban,42,48,54,102,Meru,EASTERN,3486
IMENTI SOUTH,Urban,43,35,37,72,Meru,EASTERN,3487
IMENTI SOUTH,Urban,44,38,39,77,Meru,EASTERN,3488
IMENTI SOUTH,Urban,45,77,74,151,Meru,EASTERN,3489
IMENTI SOUTH,Urban,46,51,37,88,Meru,EASTERN,3490
IMENTI SOUTH,Urban,47,51,35,86,Meru,EASTERN,3491
IMENTI SOUTH,Urban,48,53,28,81,Meru,EASTERN,3492
IMENTI SOUTH,Urban,49,66,34,100,Meru,EASTERN,3493
IMENTI SOUTH,Urban,50,66,51,117,Meru,EASTERN,3494
IMENTI SOUTH,Urban,51,26,18,44,Meru,EASTERN,3495
IMENTI SOUTH,Urban,52,30,19,49,Meru,EASTERN,3496
IMENTI SOUTH,Urban,53,29,20,49,Meru,EASTERN,3497
IMENTI SOUTH,Urban,54,23,15,38,Meru,EASTERN,3498
IMENTI SOUTH,Urban,55,26,32,58,Meru,EASTERN,3499
IMENTI SOUTH,Urban,56,15,8,23,Meru,EASTERN,3500
IMENTI SOUTH,Urban,57,25,15,40,Meru,EASTERN,3501
IMENTI SOUTH,Urban,58,18,17,35,Meru,EASTERN,3502
IMENTI SOUTH,Urban,59,26,8,34,Meru,EASTERN,3503
IMENTI SOUTH,Urban,60,33,29,62,Meru,EASTERN,3504
IMENTI SOUTH,Urban,61,10,7,17,Meru,EASTERN,3505
IMENTI SOUTH,Urban,62,11,7,18,Meru,EASTERN,3506
IMENTI SOUTH,Urban,63,10,6,16,Meru,EASTERN,3507
IMENTI SOUTH,Urban,64,11,4,15,Meru,EASTERN,3508
IMENTI SOUTH,Urban,65,13,9,22,Meru,EASTERN,3509
IMENTI SOUTH,Urban,66,6,5,11,Meru,EASTERN,3510
IMENTI SOUTH,Urban,67,11,4,15,Meru,EASTERN,3511
IMENTI SOUTH,Urban,68,8,4,12,Meru,EASTERN,3512
IMENTI SOUTH,Urban,69,8,7,15,Meru,EASTERN,3513
IMENTI SOUTH,Urban,70,16,13,29,Meru,EASTERN,3514
IMENTI SOUTH,Urban,71,1,5,6,Meru,EASTERN,3515
IMENTI SOUTH,Urban,72,1,4,5,Meru,EASTERN,3516
IMENTI SOUTH,Urban,73,9,1,10,Meru,EASTERN,3517
IMENTI SOUTH,Urban,74,6,5,11,Meru,EASTERN,3518
IMENTI SOUTH,Urban,75,16,6,22,Meru,EASTERN,3519
IMENTI SOUTH,Urban,76,2,3,5,Meru,EASTERN,3520
IMENTI SOUTH,Urban,77,2,2,4,Meru,EASTERN,3521
IMENTI SOUTH,Urban,78,1,1,2,Meru,EASTERN,3522
IMENTI SOUTH,Urban,79,5,3,8,Meru,EASTERN,3523
IMENTI SOUTH,Urban,80+,41,59,100,Meru,EASTERN,3524
IMENTI SOUTH,Urban,Age NS,10,4,14,Meru,EASTERN,3525
MERU SOUTH,Urban,0,523,515,1038,Meru,EASTERN,3526
MERU SOUTH,Urban,1,436,460,896,Meru,EASTERN,3527
MERU SOUTH,Urban,2,496,544,1040,Meru,EASTERN,3528
MERU SOUTH,Urban,3,524,524,1048,Meru,EASTERN,3529
MERU SOUTH,Urban,4,541,522,1063,Meru,EASTERN,3530
MERU SOUTH,Urban,5,583,516,1099,Meru,EASTERN,3531
MERU SOUTH,Urban,6,498,478,976,Meru,EASTERN,3532
MERU SOUTH,Urban,7,449,463,912,Meru,EASTERN,3533
MERU SOUTH,Urban,8,466,470,936,Meru,EASTERN,3534
MERU SOUTH,Urban,9,506,499,1005,Meru,EASTERN,3535
MERU SOUTH,Urban,10,513,520,1033,Meru,EASTERN,3536
MERU SOUTH,Urban,11,401,415,816,Meru,EASTERN,3537
MERU SOUTH,Urban,12,494,503,997,Meru,EASTERN,3538
MERU SOUTH,Urban,13,476,471,947,Meru,EASTERN,3539
MERU SOUTH,Urban,14,437,442,879,Meru,EASTERN,3540
MERU SOUTH,Urban,15,431,429,860,Meru,EASTERN,3541
MERU SOUTH,Urban,16,396,425,821,Meru,EASTERN,3542
MERU SOUTH,Urban,17,426,427,853,Meru,EASTERN,3543
MERU SOUTH,Urban,18,433,386,819,Meru,EASTERN,3544
MERU SOUTH,Urban,19,411,386,797,Meru,EASTERN,3545
MERU SOUTH,Urban,20,424,540,964,Meru,EASTERN,3546
MERU SOUTH,Urban,21,402,425,827,Meru,EASTERN,3547
MERU SOUTH,Urban,22,459,506,965,Meru,EASTERN,3548
MERU SOUTH,Urban,23,460,524,984,Meru,EASTERN,3549
MERU SOUTH,Urban,24,375,440,815,Meru,EASTERN,3550
MERU SOUTH,Urban,25,458,527,985,Meru,EASTERN,3551
MERU SOUTH,Urban,26,364,402,766,Meru,EASTERN,3552
MERU SOUTH,Urban,27,350,409,759,Meru,EASTERN,3553
MERU SOUTH,Urban,28,371,406,777,Meru,EASTERN,3554
MERU SOUTH,Urban,29,371,418,789,Meru,EASTERN,3555
MERU SOUTH,Urban,30,552,533,1085,Meru,EASTERN,3556
MERU SOUTH,Urban,31,301,299,600,Meru,EASTERN,3557
MERU SOUTH,Urban,32,307,306,613,Meru,EASTERN,3558
MERU SOUTH,Urban,33,255,257,512,Meru,EASTERN,3559
MERU SOUTH,Urban,34,272,297,569,Meru,EASTERN,3560
MERU SOUTH,Urban,35,430,420,850,Meru,EASTERN,3561
MERU SOUTH,Urban,36,254,253,507,Meru,EASTERN,3562
MERU SOUTH,Urban,37,237,226,463,Meru,EASTERN,3563
MERU SOUTH,Urban,38,249,294,543,Meru,EASTERN,3564
MERU SOUTH,Urban,39,218,232,450,Meru,EASTERN,3565
MERU SOUTH,Urban,40,358,374,732,Meru,EASTERN,3566
MERU SOUTH,Urban,41,212,186,398,Meru,EASTERN,3567
MERU SOUTH,Urban,42,158,210,368,Meru,EASTERN,3568
MERU SOUTH,Urban,43,149,131,280,Meru,EASTERN,3569
MERU SOUTH,Urban,44,160,172,332,Meru,EASTERN,3570
MERU SOUTH,Urban,45,270,319,589,Meru,EASTERN,3571
MERU SOUTH,Urban,46,210,210,420,Meru,EASTERN,3572
MERU SOUTH,Urban,47,180,195,375,Meru,EASTERN,3573
MERU SOUTH,Urban,48,174,165,339,Meru,EASTERN,3574
MERU SOUTH,Urban,49,203,204,407,Meru,EASTERN,3575
MERU SOUTH,Urban,50,268,319,587,Meru,EASTERN,3576
MERU SOUTH,Urban,51,144,140,284,Meru,EASTERN,3577
MERU SOUTH,Urban,52,160,123,283,Meru,EASTERN,3578
MERU SOUTH,Urban,53,123,102,225,Meru,EASTERN,3579
MERU SOUTH,Urban,54,78,82,160,Meru,EASTERN,3580
MERU SOUTH,Urban,55,150,175,325,Meru,EASTERN,3581
MERU SOUTH,Urban,56,108,108,216,Meru,EASTERN,3582
MERU SOUTH,Urban,57,132,136,268,Meru,EASTERN,3583
MERU SOUTH,Urban,58,75,68,143,Meru,EASTERN,3584
MERU SOUTH,Urban,59,116,92,208,Meru,EASTERN,3585
MERU SOUTH,Urban,60,145,175,320,Meru,EASTERN,3586
MERU SOUTH,Urban,61,73,80,153,Meru,EASTERN,3587
MERU SOUTH,Urban,62,64,61,125,Meru,EASTERN,3588
MERU SOUTH,Urban,63,63,49,112,Meru,EASTERN,3589
MERU SOUTH,Urban,64,63,74,137,Meru,EASTERN,3590
MERU SOUTH,Urban,65,64,84,148,Meru,EASTERN,3591
MERU SOUTH,Urban,66,35,35,70,Meru,EASTERN,3592
MERU SOUTH,Urban,67,65,79,144,Meru,EASTERN,3593
MERU SOUTH,Urban,68,36,38,74,Meru,EASTERN,3594
MERU SOUTH,Urban,69,50,61,111,Meru,EASTERN,3595
MERU SOUTH,Urban,70,89,100,189,Meru,EASTERN,3596
MERU SOUTH,Urban,71,27,43,70,Meru,EASTERN,3597
MERU SOUTH,Urban,72,33,24,57,Meru,EASTERN,3598
MERU SOUTH,Urban,73,42,47,89,Meru,EASTERN,3599
MERU SOUTH,Urban,74,30,51,81,Meru,EASTERN,3600
MERU SOUTH,Urban,75,41,50,91,Meru,EASTERN,3601
MERU SOUTH,Urban,76,30,21,51,Meru,EASTERN,3602
MERU SOUTH,Urban,77,21,46,67,Meru,EASTERN,3603
MERU SOUTH,Urban,78,29,26,55,Meru,EASTERN,3604
MERU SOUTH,Urban,79,24,43,67,Meru,EASTERN,3605
MERU SOUTH,Urban,80+,248,386,634,Meru,EASTERN,3606
MERU SOUTH,Urban,Age NS,17,11,28,Meru,EASTERN,3607
MAARA,Urban,0,340,341,681,Meru,EASTERN,3608
MAARA,Urban,1,273,290,563,Meru,EASTERN,3609
MAARA,Urban,2,342,350,692,Meru,EASTERN,3610
MAARA,Urban,3,356,332,688,Meru,EASTERN,3611
MAARA,Urban,4,331,328,659,Meru,EASTERN,3612
MAARA,Urban,5,335,360,695,Meru,EASTERN,3613
MAARA,Urban,6,309,300,609,Meru,EASTERN,3614
MAARA,Urban,7,307,305,612,Meru,EASTERN,3615
MAARA,Urban,8,346,303,649,Meru,EASTERN,3616
MAARA,Urban,9,318,322,640,Meru,EASTERN,3617
MAARA,Urban,10,370,335,705,Meru,EASTERN,3618
MAARA,Urban,11,349,348,697,Meru,EASTERN,3619
MAARA,Urban,12,426,459,885,Meru,EASTERN,3620
MAARA,Urban,13,473,498,971,Meru,EASTERN,3621
MAARA,Urban,14,393,348,741,Meru,EASTERN,3622
MAARA,Urban,15,305,277,582,Meru,EASTERN,3623
MAARA,Urban,16,290,278,568,Meru,EASTERN,3624
MAARA,Urban,17,328,321,649,Meru,EASTERN,3625
MAARA,Urban,18,326,296,622,Meru,EASTERN,3626
MAARA,Urban,19,295,266,561,Meru,EASTERN,3627
MAARA,Urban,20,332,300,632,Meru,EASTERN,3628
MAARA,Urban,21,285,238,523,Meru,EASTERN,3629
MAARA,Urban,22,270,322,592,Meru,EASTERN,3630
MAARA,Urban,23,310,305,615,Meru,EASTERN,3631
MAARA,Urban,24,265,273,538,Meru,EASTERN,3632
MAARA,Urban,25,321,326,647,Meru,EASTERN,3633
MAARA,Urban,26,224,284,508,Meru,EASTERN,3634
MAARA,Urban,27,258,255,513,Meru,EASTERN,3635
MAARA,Urban,28,238,270,508,Meru,EASTERN,3636
MAARA,Urban,29,256,259,515,Meru,EASTERN,3637
MAARA,Urban,30,343,387,730,Meru,EASTERN,3638
MAARA,Urban,31,221,215,436,Meru,EASTERN,3639
MAARA,Urban,32,228,242,470,Meru,EASTERN,3640
MAARA,Urban,33,209,194,403,Meru,EASTERN,3641
MAARA,Urban,34,202,195,397,Meru,EASTERN,3642
MAARA,Urban,35,312,310,622,Meru,EASTERN,3643
MAARA,Urban,36,207,209,416,Meru,EASTERN,3644
MAARA,Urban,37,197,188,385,Meru,EASTERN,3645
MAARA,Urban,38,215,197,412,Meru,EASTERN,3646
MAARA,Urban,39,180,200,380,Meru,EASTERN,3647
MAARA,Urban,40,271,316,587,Meru,EASTERN,3648
MAARA,Urban,41,165,140,305,Meru,EASTERN,3649
MAARA,Urban,42,141,127,268,Meru,EASTERN,3650
MAARA,Urban,43,129,119,248,Meru,EASTERN,3651
MAARA,Urban,44,146,124,270,Meru,EASTERN,3652
MAARA,Urban,45,207,213,420,Meru,EASTERN,3653
MAARA,Urban,46,152,146,298,Meru,EASTERN,3654
MAARA,Urban,47,156,154,310,Meru,EASTERN,3655
MAARA,Urban,48,130,138,268,Meru,EASTERN,3656
MAARA,Urban,49,159,154,313,Meru,EASTERN,3657
MAARA,Urban,50,216,236,452,Meru,EASTERN,3658
MAARA,Urban,51,136,109,245,Meru,EASTERN,3659
MAARA,Urban,52,130,97,227,Meru,EASTERN,3660
MAARA,Urban,53,97,103,200,Meru,EASTERN,3661
MAARA,Urban,54,92,85,177,Meru,EASTERN,3662
MAARA,Urban,55,130,128,258,Meru,EASTERN,3663
MAARA,Urban,56,109,83,192,Meru,EASTERN,3664
MAARA,Urban,57,127,114,241,Meru,EASTERN,3665
MAARA,Urban,58,76,56,132,Meru,EASTERN,3666
MAARA,Urban,59,96,90,186,Meru,EASTERN,3667
MAARA,Urban,60,130,164,294,Meru,EASTERN,3668
MAARA,Urban,61,76,63,139,Meru,EASTERN,3669
MAARA,Urban,62,63,62,125,Meru,EASTERN,3670
MAARA,Urban,63,64,46,110,Meru,EASTERN,3671
MAARA,Urban,64,56,79,135,Meru,EASTERN,3672
MAARA,Urban,65,71,76,147,Meru,EASTERN,3673
MAARA,Urban,66,35,37,72,Meru,EASTERN,3674
MAARA,Urban,67,79,71,150,Meru,EASTERN,3675
MAARA,Urban,68,24,39,63,Meru,EASTERN,3676
MAARA,Urban,69,49,59,108,Meru,EASTERN,3677
MAARA,Urban,70,86,107,193,Meru,EASTERN,3678
MAARA,Urban,71,39,46,85,Meru,EASTERN,3679
MAARA,Urban,72,32,49,81,Meru,EASTERN,3680
MAARA,Urban,73,37,36,73,Meru,EASTERN,3681
MAARA,Urban,74,48,39,87,Meru,EASTERN,3682
MAARA,Urban,75,44,38,82,Meru,EASTERN,3683
MAARA,Urban,76,26,19,45,Meru,EASTERN,3684
MAARA,Urban,77,35,27,62,Meru,EASTERN,3685
MAARA,Urban,78,27,19,46,Meru,EASTERN,3686
MAARA,Urban,79,42,42,84,Meru,EASTERN,3687
MAARA,Urban,80+,204,292,496,Meru,EASTERN,3688
MAARA,Urban,Age NS,6,3,9,Meru,EASTERN,3689
IGEMBE,Urban,0,488,508,996,Meru,EASTERN,3690
IGEMBE,Urban,1,393,389,782,Meru,EASTERN,3691
IGEMBE,Urban,2,392,411,803,Meru,EASTERN,3692
IGEMBE,Urban,3,405,403,808,Meru,EASTERN,3693
IGEMBE,Urban,4,344,369,713,Meru,EASTERN,3694
IGEMBE,Urban,5,392,377,769,Meru,EASTERN,3695
IGEMBE,Urban,6,297,318,615,Meru,EASTERN,3696
IGEMBE,Urban,7,312,320,632,Meru,EASTERN,3697
IGEMBE,Urban,8,283,336,619,Meru,EASTERN,3698
IGEMBE,Urban,9,350,315,665,Meru,EASTERN,3699
IGEMBE,Urban,10,348,386,734,Meru,EASTERN,3700
IGEMBE,Urban,11,244,221,465,Meru,EASTERN,3701
IGEMBE,Urban,12,329,357,686,Meru,EASTERN,3702
IGEMBE,Urban,13,298,332,630,Meru,EASTERN,3703
IGEMBE,Urban,14,254,310,564,Meru,EASTERN,3704
IGEMBE,Urban,15,252,341,593,Meru,EASTERN,3705
IGEMBE,Urban,16,225,355,580,Meru,EASTERN,3706
IGEMBE,Urban,17,226,445,671,Meru,EASTERN,3707
IGEMBE,Urban,18,293,479,772,Meru,EASTERN,3708
IGEMBE,Urban,19,206,323,529,Meru,EASTERN,3709
IGEMBE,Urban,20,356,571,927,Meru,EASTERN,3710
IGEMBE,Urban,21,246,343,589,Meru,EASTERN,3711
IGEMBE,Urban,22,358,434,792,Meru,EASTERN,3712
IGEMBE,Urban,23,346,447,793,Meru,EASTERN,3713
IGEMBE,Urban,24,367,381,748,Meru,EASTERN,3714
IGEMBE,Urban,25,546,619,1165,Meru,EASTERN,3715
IGEMBE,Urban,26,368,331,699,Meru,EASTERN,3716
IGEMBE,Urban,27,435,345,780,Meru,EASTERN,3717
IGEMBE,Urban,28,397,431,828,Meru,EASTERN,3718
IGEMBE,Urban,29,335,265,600,Meru,EASTERN,3719
IGEMBE,Urban,30,664,584,1248,Meru,EASTERN,3720
IGEMBE,Urban,31,202,168,370,Meru,EASTERN,3721
IGEMBE,Urban,32,330,254,584,Meru,EASTERN,3722
IGEMBE,Urban,33,200,168,368,Meru,EASTERN,3723
IGEMBE,Urban,34,196,143,339,Meru,EASTERN,3724
IGEMBE,Urban,35,421,295,716,Meru,EASTERN,3725
IGEMBE,Urban,36,176,127,303,Meru,EASTERN,3726
IGEMBE,Urban,37,164,129,293,Meru,EASTERN,3727
IGEMBE,Urban,38,230,132,362,Meru,EASTERN,3728
IGEMBE,Urban,39,145,89,234,Meru,EASTERN,3729
IGEMBE,Urban,40,312,225,537,Meru,EASTERN,3730
IGEMBE,Urban,41,74,55,129,Meru,EASTERN,3731
IGEMBE,Urban,42,132,79,211,Meru,EASTERN,3732
IGEMBE,Urban,43,73,48,121,Meru,EASTERN,3733
IGEMBE,Urban,44,60,44,104,Meru,EASTERN,3734
IGEMBE,Urban,45,187,134,321,Meru,EASTERN,3735
IGEMBE,Urban,46,105,72,177,Meru,EASTERN,3736
IGEMBE,Urban,47,70,48,118,Meru,EASTERN,3737
IGEMBE,Urban,48,103,65,168,Meru,EASTERN,3738
IGEMBE,Urban,49,69,33,102,Meru,EASTERN,3739
IGEMBE,Urban,50,158,140,298,Meru,EASTERN,3740
IGEMBE,Urban,51,35,31,66,Meru,EASTERN,3741
IGEMBE,Urban,52,69,33,102,Meru,EASTERN,3742
IGEMBE,Urban,53,28,25,53,Meru,EASTERN,3743
IGEMBE,Urban,54,46,22,68,Meru,EASTERN,3744
IGEMBE,Urban,55,86,62,148,Meru,EASTERN,3745
IGEMBE,Urban,56,29,22,51,Meru,EASTERN,3746
IGEMBE,Urban,57,26,25,51,Meru,EASTERN,3747
IGEMBE,Urban,58,35,24,59,Meru,EASTERN,3748
IGEMBE,Urban,59,30,13,43,Meru,EASTERN,3749
IGEMBE,Urban,60,104,67,171,Meru,EASTERN,3750
IGEMBE,Urban,61,29,14,43,Meru,EASTERN,3751
IGEMBE,Urban,62,22,21,43,Meru,EASTERN,3752
IGEMBE,Urban,63,14,9,23,Meru,EASTERN,3753
IGEMBE,Urban,64,16,9,25,Meru,EASTERN,3754
IGEMBE,Urban,65,29,24,53,Meru,EASTERN,3755
IGEMBE,Urban,66,11,4,15,Meru,EASTERN,3756
IGEMBE,Urban,67,14,9,23,Meru,EASTERN,3757
IGEMBE,Urban,68,8,3,11,Meru,EASTERN,3758
IGEMBE,Urban,69,8,14,22,Meru,EASTERN,3759
IGEMBE,Urban,70,43,57,100,Meru,EASTERN,3760
IGEMBE,Urban,71,3,7,10,Meru,EASTERN,3761
IGEMBE,Urban,72,10,9,19,Meru,EASTERN,3762
IGEMBE,Urban,73,10,3,13,Meru,EASTERN,3763
IGEMBE,Urban,74,6,6,12,Meru,EASTERN,3764
IGEMBE,Urban,75,19,21,40,Meru,EASTERN,3765
IGEMBE,Urban,76,5,7,12,Meru,EASTERN,3766
IGEMBE,Urban,77,4,11,15,Meru,EASTERN,3767
IGEMBE,Urban,78,6,6,12,Meru,EASTERN,3768
IGEMBE,Urban,79,5,10,15,Meru,EASTERN,3769
IGEMBE,Urban,80+,73,124,197,Meru,EASTERN,3770
IGEMBE,Urban,Age NS,29,26,55,Meru,EASTERN,3771
TIGANIA,Urban,0,56,50,106,Meru,EASTERN,3772
TIGANIA,Urban,1,45,39,84,Meru,EASTERN,3773
TIGANIA,Urban,2,45,46,91,Meru,EASTERN,3774
TIGANIA,Urban,3,49,39,88,Meru,EASTERN,3775
TIGANIA,Urban,4,36,41,77,Meru,EASTERN,3776
TIGANIA,Urban,5,46,47,93,Meru,EASTERN,3777
TIGANIA,Urban,6,45,55,100,Meru,EASTERN,3778
TIGANIA,Urban,7,49,40,89,Meru,EASTERN,3779
TIGANIA,Urban,8,39,37,76,Meru,EASTERN,3780
TIGANIA,Urban,9,44,49,93,Meru,EASTERN,3781
TIGANIA,Urban,10,35,49,84,Meru,EASTERN,3782
TIGANIA,Urban,11,38,34,72,Meru,EASTERN,3783
TIGANIA,Urban,12,45,52,97,Meru,EASTERN,3784
TIGANIA,Urban,13,40,55,95,Meru,EASTERN,3785
TIGANIA,Urban,14,38,51,89,Meru,EASTERN,3786
TIGANIA,Urban,15,29,41,70,Meru,EASTERN,3787
TIGANIA,Urban,16,29,39,68,Meru,EASTERN,3788
TIGANIA,Urban,17,46,32,78,Meru,EASTERN,3789
TIGANIA,Urban,18,29,34,63,Meru,EASTERN,3790
TIGANIA,Urban,19,34,28,62,Meru,EASTERN,3791
TIGANIA,Urban,20,26,50,76,Meru,EASTERN,3792
TIGANIA,Urban,21,35,35,70,Meru,EASTERN,3793
TIGANIA,Urban,22,30,47,77,Meru,EASTERN,3794
TIGANIA,Urban,23,45,45,90,Meru,EASTERN,3795
TIGANIA,Urban,24,29,41,70,Meru,EASTERN,3796
TIGANIA,Urban,25,51,64,115,Meru,EASTERN,3797
TIGANIA,Urban,26,33,38,71,Meru,EASTERN,3798
TIGANIA,Urban,27,46,37,83,Meru,EASTERN,3799
TIGANIA,Urban,28,32,34,66,Meru,EASTERN,3800
TIGANIA,Urban,29,32,31,63,Meru,EASTERN,3801
TIGANIA,Urban,30,60,63,123,Meru,EASTERN,3802
TIGANIA,Urban,31,31,15,46,Meru,EASTERN,3803
TIGANIA,Urban,32,32,29,61,Meru,EASTERN,3804
TIGANIA,Urban,33,26,15,41,Meru,EASTERN,3805
TIGANIA,Urban,34,18,17,35,Meru,EASTERN,3806
TIGANIA,Urban,35,33,27,60,Meru,EASTERN,3807
TIGANIA,Urban,36,15,13,28,Meru,EASTERN,3808
TIGANIA,Urban,37,15,11,26,Meru,EASTERN,3809
TIGANIA,Urban,38,19,16,35,Meru,EASTERN,3810
TIGANIA,Urban,39,16,20,36,Meru,EASTERN,3811
TIGANIA,Urban,40,29,25,54,Meru,EASTERN,3812
TIGANIA,Urban,41,12,4,16,Meru,EASTERN,3813
TIGANIA,Urban,42,18,10,28,Meru,EASTERN,3814
TIGANIA,Urban,43,8,7,15,Meru,EASTERN,3815
TIGANIA,Urban,44,6,6,12,Meru,EASTERN,3816
TIGANIA,Urban,45,14,15,29,Meru,EASTERN,3817
TIGANIA,Urban,46,15,6,21,Meru,EASTERN,3818
TIGANIA,Urban,47,7,19,26,Meru,EASTERN,3819
TIGANIA,Urban,48,12,16,28,Meru,EASTERN,3820
TIGANIA,Urban,49,6,12,18,Meru,EASTERN,3821
TIGANIA,Urban,50,23,20,43,Meru,EASTERN,3822
TIGANIA,Urban,51,10,5,15,Meru,EASTERN,3823
TIGANIA,Urban,52,17,7,24,Meru,EASTERN,3824
TIGANIA,Urban,53,6,5,11,Meru,EASTERN,3825
TIGANIA,Urban,54,1,10,11,Meru,EASTERN,3826
TIGANIA,Urban,55,11,17,28,Meru,EASTERN,3827
TIGANIA,Urban,56,8,5,13,Meru,EASTERN,3828
TIGANIA,Urban,57,11,6,17,Meru,EASTERN,3829
TIGANIA,Urban,58,13,7,20,Meru,EASTERN,3830
TIGANIA,Urban,59,8,10,18,Meru,EASTERN,3831
TIGANIA,Urban,60,11,17,28,Meru,EASTERN,3832
TIGANIA,Urban,61,3,3,6,Meru,EASTERN,3833
TIGANIA,Urban,62,2,4,6,Meru,EASTERN,3834
TIGANIA,Urban,63,9,1,10,Meru,EASTERN,3835
TIGANIA,Urban,64,5,1,6,Meru,EASTERN,3836
TIGANIA,Urban,65,11,11,22,Meru,EASTERN,3837
TIGANIA,Urban,66,2,0,2,Meru,EASTERN,3838
TIGANIA,Urban,67,4,0,4,Meru,EASTERN,3839
TIGANIA,Urban,68,1,2,3,Meru,EASTERN,3840
TIGANIA,Urban,69,2,1,3,Meru,EASTERN,3841
TIGANIA,Urban,70,11,9,20,Meru,EASTERN,3842
TIGANIA,Urban,71,3,0,3,Meru,EASTERN,3843
TIGANIA,Urban,72,5,1,6,Meru,EASTERN,3844
TIGANIA,Urban,73,2,2,4,Meru,EASTERN,3845
TIGANIA,Urban,74,1,0,1,Meru,EASTERN,3846
TIGANIA,Urban,75,2,4,6,Meru,EASTERN,3847
TIGANIA,Urban,76,0,1,1,Meru,EASTERN,3848
TIGANIA,Urban,77,1,1,2,Meru,EASTERN,3849
TIGANIA,Urban,78,1,1,2,Meru,EASTERN,3850
TIGANIA,Urban,79,0,1,1,Meru,EASTERN,3851
TIGANIA,Urban,80+,41,50,91,Meru,EASTERN,3852
TIGANIA,Urban,Age NS,13,5,18,Meru,EASTERN,3853
THARAKA,Urban,0,129,128,257,Tharaka Nithi,EASTERN,3854
THARAKA,Urban,1,122,89,211,Tharaka Nithi,EASTERN,3855
THARAKA,Urban,2,131,113,244,Tharaka Nithi,EASTERN,3856
THARAKA,Urban,3,125,98,223,Tharaka Nithi,EASTERN,3857
THARAKA,Urban,4,120,117,237,Tharaka Nithi,EASTERN,3858
THARAKA,Urban,5,122,116,238,Tharaka Nithi,EASTERN,3859
THARAKA,Urban,6,77,118,195,Tharaka Nithi,EASTERN,3860
THARAKA,Urban,7,95,109,204,Tharaka Nithi,EASTERN,3861
THARAKA,Urban,8,105,132,237,Tharaka Nithi,EASTERN,3862
THARAKA,Urban,9,116,106,222,Tharaka Nithi,EASTERN,3863
THARAKA,Urban,10,133,120,253,Tharaka Nithi,EASTERN,3864
THARAKA,Urban,11,98,96,194,Tharaka Nithi,EASTERN,3865
THARAKA,Urban,12,109,97,206,Tharaka Nithi,EASTERN,3866
THARAKA,Urban,13,98,95,193,Tharaka Nithi,EASTERN,3867
THARAKA,Urban,14,113,116,229,Tharaka Nithi,EASTERN,3868
THARAKA,Urban,15,108,127,235,Tharaka Nithi,EASTERN,3869
THARAKA,Urban,16,97,99,196,Tharaka Nithi,EASTERN,3870
THARAKA,Urban,17,82,80,162,Tharaka Nithi,EASTERN,3871
THARAKA,Urban,18,77,94,171,Tharaka Nithi,EASTERN,3872
THARAKA,Urban,19,63,60,123,Tharaka Nithi,EASTERN,3873
THARAKA,Urban,20,95,117,212,Tharaka Nithi,EASTERN,3874
THARAKA,Urban,21,78,84,162,Tharaka Nithi,EASTERN,3875
THARAKA,Urban,22,68,87,155,Tharaka Nithi,EASTERN,3876
THARAKA,Urban,23,74,106,180,Tharaka Nithi,EASTERN,3877
THARAKA,Urban,24,73,73,146,Tharaka Nithi,EASTERN,3878
THARAKA,Urban,25,92,100,192,Tharaka Nithi,EASTERN,3879
THARAKA,Urban,26,63,77,140,Tharaka Nithi,EASTERN,3880
THARAKA,Urban,27,71,79,150,Tharaka Nithi,EASTERN,3881
THARAKA,Urban,28,51,75,126,Tharaka Nithi,EASTERN,3882
THARAKA,Urban,29,64,83,147,Tharaka Nithi,EASTERN,3883
THARAKA,Urban,30,109,121,230,Tharaka Nithi,EASTERN,3884
THARAKA,Urban,31,57,50,107,Tharaka Nithi,EASTERN,3885
THARAKA,Urban,32,66,55,121,Tharaka Nithi,EASTERN,3886
THARAKA,Urban,33,49,62,111,Tharaka Nithi,EASTERN,3887
THARAKA,Urban,34,53,42,95,Tharaka Nithi,EASTERN,3888
THARAKA,Urban,35,76,91,167,Tharaka Nithi,EASTERN,3889
THARAKA,Urban,36,50,43,93,Tharaka Nithi,EASTERN,3890
THARAKA,Urban,37,35,35,70,Tharaka Nithi,EASTERN,3891
THARAKA,Urban,38,41,40,81,Tharaka Nithi,EASTERN,3892
THARAKA,Urban,39,46,37,83,Tharaka Nithi,EASTERN,3893
THARAKA,Urban,40,51,61,112,Tharaka Nithi,EASTERN,3894
THARAKA,Urban,41,40,28,68,Tharaka Nithi,EASTERN,3895
THARAKA,Urban,42,34,31,65,Tharaka Nithi,EASTERN,3896
THARAKA,Urban,43,24,20,44,Tharaka Nithi,EASTERN,3897
THARAKA,Urban,44,22,31,53,Tharaka Nithi,EASTERN,3898
THARAKA,Urban,45,64,34,98,Tharaka Nithi,EASTERN,3899
THARAKA,Urban,46,30,25,55,Tharaka Nithi,EASTERN,3900
THARAKA,Urban,47,18,19,37,Tharaka Nithi,EASTERN,3901
THARAKA,Urban,48,33,45,78,Tharaka Nithi,EASTERN,3902
THARAKA,Urban,49,17,25,42,Tharaka Nithi,EASTERN,3903
THARAKA,Urban,50,44,31,75,Tharaka Nithi,EASTERN,3904
THARAKA,Urban,51,25,27,52,Tharaka Nithi,EASTERN,3905
THARAKA,Urban,52,22,15,37,Tharaka Nithi,EASTERN,3906
THARAKA,Urban,53,12,7,19,Tharaka Nithi,EASTERN,3907
THARAKA,Urban,54,18,13,31,Tharaka Nithi,EASTERN,3908
THARAKA,Urban,55,18,29,47,Tharaka Nithi,EASTERN,3909
THARAKA,Urban,56,8,10,18,Tharaka Nithi,EASTERN,3910
THARAKA,Urban,57,18,16,34,Tharaka Nithi,EASTERN,3911
THARAKA,Urban,58,20,9,29,Tharaka Nithi,EASTERN,3912
THARAKA,Urban,59,6,11,17,Tharaka Nithi,EASTERN,3913
THARAKA,Urban,60,32,31,63,Tharaka Nithi,EASTERN,3914
THARAKA,Urban,61,26,21,47,Tharaka Nithi,EASTERN,3915
THARAKA,Urban,62,9,6,15,Tharaka Nithi,EASTERN,3916
THARAKA,Urban,63,10,9,19,Tharaka Nithi,EASTERN,3917
THARAKA,Urban,64,9,14,23,Tharaka Nithi,EASTERN,3918
THARAKA,Urban,65,15,19,34,Tharaka Nithi,EASTERN,3919
THARAKA,Urban,66,13,6,19,Tharaka Nithi,EASTERN,3920
THARAKA,Urban,67,7,9,16,Tharaka Nithi,EASTERN,3921
THARAKA,Urban,68,11,12,23,Tharaka Nithi,EASTERN,3922
THARAKA,Urban,69,7,10,17,Tharaka Nithi,EASTERN,3923
THARAKA,Urban,70,13,24,37,Tharaka Nithi,EASTERN,3924
THARAKA,Urban,71,3,4,7,Tharaka Nithi,EASTERN,3925
THARAKA,Urban,72,6,4,10,Tharaka Nithi,EASTERN,3926
THARAKA,Urban,73,2,3,5,Tharaka Nithi,EASTERN,3927
THARAKA,Urban,74,2,7,9,Tharaka Nithi,EASTERN,3928
THARAKA,Urban,75,6,15,21,Tharaka Nithi,EASTERN,3929
THARAKA,Urban,76,6,4,10,Tharaka Nithi,EASTERN,3930
THARAKA,Urban,77,6,2,8,Tharaka Nithi,EASTERN,3931
THARAKA,Urban,78,8,4,12,Tharaka Nithi,EASTERN,3932
THARAKA,Urban,79,7,1,8,Tharaka Nithi,EASTERN,3933
THARAKA,Urban,80+,43,80,123,Tharaka Nithi,EASTERN,3934
THARAKA,Urban,Age NS,0,0,0,Tharaka Nithi,EASTERN,3935
EMBU,Urban,0,972,938,1910,Embu,EASTERN,3936
EMBU,Urban,1,812,867,1679,Embu,EASTERN,3937
EMBU,Urban,2,867,849,1716,Embu,EASTERN,3938
EMBU,Urban,3,842,828,1670,Embu,EASTERN,3939
EMBU,Urban,4,859,865,1724,Embu,EASTERN,3940
EMBU,Urban,5,823,832,1655,Embu,EASTERN,3941
EMBU,Urban,6,825,807,1632,Embu,EASTERN,3942
EMBU,Urban,7,820,796,1616,Embu,EASTERN,3943
EMBU,Urban,8,684,800,1484,Embu,EASTERN,3944
EMBU,Urban,9,867,875,1742,Embu,EASTERN,3945
EMBU,Urban,10,868,869,1737,Embu,EASTERN,3946
EMBU,Urban,11,731,780,1511,Embu,EASTERN,3947
EMBU,Urban,12,872,898,1770,Embu,EASTERN,3948
EMBU,Urban,13,820,873,1693,Embu,EASTERN,3949
EMBU,Urban,14,709,749,1458,Embu,EASTERN,3950
EMBU,Urban,15,675,668,1343,Embu,EASTERN,3951
EMBU,Urban,16,664,808,1472,Embu,EASTERN,3952
EMBU,Urban,17,704,828,1532,Embu,EASTERN,3953
EMBU,Urban,18,782,920,1702,Embu,EASTERN,3954
EMBU,Urban,19,739,807,1546,Embu,EASTERN,3955
EMBU,Urban,20,859,1062,1921,Embu,EASTERN,3956
EMBU,Urban,21,760,860,1620,Embu,EASTERN,3957
EMBU,Urban,22,830,1038,1868,Embu,EASTERN,3958
EMBU,Urban,23,837,1109,1946,Embu,EASTERN,3959
EMBU,Urban,24,820,1003,1823,Embu,EASTERN,3960
EMBU,Urban,25,1105,1156,2261,Embu,EASTERN,3961
EMBU,Urban,26,864,950,1814,Embu,EASTERN,3962
EMBU,Urban,27,886,840,1726,Embu,EASTERN,3963
EMBU,Urban,28,856,942,1798,Embu,EASTERN,3964
EMBU,Urban,29,795,773,1568,Embu,EASTERN,3965
EMBU,Urban,30,1157,1190,2347,Embu,EASTERN,3966
EMBU,Urban,31,587,526,1113,Embu,EASTERN,3967
EMBU,Urban,32,766,729,1495,Embu,EASTERN,3968
EMBU,Urban,33,526,505,1031,Embu,EASTERN,3969
EMBU,Urban,34,551,561,1112,Embu,EASTERN,3970
EMBU,Urban,35,938,862,1800,Embu,EASTERN,3971
EMBU,Urban,36,524,473,997,Embu,EASTERN,3972
EMBU,Urban,37,479,464,943,Embu,EASTERN,3973
EMBU,Urban,38,552,556,1108,Embu,EASTERN,3974
EMBU,Urban,39,491,423,914,Embu,EASTERN,3975
EMBU,Urban,40,786,703,1489,Embu,EASTERN,3976
EMBU,Urban,41,344,295,639,Embu,EASTERN,3977
EMBU,Urban,42,438,423,861,Embu,EASTERN,3978
EMBU,Urban,43,343,329,672,Embu,EASTERN,3979
EMBU,Urban,44,304,343,647,Embu,EASTERN,3980
EMBU,Urban,45,564,571,1135,Embu,EASTERN,3981
EMBU,Urban,46,388,397,785,Embu,EASTERN,3982
EMBU,Urban,47,300,301,601,Embu,EASTERN,3983
EMBU,Urban,48,291,309,600,Embu,EASTERN,3984
EMBU,Urban,49,310,269,579,Embu,EASTERN,3985
EMBU,Urban,50,510,491,1001,Embu,EASTERN,3986
EMBU,Urban,51,229,196,425,Embu,EASTERN,3987
EMBU,Urban,52,250,209,459,Embu,EASTERN,3988
EMBU,Urban,53,154,145,299,Embu,EASTERN,3989
EMBU,Urban,54,171,169,340,Embu,EASTERN,3990
EMBU,Urban,55,260,248,508,Embu,EASTERN,3991
EMBU,Urban,56,188,169,357,Embu,EASTERN,3992
EMBU,Urban,57,188,152,340,Embu,EASTERN,3993
EMBU,Urban,58,115,109,224,Embu,EASTERN,3994
EMBU,Urban,59,154,127,281,Embu,EASTERN,3995
EMBU,Urban,60,275,242,517,Embu,EASTERN,3996
EMBU,Urban,61,100,99,199,Embu,EASTERN,3997
EMBU,Urban,62,96,77,173,Embu,EASTERN,3998
EMBU,Urban,63,84,87,171,Embu,EASTERN,3999
EMBU,Urban,64,88,96,184,Embu,EASTERN,4000
EMBU,Urban,65,122,137,259,Embu,EASTERN,4001
EMBU,Urban,66,50,56,106,Embu,EASTERN,4002
EMBU,Urban,67,67,60,127,Embu,EASTERN,4003
EMBU,Urban,68,55,78,133,Embu,EASTERN,4004
EMBU,Urban,69,65,77,142,Embu,EASTERN,4005
EMBU,Urban,70,124,189,313,Embu,EASTERN,4006
EMBU,Urban,71,37,60,97,Embu,EASTERN,4007
EMBU,Urban,72,48,36,84,Embu,EASTERN,4008
EMBU,Urban,73,48,43,91,Embu,EASTERN,4009
EMBU,Urban,74,58,47,105,Embu,EASTERN,4010
EMBU,Urban,75,66,83,149,Embu,EASTERN,4011
EMBU,Urban,76,37,48,85,Embu,EASTERN,4012
EMBU,Urban,77,40,36,76,Embu,EASTERN,4013
EMBU,Urban,78,28,46,74,Embu,EASTERN,4014
EMBU,Urban,79,37,46,83,Embu,EASTERN,4015
EMBU,Urban,80+,382,586,968,Embu,EASTERN,4016
EMBU,Urban,Age NS,23,12,35,Embu,EASTERN,4017
MBEERE,Urban,0,44,33,77,Embu,EASTERN,4018
MBEERE,Urban,1,45,32,77,Embu,EASTERN,4019
MBEERE,Urban,2,27,40,67,Embu,EASTERN,4020
MBEERE,Urban,3,30,30,60,Embu,EASTERN,4021
MBEERE,Urban,4,28,26,54,Embu,EASTERN,4022
MBEERE,Urban,5,35,25,60,Embu,EASTERN,4023
MBEERE,Urban,6,26,29,55,Embu,EASTERN,4024
MBEERE,Urban,7,26,18,44,Embu,EASTERN,4025
MBEERE,Urban,8,25,31,56,Embu,EASTERN,4026
MBEERE,Urban,9,28,39,67,Embu,EASTERN,4027
MBEERE,Urban,10,19,21,40,Embu,EASTERN,4028
MBEERE,Urban,11,22,18,40,Embu,EASTERN,4029
MBEERE,Urban,12,27,27,54,Embu,EASTERN,4030
MBEERE,Urban,13,24,30,54,Embu,EASTERN,4031
MBEERE,Urban,14,25,40,65,Embu,EASTERN,4032
MBEERE,Urban,15,27,31,58,Embu,EASTERN,4033
MBEERE,Urban,16,26,33,59,Embu,EASTERN,4034
MBEERE,Urban,17,25,23,48,Embu,EASTERN,4035
MBEERE,Urban,18,23,27,50,Embu,EASTERN,4036
MBEERE,Urban,19,19,20,39,Embu,EASTERN,4037
MBEERE,Urban,20,38,38,76,Embu,EASTERN,4038
MBEERE,Urban,21,20,34,54,Embu,EASTERN,4039
MBEERE,Urban,22,28,42,70,Embu,EASTERN,4040
MBEERE,Urban,23,33,56,89,Embu,EASTERN,4041
MBEERE,Urban,24,28,35,63,Embu,EASTERN,4042
MBEERE,Urban,25,44,46,90,Embu,EASTERN,4043
MBEERE,Urban,26,28,25,53,Embu,EASTERN,4044
MBEERE,Urban,27,25,36,61,Embu,EASTERN,4045
MBEERE,Urban,28,29,29,58,Embu,EASTERN,4046
MBEERE,Urban,29,32,32,64,Embu,EASTERN,4047
MBEERE,Urban,30,39,43,82,Embu,EASTERN,4048
MBEERE,Urban,31,17,16,33,Embu,EASTERN,4049
MBEERE,Urban,32,23,30,53,Embu,EASTERN,4050
MBEERE,Urban,33,15,25,40,Embu,EASTERN,4051
MBEERE,Urban,34,22,18,40,Embu,EASTERN,4052
MBEERE,Urban,35,39,27,66,Embu,EASTERN,4053
MBEERE,Urban,36,23,20,43,Embu,EASTERN,4054
MBEERE,Urban,37,13,15,28,Embu,EASTERN,4055
MBEERE,Urban,38,14,20,34,Embu,EASTERN,4056
MBEERE,Urban,39,19,16,35,Embu,EASTERN,4057
MBEERE,Urban,40,25,27,52,Embu,EASTERN,4058
MBEERE,Urban,41,11,9,20,Embu,EASTERN,4059
MBEERE,Urban,42,12,13,25,Embu,EASTERN,4060
MBEERE,Urban,43,13,12,25,Embu,EASTERN,4061
MBEERE,Urban,44,12,9,21,Embu,EASTERN,4062
MBEERE,Urban,45,23,20,43,Embu,EASTERN,4063
MBEERE,Urban,46,13,10,23,Embu,EASTERN,4064
MBEERE,Urban,47,14,8,22,Embu,EASTERN,4065
MBEERE,Urban,48,10,10,20,Embu,EASTERN,4066
MBEERE,Urban,49,12,8,20,Embu,EASTERN,4067
MBEERE,Urban,50,18,8,26,Embu,EASTERN,4068
MBEERE,Urban,51,4,2,6,Embu,EASTERN,4069
MBEERE,Urban,52,12,5,17,Embu,EASTERN,4070
MBEERE,Urban,53,7,4,11,Embu,EASTERN,4071
MBEERE,Urban,54,5,4,9,Embu,EASTERN,4072
MBEERE,Urban,55,4,9,13,Embu,EASTERN,4073
MBEERE,Urban,56,4,1,5,Embu,EASTERN,4074
MBEERE,Urban,57,5,5,10,Embu,EASTERN,4075
MBEERE,Urban,58,3,2,5,Embu,EASTERN,4076
MBEERE,Urban,59,8,4,12,Embu,EASTERN,4077
MBEERE,Urban,60,6,5,11,Embu,EASTERN,4078
MBEERE,Urban,61,2,3,5,Embu,EASTERN,4079
MBEERE,Urban,62,2,1,3,Embu,EASTERN,4080
MBEERE,Urban,63,2,1,3,Embu,EASTERN,4081
MBEERE,Urban,64,3,0,3,Embu,EASTERN,4082
MBEERE,Urban,65,3,3,6,Embu,EASTERN,4083
MBEERE,Urban,66,0,2,2,Embu,EASTERN,4084
MBEERE,Urban,67,1,2,3,Embu,EASTERN,4085
MBEERE,Urban,68,0,0,0,Embu,EASTERN,4086
MBEERE,Urban,69,0,2,2,Embu,EASTERN,4087
MBEERE,Urban,70,0,6,6,Embu,EASTERN,4088
MBEERE,Urban,71,1,0,1,Embu,EASTERN,4089
MBEERE,Urban,72,1,1,2,Embu,EASTERN,4090
MBEERE,Urban,73,0,0,0,Embu,EASTERN,4091
MBEERE,Urban,74,1,1,2,Embu,EASTERN,4092
MBEERE,Urban,75,2,0,2,Embu,EASTERN,4093
MBEERE,Urban,76,1,0,1,Embu,EASTERN,4094
MBEERE,Urban,77,0,1,1,Embu,EASTERN,4095
MBEERE,Urban,78,0,1,1,Embu,EASTERN,4096
MBEERE,Urban,79,1,3,4,Embu,EASTERN,4097
MBEERE,Urban,80+,7,5,12,Embu,EASTERN,4098
MBEERE,Urban,Age NS,0,0,0,Embu,EASTERN,4099
KITUI,Urban,0,1573,1549,3122,Kitui,EASTERN,4100
KITUI,Urban,1,1484,1439,2923,Kitui,EASTERN,4101
KITUI,Urban,2,1563,1540,3103,Kitui,EASTERN,4102
KITUI,Urban,3,1569,1583,3152,Kitui,EASTERN,4103
KITUI,Urban,4,1574,1533,3107,Kitui,EASTERN,4104
KITUI,Urban,5,1640,1517,3157,Kitui,EASTERN,4105
KITUI,Urban,6,1555,1479,3034,Kitui,EASTERN,4106
KITUI,Urban,7,1525,1463,2988,Kitui,EASTERN,4107
KITUI,Urban,8,1411,1506,2917,Kitui,EASTERN,4108
KITUI,Urban,9,1641,1591,3232,Kitui,EASTERN,4109
KITUI,Urban,10,1755,1674,3429,Kitui,EASTERN,4110
KITUI,Urban,11,1433,1391,2824,Kitui,EASTERN,4111
KITUI,Urban,12,1703,1653,3356,Kitui,EASTERN,4112
KITUI,Urban,13,1664,1672,3336,Kitui,EASTERN,4113
KITUI,Urban,14,1527,1472,2999,Kitui,EASTERN,4114
KITUI,Urban,15,1649,1577,3226,Kitui,EASTERN,4115
KITUI,Urban,16,1371,1482,2853,Kitui,EASTERN,4116
KITUI,Urban,17,1607,1627,3234,Kitui,EASTERN,4117
KITUI,Urban,18,1665,1385,3050,Kitui,EASTERN,4118
KITUI,Urban,19,1349,1227,2576,Kitui,EASTERN,4119
KITUI,Urban,20,1380,1392,2772,Kitui,EASTERN,4120
KITUI,Urban,21,1032,993,2025,Kitui,EASTERN,4121
KITUI,Urban,22,1104,1257,2361,Kitui,EASTERN,4122
KITUI,Urban,23,1048,1168,2216,Kitui,EASTERN,4123
KITUI,Urban,24,833,995,1828,Kitui,EASTERN,4124
KITUI,Urban,25,1059,1207,2266,Kitui,EASTERN,4125
KITUI,Urban,26,784,945,1729,Kitui,EASTERN,4126
KITUI,Urban,27,870,963,1833,Kitui,EASTERN,4127
KITUI,Urban,28,752,953,1705,Kitui,EASTERN,4128
KITUI,Urban,29,789,940,1729,Kitui,EASTERN,4129
KITUI,Urban,30,1076,1203,2279,Kitui,EASTERN,4130
KITUI,Urban,31,721,710,1431,Kitui,EASTERN,4131
KITUI,Urban,32,718,808,1526,Kitui,EASTERN,4132
KITUI,Urban,33,552,636,1188,Kitui,EASTERN,4133
KITUI,Urban,34,640,759,1399,Kitui,EASTERN,4134
KITUI,Urban,35,1004,1082,2086,Kitui,EASTERN,4135
KITUI,Urban,36,542,595,1137,Kitui,EASTERN,4136
KITUI,Urban,37,536,588,1124,Kitui,EASTERN,4137
KITUI,Urban,38,529,632,1161,Kitui,EASTERN,4138
KITUI,Urban,39,549,587,1136,Kitui,EASTERN,4139
KITUI,Urban,40,725,848,1573,Kitui,EASTERN,4140
KITUI,Urban,41,445,455,900,Kitui,EASTERN,4141
KITUI,Urban,42,427,469,896,Kitui,EASTERN,4142
KITUI,Urban,43,359,402,761,Kitui,EASTERN,4143
KITUI,Urban,44,374,346,720,Kitui,EASTERN,4144
KITUI,Urban,45,603,664,1267,Kitui,EASTERN,4145
KITUI,Urban,46,421,501,922,Kitui,EASTERN,4146
KITUI,Urban,47,362,389,751,Kitui,EASTERN,4147
KITUI,Urban,48,312,394,706,Kitui,EASTERN,4148
KITUI,Urban,49,354,365,719,Kitui,EASTERN,4149
KITUI,Urban,50,508,599,1107,Kitui,EASTERN,4150
KITUI,Urban,51,294,334,628,Kitui,EASTERN,4151
KITUI,Urban,52,304,259,563,Kitui,EASTERN,4152
KITUI,Urban,53,253,239,492,Kitui,EASTERN,4153
KITUI,Urban,54,236,233,469,Kitui,EASTERN,4154
KITUI,Urban,55,308,327,635,Kitui,EASTERN,4155
KITUI,Urban,56,239,238,477,Kitui,EASTERN,4156
KITUI,Urban,57,312,312,624,Kitui,EASTERN,4157
KITUI,Urban,58,191,186,377,Kitui,EASTERN,4158
KITUI,Urban,59,234,290,524,Kitui,EASTERN,4159
KITUI,Urban,60,369,442,811,Kitui,EASTERN,4160
KITUI,Urban,61,201,204,405,Kitui,EASTERN,4161
KITUI,Urban,62,155,137,292,Kitui,EASTERN,4162
KITUI,Urban,63,190,319,509,Kitui,EASTERN,4163
KITUI,Urban,64,161,244,405,Kitui,EASTERN,4164
KITUI,Urban,65,195,228,423,Kitui,EASTERN,4165
KITUI,Urban,66,94,102,196,Kitui,EASTERN,4166
KITUI,Urban,67,142,161,303,Kitui,EASTERN,4167
KITUI,Urban,68,123,114,237,Kitui,EASTERN,4168
KITUI,Urban,69,150,200,350,Kitui,EASTERN,4169
KITUI,Urban,70,230,342,572,Kitui,EASTERN,4170
KITUI,Urban,71,109,114,223,Kitui,EASTERN,4171
KITUI,Urban,72,101,99,200,Kitui,EASTERN,4172
KITUI,Urban,73,108,111,219,Kitui,EASTERN,4173
KITUI,Urban,74,125,142,267,Kitui,EASTERN,4174
KITUI,Urban,75,122,137,259,Kitui,EASTERN,4175
KITUI,Urban,76,78,63,141,Kitui,EASTERN,4176
KITUI,Urban,77,56,69,125,Kitui,EASTERN,4177
KITUI,Urban,78,53,57,110,Kitui,EASTERN,4178
KITUI,Urban,79,106,169,275,Kitui,EASTERN,4179
KITUI,Urban,80+,871,1455,2326,Kitui,EASTERN,4180
KITUI,Urban,Age NS,32,25,57,Kitui,EASTERN,4181
MUTOMO,Urban,0,15,21,36,Kitui,EASTERN,4182
MUTOMO,Urban,1,11,9,20,Kitui,EASTERN,4183
MUTOMO,Urban,2,18,19,37,Kitui,EASTERN,4184
MUTOMO,Urban,3,11,10,21,Kitui,EASTERN,4185
MUTOMO,Urban,4,22,12,34,Kitui,EASTERN,4186
MUTOMO,Urban,5,15,13,28,Kitui,EASTERN,4187
MUTOMO,Urban,6,15,16,31,Kitui,EASTERN,4188
MUTOMO,Urban,7,11,10,21,Kitui,EASTERN,4189
MUTOMO,Urban,8,15,6,21,Kitui,EASTERN,4190
MUTOMO,Urban,9,17,15,32,Kitui,EASTERN,4191
MUTOMO,Urban,10,13,16,29,Kitui,EASTERN,4192
MUTOMO,Urban,11,14,5,19,Kitui,EASTERN,4193
MUTOMO,Urban,12,17,11,28,Kitui,EASTERN,4194
MUTOMO,Urban,13,10,9,19,Kitui,EASTERN,4195
MUTOMO,Urban,14,7,12,19,Kitui,EASTERN,4196
MUTOMO,Urban,15,9,26,35,Kitui,EASTERN,4197
MUTOMO,Urban,16,8,55,63,Kitui,EASTERN,4198
MUTOMO,Urban,17,11,86,97,Kitui,EASTERN,4199
MUTOMO,Urban,18,10,68,78,Kitui,EASTERN,4200
MUTOMO,Urban,19,12,24,36,Kitui,EASTERN,4201
MUTOMO,Urban,20,18,26,44,Kitui,EASTERN,4202
MUTOMO,Urban,21,16,31,47,Kitui,EASTERN,4203
MUTOMO,Urban,22,16,21,37,Kitui,EASTERN,4204
MUTOMO,Urban,23,10,11,21,Kitui,EASTERN,4205
MUTOMO,Urban,24,16,11,27,Kitui,EASTERN,4206
MUTOMO,Urban,25,14,17,31,Kitui,EASTERN,4207
MUTOMO,Urban,26,4,20,24,Kitui,EASTERN,4208
MUTOMO,Urban,27,7,20,27,Kitui,EASTERN,4209
MUTOMO,Urban,28,7,16,23,Kitui,EASTERN,4210
MUTOMO,Urban,29,11,12,23,Kitui,EASTERN,4211
MUTOMO,Urban,30,13,22,35,Kitui,EASTERN,4212
MUTOMO,Urban,31,7,7,14,Kitui,EASTERN,4213
MUTOMO,Urban,32,11,19,30,Kitui,EASTERN,4214
MUTOMO,Urban,33,10,5,15,Kitui,EASTERN,4215
MUTOMO,Urban,34,10,10,20,Kitui,EASTERN,4216
MUTOMO,Urban,35,14,20,34,Kitui,EASTERN,4217
MUTOMO,Urban,36,12,7,19,Kitui,EASTERN,4218
MUTOMO,Urban,37,5,6,11,Kitui,EASTERN,4219
MUTOMO,Urban,38,4,12,16,Kitui,EASTERN,4220
MUTOMO,Urban,39,6,13,19,Kitui,EASTERN,4221
MUTOMO,Urban,40,13,19,32,Kitui,EASTERN,4222
MUTOMO,Urban,41,6,8,14,Kitui,EASTERN,4223
MUTOMO,Urban,42,8,6,14,Kitui,EASTERN,4224
MUTOMO,Urban,43,5,4,9,Kitui,EASTERN,4225
MUTOMO,Urban,44,0,3,3,Kitui,EASTERN,4226
MUTOMO,Urban,45,10,11,21,Kitui,EASTERN,4227
MUTOMO,Urban,46,10,3,13,Kitui,EASTERN,4228
MUTOMO,Urban,47,1,2,3,Kitui,EASTERN,4229
MUTOMO,Urban,48,3,6,9,Kitui,EASTERN,4230
MUTOMO,Urban,49,8,4,12,Kitui,EASTERN,4231
MUTOMO,Urban,50,5,7,12,Kitui,EASTERN,4232
MUTOMO,Urban,51,7,1,8,Kitui,EASTERN,4233
MUTOMO,Urban,52,5,3,8,Kitui,EASTERN,4234
MUTOMO,Urban,53,4,0,4,Kitui,EASTERN,4235
MUTOMO,Urban,54,5,4,9,Kitui,EASTERN,4236
MUTOMO,Urban,55,5,3,8,Kitui,EASTERN,4237
MUTOMO,Urban,56,3,3,6,Kitui,EASTERN,4238
MUTOMO,Urban,57,5,6,11,Kitui,EASTERN,4239
MUTOMO,Urban,58,1,1,2,Kitui,EASTERN,4240
MUTOMO,Urban,59,0,5,5,Kitui,EASTERN,4241
MUTOMO,Urban,60,6,5,11,Kitui,EASTERN,4242
MUTOMO,Urban,61,5,2,7,Kitui,EASTERN,4243
MUTOMO,Urban,62,3,1,4,Kitui,EASTERN,4244
MUTOMO,Urban,63,1,0,1,Kitui,EASTERN,4245
MUTOMO,Urban,64,0,1,1,Kitui,EASTERN,4246
MUTOMO,Urban,65,3,0,3,Kitui,EASTERN,4247
MUTOMO,Urban,66,0,0,0,Kitui,EASTERN,4248
MUTOMO,Urban,67,3,1,4,Kitui,EASTERN,4249
MUTOMO,Urban,68,0,0,0,Kitui,EASTERN,4250
MUTOMO,Urban,69,0,1,1,Kitui,EASTERN,4251
MUTOMO,Urban,70,5,4,9,Kitui,EASTERN,4252
MUTOMO,Urban,71,0,2,2,Kitui,EASTERN,4253
MUTOMO,Urban,72,2,0,2,Kitui,EASTERN,4254
MUTOMO,Urban,73,4,0,4,Kitui,EASTERN,4255
MUTOMO,Urban,74,1,1,2,Kitui,EASTERN,4256
MUTOMO,Urban,75,0,1,1,Kitui,EASTERN,4257
MUTOMO,Urban,76,2,0,2,Kitui,EASTERN,4258
MUTOMO,Urban,77,0,0,0,Kitui,EASTERN,4259
MUTOMO,Urban,78,1,0,1,Kitui,EASTERN,4260
MUTOMO,Urban,79,0,0,0,Kitui,EASTERN,4261
MUTOMO,Urban,80+,4,13,17,Kitui,EASTERN,4262
MUTOMO,Urban,Age NS,0,0,0,Kitui,EASTERN,4263
MWINGI,Urban,0,286,247,533,Kitui,EASTERN,4264
MWINGI,Urban,1,203,235,438,Kitui,EASTERN,4265
MWINGI,Urban,2,195,184,379,Kitui,EASTERN,4266
MWINGI,Urban,3,205,223,428,Kitui,EASTERN,4267
MWINGI,Urban,4,200,187,387,Kitui,EASTERN,4268
MWINGI,Urban,5,200,219,419,Kitui,EASTERN,4269
MWINGI,Urban,6,195,197,392,Kitui,EASTERN,4270
MWINGI,Urban,7,178,188,366,Kitui,EASTERN,4271
MWINGI,Urban,8,179,185,364,Kitui,EASTERN,4272
MWINGI,Urban,9,177,162,339,Kitui,EASTERN,4273
MWINGI,Urban,10,179,206,385,Kitui,EASTERN,4274
MWINGI,Urban,11,145,169,314,Kitui,EASTERN,4275
MWINGI,Urban,12,151,158,309,Kitui,EASTERN,4276
MWINGI,Urban,13,184,187,371,Kitui,EASTERN,4277
MWINGI,Urban,14,152,152,304,Kitui,EASTERN,4278
MWINGI,Urban,15,140,169,309,Kitui,EASTERN,4279
MWINGI,Urban,16,122,158,280,Kitui,EASTERN,4280
MWINGI,Urban,17,116,170,286,Kitui,EASTERN,4281
MWINGI,Urban,18,160,175,335,Kitui,EASTERN,4282
MWINGI,Urban,19,165,205,370,Kitui,EASTERN,4283
MWINGI,Urban,20,218,321,539,Kitui,EASTERN,4284
MWINGI,Urban,21,176,243,419,Kitui,EASTERN,4285
MWINGI,Urban,22,229,263,492,Kitui,EASTERN,4286
MWINGI,Urban,23,218,295,513,Kitui,EASTERN,4287
MWINGI,Urban,24,163,241,404,Kitui,EASTERN,4288
MWINGI,Urban,25,232,307,539,Kitui,EASTERN,4289
MWINGI,Urban,26,191,231,422,Kitui,EASTERN,4290
MWINGI,Urban,27,170,205,375,Kitui,EASTERN,4291
MWINGI,Urban,28,220,244,464,Kitui,EASTERN,4292
MWINGI,Urban,29,159,206,365,Kitui,EASTERN,4293
MWINGI,Urban,30,269,235,504,Kitui,EASTERN,4294
MWINGI,Urban,31,140,142,282,Kitui,EASTERN,4295
MWINGI,Urban,32,174,154,328,Kitui,EASTERN,4296
MWINGI,Urban,33,111,105,216,Kitui,EASTERN,4297
MWINGI,Urban,34,137,124,261,Kitui,EASTERN,4298
MWINGI,Urban,35,187,161,348,Kitui,EASTERN,4299
MWINGI,Urban,36,123,98,221,Kitui,EASTERN,4300
MWINGI,Urban,37,102,67,169,Kitui,EASTERN,4301
MWINGI,Urban,38,126,101,227,Kitui,EASTERN,4302
MWINGI,Urban,39,102,80,182,Kitui,EASTERN,4303
MWINGI,Urban,40,183,127,310,Kitui,EASTERN,4304
MWINGI,Urban,41,77,55,132,Kitui,EASTERN,4305
MWINGI,Urban,42,74,62,136,Kitui,EASTERN,4306
MWINGI,Urban,43,82,41,123,Kitui,EASTERN,4307
MWINGI,Urban,44,64,47,111,Kitui,EASTERN,4308
MWINGI,Urban,45,109,68,177,Kitui,EASTERN,4309
MWINGI,Urban,46,73,41,114,Kitui,EASTERN,4310
MWINGI,Urban,47,58,41,99,Kitui,EASTERN,4311
MWINGI,Urban,48,49,49,98,Kitui,EASTERN,4312
MWINGI,Urban,49,47,26,73,Kitui,EASTERN,4313
MWINGI,Urban,50,75,60,135,Kitui,EASTERN,4314
MWINGI,Urban,51,46,24,70,Kitui,EASTERN,4315
MWINGI,Urban,52,48,20,68,Kitui,EASTERN,4316
MWINGI,Urban,53,35,9,44,Kitui,EASTERN,4317
MWINGI,Urban,54,32,18,50,Kitui,EASTERN,4318
MWINGI,Urban,55,39,18,57,Kitui,EASTERN,4319
MWINGI,Urban,56,32,16,48,Kitui,EASTERN,4320
MWINGI,Urban,57,36,23,59,Kitui,EASTERN,4321
MWINGI,Urban,58,19,9,28,Kitui,EASTERN,4322
MWINGI,Urban,59,13,17,30,Kitui,EASTERN,4323
MWINGI,Urban,60,36,30,66,Kitui,EASTERN,4324
MWINGI,Urban,61,16,8,24,Kitui,EASTERN,4325
MWINGI,Urban,62,17,11,28,Kitui,EASTERN,4326
MWINGI,Urban,63,12,11,23,Kitui,EASTERN,4327
MWINGI,Urban,64,16,11,27,Kitui,EASTERN,4328
MWINGI,Urban,65,19,16,35,Kitui,EASTERN,4329
MWINGI,Urban,66,11,3,14,Kitui,EASTERN,4330
MWINGI,Urban,67,16,10,26,Kitui,EASTERN,4331
MWINGI,Urban,68,18,6,24,Kitui,EASTERN,4332
MWINGI,Urban,69,9,13,22,Kitui,EASTERN,4333
MWINGI,Urban,70,24,25,49,Kitui,EASTERN,4334
MWINGI,Urban,71,2,6,8,Kitui,EASTERN,4335
MWINGI,Urban,72,10,3,13,Kitui,EASTERN,4336
MWINGI,Urban,73,7,3,10,Kitui,EASTERN,4337
MWINGI,Urban,74,6,2,8,Kitui,EASTERN,4338
MWINGI,Urban,75,10,4,14,Kitui,EASTERN,4339
MWINGI,Urban,76,8,1,9,Kitui,EASTERN,4340
MWINGI,Urban,77,4,5,9,Kitui,EASTERN,4341
MWINGI,Urban,78,12,4,16,Kitui,EASTERN,4342
MWINGI,Urban,79,7,8,15,Kitui,EASTERN,4343
MWINGI,Urban,80+,45,64,109,Kitui,EASTERN,4344
MWINGI,Urban,Age NS,10,4,14,Kitui,EASTERN,4345
KYUSO,Urban,0,14,15,29,Kitui,EASTERN,4346
KYUSO,Urban,1,11,16,27,Kitui,EASTERN,4347
KYUSO,Urban,2,7,14,21,Kitui,EASTERN,4348
KYUSO,Urban,3,13,14,27,Kitui,EASTERN,4349
KYUSO,Urban,4,12,13,25,Kitui,EASTERN,4350
KYUSO,Urban,5,8,11,19,Kitui,EASTERN,4351
KYUSO,Urban,6,9,11,20,Kitui,EASTERN,4352
KYUSO,Urban,7,10,8,18,Kitui,EASTERN,4353
KYUSO,Urban,8,11,13,24,Kitui,EASTERN,4354
KYUSO,Urban,9,8,11,19,Kitui,EASTERN,4355
KYUSO,Urban,10,10,12,22,Kitui,EASTERN,4356
KYUSO,Urban,11,4,8,12,Kitui,EASTERN,4357
KYUSO,Urban,12,6,8,14,Kitui,EASTERN,4358
KYUSO,Urban,13,8,9,17,Kitui,EASTERN,4359
KYUSO,Urban,14,4,4,8,Kitui,EASTERN,4360
KYUSO,Urban,15,7,5,12,Kitui,EASTERN,4361
KYUSO,Urban,16,8,4,12,Kitui,EASTERN,4362
KYUSO,Urban,17,5,8,13,Kitui,EASTERN,4363
KYUSO,Urban,18,3,11,14,Kitui,EASTERN,4364
KYUSO,Urban,19,7,12,19,Kitui,EASTERN,4365
KYUSO,Urban,20,8,22,30,Kitui,EASTERN,4366
KYUSO,Urban,21,2,12,14,Kitui,EASTERN,4367
KYUSO,Urban,22,8,15,23,Kitui,EASTERN,4368
KYUSO,Urban,23,11,16,27,Kitui,EASTERN,4369
KYUSO,Urban,24,19,7,26,Kitui,EASTERN,4370
KYUSO,Urban,25,16,24,40,Kitui,EASTERN,4371
KYUSO,Urban,26,15,8,23,Kitui,EASTERN,4372
KYUSO,Urban,27,13,6,19,Kitui,EASTERN,4373
KYUSO,Urban,28,10,14,24,Kitui,EASTERN,4374
KYUSO,Urban,29,16,11,27,Kitui,EASTERN,4375
KYUSO,Urban,30,11,12,23,Kitui,EASTERN,4376
KYUSO,Urban,31,8,5,13,Kitui,EASTERN,4377
KYUSO,Urban,32,7,13,20,Kitui,EASTERN,4378
KYUSO,Urban,33,14,5,19,Kitui,EASTERN,4379
KYUSO,Urban,34,8,3,11,Kitui,EASTERN,4380
KYUSO,Urban,35,13,9,22,Kitui,EASTERN,4381
KYUSO,Urban,36,6,8,14,Kitui,EASTERN,4382
KYUSO,Urban,37,10,9,19,Kitui,EASTERN,4383
KYUSO,Urban,38,6,9,15,Kitui,EASTERN,4384
KYUSO,Urban,39,3,1,4,Kitui,EASTERN,4385
KYUSO,Urban,40,10,7,17,Kitui,EASTERN,4386
KYUSO,Urban,41,4,4,8,Kitui,EASTERN,4387
KYUSO,Urban,42,9,2,11,Kitui,EASTERN,4388
KYUSO,Urban,43,6,4,10,Kitui,EASTERN,4389
KYUSO,Urban,44,4,4,8,Kitui,EASTERN,4390
KYUSO,Urban,45,4,5,9,Kitui,EASTERN,4391
KYUSO,Urban,46,5,3,8,Kitui,EASTERN,4392
KYUSO,Urban,47,4,1,5,Kitui,EASTERN,4393
KYUSO,Urban,48,7,4,11,Kitui,EASTERN,4394
KYUSO,Urban,49,5,5,10,Kitui,EASTERN,4395
KYUSO,Urban,50,4,3,7,Kitui,EASTERN,4396
KYUSO,Urban,51,3,2,5,Kitui,EASTERN,4397
KYUSO,Urban,52,3,0,3,Kitui,EASTERN,4398
KYUSO,Urban,53,3,0,3,Kitui,EASTERN,4399
KYUSO,Urban,54,2,1,3,Kitui,EASTERN,4400
KYUSO,Urban,55,4,1,5,Kitui,EASTERN,4401
KYUSO,Urban,56,1,0,1,Kitui,EASTERN,4402
KYUSO,Urban,57,0,1,1,Kitui,EASTERN,4403
KYUSO,Urban,58,1,1,2,Kitui,EASTERN,4404
KYUSO,Urban,59,1,3,4,Kitui,EASTERN,4405
KYUSO,Urban,60,2,2,4,Kitui,EASTERN,4406
KYUSO,Urban,61,1,0,1,Kitui,EASTERN,4407
KYUSO,Urban,62,1,1,2,Kitui,EASTERN,4408
KYUSO,Urban,63,0,0,0,Kitui,EASTERN,4409
KYUSO,Urban,64,1,1,2,Kitui,EASTERN,4410
KYUSO,Urban,65,1,0,1,Kitui,EASTERN,4411
KYUSO,Urban,66,0,0,0,Kitui,EASTERN,4412
KYUSO,Urban,67,3,0,3,Kitui,EASTERN,4413
KYUSO,Urban,68,0,1,1,Kitui,EASTERN,4414
KYUSO,Urban,69,0,1,1,Kitui,EASTERN,4415
KYUSO,Urban,70,2,0,2,Kitui,EASTERN,4416
KYUSO,Urban,71,1,2,3,Kitui,EASTERN,4417
KYUSO,Urban,72,1,0,1,Kitui,EASTERN,4418
KYUSO,Urban,73,0,0,0,Kitui,EASTERN,4419
KYUSO,Urban,74,0,0,0,Kitui,EASTERN,4420
KYUSO,Urban,75,0,0,0,Kitui,EASTERN,4421
KYUSO,Urban,76,0,0,0,Kitui,EASTERN,4422
KYUSO,Urban,77,1,0,1,Kitui,EASTERN,4423
KYUSO,Urban,78,1,0,1,Kitui,EASTERN,4424
KYUSO,Urban,79,2,1,3,Kitui,EASTERN,4425
KYUSO,Urban,80+,2,1,3,Kitui,EASTERN,4426
KYUSO,Urban,Age NS,0,0,0,Kitui,EASTERN,4427
MACHAKOS,Urban,0,4029,4109,8138,Machakos,EASTERN,4428
MACHAKOS,Urban,1,3435,3456,6891,Machakos,EASTERN,4429
MACHAKOS,Urban,2,3524,3613,7137,Machakos,EASTERN,4430
MACHAKOS,Urban,3,3523,3308,6831,Machakos,EASTERN,4431
MACHAKOS,Urban,4,3516,3346,6862,Machakos,EASTERN,4432
MACHAKOS,Urban,5,3540,3248,6788,Machakos,EASTERN,4433
MACHAKOS,Urban,6,3045,3036,6081,Machakos,EASTERN,4434
MACHAKOS,Urban,7,3078,3051,6129,Machakos,EASTERN,4435
MACHAKOS,Urban,8,2882,2974,5856,Machakos,EASTERN,4436
MACHAKOS,Urban,9,3173,3115,6288,Machakos,EASTERN,4437
MACHAKOS,Urban,10,3100,3091,6191,Machakos,EASTERN,4438
MACHAKOS,Urban,11,2633,2572,5205,Machakos,EASTERN,4439
MACHAKOS,Urban,12,2996,2933,5929,Machakos,EASTERN,4440
MACHAKOS,Urban,13,3095,3038,6133,Machakos,EASTERN,4441
MACHAKOS,Urban,14,2728,2706,5434,Machakos,EASTERN,4442
MACHAKOS,Urban,15,2587,2619,5206,Machakos,EASTERN,4443
MACHAKOS,Urban,16,2490,2598,5088,Machakos,EASTERN,4444
MACHAKOS,Urban,17,2669,2741,5410,Machakos,EASTERN,4445
MACHAKOS,Urban,18,3016,2900,5916,Machakos,EASTERN,4446
MACHAKOS,Urban,19,2995,2977,5972,Machakos,EASTERN,4447
MACHAKOS,Urban,20,3621,4169,7790,Machakos,EASTERN,4448
MACHAKOS,Urban,21,3104,3292,6396,Machakos,EASTERN,4449
MACHAKOS,Urban,22,3676,4008,7684,Machakos,EASTERN,4450
MACHAKOS,Urban,23,3775,3970,7745,Machakos,EASTERN,4451
MACHAKOS,Urban,24,3732,3603,7335,Machakos,EASTERN,4452
MACHAKOS,Urban,25,4401,4270,8671,Machakos,EASTERN,4453
MACHAKOS,Urban,26,3460,3234,6694,Machakos,EASTERN,4454
MACHAKOS,Urban,27,3616,3022,6638,Machakos,EASTERN,4455
MACHAKOS,Urban,28,3381,3174,6555,Machakos,EASTERN,4456
MACHAKOS,Urban,29,3297,2798,6095,Machakos,EASTERN,4457
MACHAKOS,Urban,30,4373,3762,8135,Machakos,EASTERN,4458
MACHAKOS,Urban,31,2503,1839,4342,Machakos,EASTERN,4459
MACHAKOS,Urban,32,3078,2464,5542,Machakos,EASTERN,4460
MACHAKOS,Urban,33,2138,1750,3888,Machakos,EASTERN,4461
MACHAKOS,Urban,34,2473,1832,4305,Machakos,EASTERN,4462
MACHAKOS,Urban,35,3355,2679,6034,Machakos,EASTERN,4463
MACHAKOS,Urban,36,1993,1609,3602,Machakos,EASTERN,4464
MACHAKOS,Urban,37,1955,1439,3394,Machakos,EASTERN,4465
MACHAKOS,Urban,38,2078,1687,3765,Machakos,EASTERN,4466
MACHAKOS,Urban,39,1914,1449,3363,Machakos,EASTERN,4467
MACHAKOS,Urban,40,2712,2068,4780,Machakos,EASTERN,4468
MACHAKOS,Urban,41,1380,970,2350,Machakos,EASTERN,4469
MACHAKOS,Urban,42,1507,1139,2646,Machakos,EASTERN,4470
MACHAKOS,Urban,43,1113,892,2005,Machakos,EASTERN,4471
MACHAKOS,Urban,44,1110,828,1938,Machakos,EASTERN,4472
MACHAKOS,Urban,45,1825,1490,3315,Machakos,EASTERN,4473
MACHAKOS,Urban,46,1262,1024,2286,Machakos,EASTERN,4474
MACHAKOS,Urban,47,1171,880,2051,Machakos,EASTERN,4475
MACHAKOS,Urban,48,1051,891,1942,Machakos,EASTERN,4476
MACHAKOS,Urban,49,1183,885,2068,Machakos,EASTERN,4477
MACHAKOS,Urban,50,1516,1187,2703,Machakos,EASTERN,4478
MACHAKOS,Urban,51,892,634,1526,Machakos,EASTERN,4479
MACHAKOS,Urban,52,863,651,1514,Machakos,EASTERN,4480
MACHAKOS,Urban,53,706,542,1248,Machakos,EASTERN,4481
MACHAKOS,Urban,54,690,501,1191,Machakos,EASTERN,4482
MACHAKOS,Urban,55,813,655,1468,Machakos,EASTERN,4483
MACHAKOS,Urban,56,635,510,1145,Machakos,EASTERN,4484
MACHAKOS,Urban,57,713,657,1370,Machakos,EASTERN,4485
MACHAKOS,Urban,58,429,372,801,Machakos,EASTERN,4486
MACHAKOS,Urban,59,532,417,949,Machakos,EASTERN,4487
MACHAKOS,Urban,60,700,633,1333,Machakos,EASTERN,4488
MACHAKOS,Urban,61,423,357,780,Machakos,EASTERN,4489
MACHAKOS,Urban,62,378,243,621,Machakos,EASTERN,4490
MACHAKOS,Urban,63,332,277,609,Machakos,EASTERN,4491
MACHAKOS,Urban,64,311,298,609,Machakos,EASTERN,4492
MACHAKOS,Urban,65,312,335,647,Machakos,EASTERN,4493
MACHAKOS,Urban,66,177,177,354,Machakos,EASTERN,4494
MACHAKOS,Urban,67,286,276,562,Machakos,EASTERN,4495
MACHAKOS,Urban,68,190,174,364,Machakos,EASTERN,4496
MACHAKOS,Urban,69,186,247,433,Machakos,EASTERN,4497
MACHAKOS,Urban,70,356,470,826,Machakos,EASTERN,4498
MACHAKOS,Urban,71,172,177,349,Machakos,EASTERN,4499
MACHAKOS,Urban,72,163,170,333,Machakos,EASTERN,4500
MACHAKOS,Urban,73,149,170,319,Machakos,EASTERN,4501
MACHAKOS,Urban,74,141,144,285,Machakos,EASTERN,4502
MACHAKOS,Urban,75,173,220,393,Machakos,EASTERN,4503
MACHAKOS,Urban,76,102,86,188,Machakos,EASTERN,4504
MACHAKOS,Urban,77,110,108,218,Machakos,EASTERN,4505
MACHAKOS,Urban,78,97,96,193,Machakos,EASTERN,4506
MACHAKOS,Urban,79,101,173,274,Machakos,EASTERN,4507
MACHAKOS,Urban,80+,1044,1767,2811,Machakos,EASTERN,4508
MACHAKOS,Urban,Age NS,100,79,179,Machakos,EASTERN,4509
MWALA,Urban,0,68,56,124,Machakos,EASTERN,4510
MWALA,Urban,1,76,74,150,Machakos,EASTERN,4511
MWALA,Urban,2,62,55,117,Machakos,EASTERN,4512
MWALA,Urban,3,61,71,132,Machakos,EASTERN,4513
MWALA,Urban,4,64,72,136,Machakos,EASTERN,4514
MWALA,Urban,5,54,50,104,Machakos,EASTERN,4515
MWALA,Urban,6,48,46,94,Machakos,EASTERN,4516
MWALA,Urban,7,65,44,109,Machakos,EASTERN,4517
MWALA,Urban,8,52,48,100,Machakos,EASTERN,4518
MWALA,Urban,9,62,49,111,Machakos,EASTERN,4519
MWALA,Urban,10,36,63,99,Machakos,EASTERN,4520
MWALA,Urban,11,41,50,91,Machakos,EASTERN,4521
MWALA,Urban,12,69,48,117,Machakos,EASTERN,4522
MWALA,Urban,13,42,46,88,Machakos,EASTERN,4523
MWALA,Urban,14,52,43,95,Machakos,EASTERN,4524
MWALA,Urban,15,33,48,81,Machakos,EASTERN,4525
MWALA,Urban,16,40,44,84,Machakos,EASTERN,4526
MWALA,Urban,17,52,53,105,Machakos,EASTERN,4527
MWALA,Urban,18,69,77,146,Machakos,EASTERN,4528
MWALA,Urban,19,70,58,128,Machakos,EASTERN,4529
MWALA,Urban,20,65,93,158,Machakos,EASTERN,4530
MWALA,Urban,21,48,61,109,Machakos,EASTERN,4531
MWALA,Urban,22,48,71,119,Machakos,EASTERN,4532
MWALA,Urban,23,70,73,143,Machakos,EASTERN,4533
MWALA,Urban,24,46,69,115,Machakos,EASTERN,4534
MWALA,Urban,25,73,78,151,Machakos,EASTERN,4535
MWALA,Urban,26,48,58,106,Machakos,EASTERN,4536
MWALA,Urban,27,60,58,118,Machakos,EASTERN,4537
MWALA,Urban,28,62,64,126,Machakos,EASTERN,4538
MWALA,Urban,29,47,61,108,Machakos,EASTERN,4539
MWALA,Urban,30,82,98,180,Machakos,EASTERN,4540
MWALA,Urban,31,38,52,90,Machakos,EASTERN,4541
MWALA,Urban,32,57,64,121,Machakos,EASTERN,4542
MWALA,Urban,33,37,40,77,Machakos,EASTERN,4543
MWALA,Urban,34,44,57,101,Machakos,EASTERN,4544
MWALA,Urban,35,69,54,123,Machakos,EASTERN,4545
MWALA,Urban,36,44,42,86,Machakos,EASTERN,4546
MWALA,Urban,37,41,34,75,Machakos,EASTERN,4547
MWALA,Urban,38,31,51,82,Machakos,EASTERN,4548
MWALA,Urban,39,37,39,76,Machakos,EASTERN,4549
MWALA,Urban,40,48,55,103,Machakos,EASTERN,4550
MWALA,Urban,41,22,20,42,Machakos,EASTERN,4551
MWALA,Urban,42,30,35,65,Machakos,EASTERN,4552
MWALA,Urban,43,20,28,48,Machakos,EASTERN,4553
MWALA,Urban,44,19,5,24,Machakos,EASTERN,4554
MWALA,Urban,45,34,19,53,Machakos,EASTERN,4555
MWALA,Urban,46,17,18,35,Machakos,EASTERN,4556
MWALA,Urban,47,20,18,38,Machakos,EASTERN,4557
MWALA,Urban,48,16,13,29,Machakos,EASTERN,4558
MWALA,Urban,49,18,18,36,Machakos,EASTERN,4559
MWALA,Urban,50,26,29,55,Machakos,EASTERN,4560
MWALA,Urban,51,13,8,21,Machakos,EASTERN,4561
MWALA,Urban,52,13,11,24,Machakos,EASTERN,4562
MWALA,Urban,53,9,12,21,Machakos,EASTERN,4563
MWALA,Urban,54,10,10,20,Machakos,EASTERN,4564
MWALA,Urban,55,13,16,29,Machakos,EASTERN,4565
MWALA,Urban,56,9,6,15,Machakos,EASTERN,4566
MWALA,Urban,57,13,9,22,Machakos,EASTERN,4567
MWALA,Urban,58,6,5,11,Machakos,EASTERN,4568
MWALA,Urban,59,8,6,14,Machakos,EASTERN,4569
MWALA,Urban,60,12,11,23,Machakos,EASTERN,4570
MWALA,Urban,61,6,6,12,Machakos,EASTERN,4571
MWALA,Urban,62,2,2,4,Machakos,EASTERN,4572
MWALA,Urban,63,0,2,2,Machakos,EASTERN,4573
MWALA,Urban,64,8,7,15,Machakos,EASTERN,4574
MWALA,Urban,65,8,6,14,Machakos,EASTERN,4575
MWALA,Urban,66,1,3,4,Machakos,EASTERN,4576
MWALA,Urban,67,4,2,6,Machakos,EASTERN,4577
MWALA,Urban,68,3,0,3,Machakos,EASTERN,4578
MWALA,Urban,69,2,5,7,Machakos,EASTERN,4579
MWALA,Urban,70,4,5,9,Machakos,EASTERN,4580
MWALA,Urban,71,3,3,6,Machakos,EASTERN,4581
MWALA,Urban,72,2,3,5,Machakos,EASTERN,4582
MWALA,Urban,73,0,2,2,Machakos,EASTERN,4583
MWALA,Urban,74,2,2,4,Machakos,EASTERN,4584
MWALA,Urban,75,3,2,5,Machakos,EASTERN,4585
MWALA,Urban,76,0,1,1,Machakos,EASTERN,4586
MWALA,Urban,77,3,1,4,Machakos,EASTERN,4587
MWALA,Urban,78,1,3,4,Machakos,EASTERN,4588
MWALA,Urban,79,1,4,5,Machakos,EASTERN,4589
MWALA,Urban,80+,16,25,41,Machakos,EASTERN,4590
MWALA,Urban,Age NS,0,0,0,Machakos,EASTERN,4591
YATTA,Urban,0,724,742,1466,Machakos,EASTERN,4592
YATTA,Urban,1,685,670,1355,Machakos,EASTERN,4593
YATTA,Urban,2,738,740,1478,Machakos,EASTERN,4594
YATTA,Urban,3,723,718,1441,Machakos,EASTERN,4595
YATTA,Urban,4,766,767,1533,Machakos,EASTERN,4596
YATTA,Urban,5,771,759,1530,Machakos,EASTERN,4597
YATTA,Urban,6,766,738,1504,Machakos,EASTERN,4598
YATTA,Urban,7,747,750,1497,Machakos,EASTERN,4599
YATTA,Urban,8,597,659,1256,Machakos,EASTERN,4600
YATTA,Urban,9,835,773,1608,Machakos,EASTERN,4601
YATTA,Urban,10,752,682,1434,Machakos,EASTERN,4602
YATTA,Urban,11,623,609,1232,Machakos,EASTERN,4603
YATTA,Urban,12,741,685,1426,Machakos,EASTERN,4604
YATTA,Urban,13,752,687,1439,Machakos,EASTERN,4605
YATTA,Urban,14,665,630,1295,Machakos,EASTERN,4606
YATTA,Urban,15,617,637,1254,Machakos,EASTERN,4607
YATTA,Urban,16,582,538,1120,Machakos,EASTERN,4608
YATTA,Urban,17,680,551,1231,Machakos,EASTERN,4609
YATTA,Urban,18,651,535,1186,Machakos,EASTERN,4610
YATTA,Urban,19,572,516,1088,Machakos,EASTERN,4611
YATTA,Urban,20,593,618,1211,Machakos,EASTERN,4612
YATTA,Urban,21,460,417,877,Machakos,EASTERN,4613
YATTA,Urban,22,445,517,962,Machakos,EASTERN,4614
YATTA,Urban,23,471,526,997,Machakos,EASTERN,4615
YATTA,Urban,24,406,460,866,Machakos,EASTERN,4616
YATTA,Urban,25,472,541,1013,Machakos,EASTERN,4617
YATTA,Urban,26,377,452,829,Machakos,EASTERN,4618
YATTA,Urban,27,432,452,884,Machakos,EASTERN,4619
YATTA,Urban,28,331,445,776,Machakos,EASTERN,4620
YATTA,Urban,29,390,431,821,Machakos,EASTERN,4621
YATTA,Urban,30,505,523,1028,Machakos,EASTERN,4622
YATTA,Urban,31,322,356,678,Machakos,EASTERN,4623
YATTA,Urban,32,308,391,699,Machakos,EASTERN,4624
YATTA,Urban,33,252,300,552,Machakos,EASTERN,4625
YATTA,Urban,34,315,299,614,Machakos,EASTERN,4626
YATTA,Urban,35,398,426,824,Machakos,EASTERN,4627
YATTA,Urban,36,264,281,545,Machakos,EASTERN,4628
YATTA,Urban,37,251,285,536,Machakos,EASTERN,4629
YATTA,Urban,38,242,261,503,Machakos,EASTERN,4630
YATTA,Urban,39,263,269,532,Machakos,EASTERN,4631
YATTA,Urban,40,328,365,693,Machakos,EASTERN,4632
YATTA,Urban,41,209,215,424,Machakos,EASTERN,4633
YATTA,Urban,42,174,183,357,Machakos,EASTERN,4634
YATTA,Urban,43,174,150,324,Machakos,EASTERN,4635
YATTA,Urban,44,150,174,324,Machakos,EASTERN,4636
YATTA,Urban,45,247,285,532,Machakos,EASTERN,4637
YATTA,Urban,46,225,246,471,Machakos,EASTERN,4638
YATTA,Urban,47,144,186,330,Machakos,EASTERN,4639
YATTA,Urban,48,152,162,314,Machakos,EASTERN,4640
YATTA,Urban,49,206,180,386,Machakos,EASTERN,4641
YATTA,Urban,50,209,240,449,Machakos,EASTERN,4642
YATTA,Urban,51,156,157,313,Machakos,EASTERN,4643
YATTA,Urban,52,169,167,336,Machakos,EASTERN,4644
YATTA,Urban,53,127,131,258,Machakos,EASTERN,4645
YATTA,Urban,54,97,102,199,Machakos,EASTERN,4646
YATTA,Urban,55,138,144,282,Machakos,EASTERN,4647
YATTA,Urban,56,101,106,207,Machakos,EASTERN,4648
YATTA,Urban,57,186,230,416,Machakos,EASTERN,4649
YATTA,Urban,58,75,71,146,Machakos,EASTERN,4650
YATTA,Urban,59,104,139,243,Machakos,EASTERN,4651
YATTA,Urban,60,133,154,287,Machakos,EASTERN,4652
YATTA,Urban,61,100,123,223,Machakos,EASTERN,4653
YATTA,Urban,62,56,53,109,Machakos,EASTERN,4654
YATTA,Urban,63,85,80,165,Machakos,EASTERN,4655
YATTA,Urban,64,65,86,151,Machakos,EASTERN,4656
YATTA,Urban,65,73,71,144,Machakos,EASTERN,4657
YATTA,Urban,66,35,44,79,Machakos,EASTERN,4658
YATTA,Urban,67,97,95,192,Machakos,EASTERN,4659
YATTA,Urban,68,36,49,85,Machakos,EASTERN,4660
YATTA,Urban,69,57,79,136,Machakos,EASTERN,4661
YATTA,Urban,70,78,116,194,Machakos,EASTERN,4662
YATTA,Urban,71,39,49,88,Machakos,EASTERN,4663
YATTA,Urban,72,47,40,87,Machakos,EASTERN,4664
YATTA,Urban,73,49,52,101,Machakos,EASTERN,4665
YATTA,Urban,74,35,43,78,Machakos,EASTERN,4666
YATTA,Urban,75,33,60,93,Machakos,EASTERN,4667
YATTA,Urban,76,27,18,45,Machakos,EASTERN,4668
YATTA,Urban,77,42,36,78,Machakos,EASTERN,4669
YATTA,Urban,78,17,27,44,Machakos,EASTERN,4670
YATTA,Urban,79,25,56,81,Machakos,EASTERN,4671
YATTA,Urban,80+,351,507,858,Machakos,EASTERN,4672
YATTA,Urban,Age NS,15,5,20,Machakos,EASTERN,4673
KANGUNDO,Urban,0,2921,2876,5797,Machakos,EASTERN,4674
KANGUNDO,Urban,1,2961,2814,5775,Machakos,EASTERN,4675
KANGUNDO,Urban,2,3010,2964,5974,Machakos,EASTERN,4676
KANGUNDO,Urban,3,3038,3038,6076,Machakos,EASTERN,4677
KANGUNDO,Urban,4,3138,2883,6021,Machakos,EASTERN,4678
KANGUNDO,Urban,5,3127,2922,6049,Machakos,EASTERN,4679
KANGUNDO,Urban,6,2971,2812,5783,Machakos,EASTERN,4680
KANGUNDO,Urban,7,2925,2778,5703,Machakos,EASTERN,4681
KANGUNDO,Urban,8,2738,2681,5419,Machakos,EASTERN,4682
KANGUNDO,Urban,9,2895,2996,5891,Machakos,EASTERN,4683
KANGUNDO,Urban,10,3017,2750,5767,Machakos,EASTERN,4684
KANGUNDO,Urban,11,2514,2451,4965,Machakos,EASTERN,4685
KANGUNDO,Urban,12,2773,2663,5436,Machakos,EASTERN,4686
KANGUNDO,Urban,13,2873,2931,5804,Machakos,EASTERN,4687
KANGUNDO,Urban,14,2728,2643,5371,Machakos,EASTERN,4688
KANGUNDO,Urban,15,2638,2401,5039,Machakos,EASTERN,4689
KANGUNDO,Urban,16,2360,2118,4478,Machakos,EASTERN,4690
KANGUNDO,Urban,17,2627,2325,4952,Machakos,EASTERN,4691
KANGUNDO,Urban,18,2365,2010,4375,Machakos,EASTERN,4692
KANGUNDO,Urban,19,2336,1862,4198,Machakos,EASTERN,4693
KANGUNDO,Urban,20,2336,1911,4247,Machakos,EASTERN,4694
KANGUNDO,Urban,21,1694,1676,3370,Machakos,EASTERN,4695
KANGUNDO,Urban,22,1855,1875,3730,Machakos,EASTERN,4696
KANGUNDO,Urban,23,1765,1906,3671,Machakos,EASTERN,4697
KANGUNDO,Urban,24,1500,1634,3134,Machakos,EASTERN,4698
KANGUNDO,Urban,25,1816,2013,3829,Machakos,EASTERN,4699
KANGUNDO,Urban,26,1414,1663,3077,Machakos,EASTERN,4700
KANGUNDO,Urban,27,1661,1810,3471,Machakos,EASTERN,4701
KANGUNDO,Urban,28,1352,1549,2901,Machakos,EASTERN,4702
KANGUNDO,Urban,29,1552,1730,3282,Machakos,EASTERN,4703
KANGUNDO,Urban,30,1821,2108,3929,Machakos,EASTERN,4704
KANGUNDO,Urban,31,1382,1372,2754,Machakos,EASTERN,4705
KANGUNDO,Urban,32,1284,1476,2760,Machakos,EASTERN,4706
KANGUNDO,Urban,33,1134,1287,2421,Machakos,EASTERN,4707
KANGUNDO,Urban,34,1214,1297,2511,Machakos,EASTERN,4708
KANGUNDO,Urban,35,1503,1619,3122,Machakos,EASTERN,4709
KANGUNDO,Urban,36,1097,1177,2274,Machakos,EASTERN,4710
KANGUNDO,Urban,37,1101,1111,2212,Machakos,EASTERN,4711
KANGUNDO,Urban,38,919,1006,1925,Machakos,EASTERN,4712
KANGUNDO,Urban,39,1056,1128,2184,Machakos,EASTERN,4713
KANGUNDO,Urban,40,1269,1413,2682,Machakos,EASTERN,4714
KANGUNDO,Urban,41,871,913,1784,Machakos,EASTERN,4715
KANGUNDO,Urban,42,766,778,1544,Machakos,EASTERN,4716
KANGUNDO,Urban,43,651,750,1401,Machakos,EASTERN,4717
KANGUNDO,Urban,44,701,797,1498,Machakos,EASTERN,4718
KANGUNDO,Urban,45,1051,1319,2370,Machakos,EASTERN,4719
KANGUNDO,Urban,46,963,1005,1968,Machakos,EASTERN,4720
KANGUNDO,Urban,47,757,905,1662,Machakos,EASTERN,4721
KANGUNDO,Urban,48,549,703,1252,Machakos,EASTERN,4722
KANGUNDO,Urban,49,813,926,1739,Machakos,EASTERN,4723
KANGUNDO,Urban,50,1041,1241,2282,Machakos,EASTERN,4724
KANGUNDO,Urban,51,794,771,1565,Machakos,EASTERN,4725
KANGUNDO,Urban,52,715,780,1495,Machakos,EASTERN,4726
KANGUNDO,Urban,53,617,723,1340,Machakos,EASTERN,4727
KANGUNDO,Urban,54,563,600,1163,Machakos,EASTERN,4728
KANGUNDO,Urban,55,714,758,1472,Machakos,EASTERN,4729
KANGUNDO,Urban,56,554,656,1210,Machakos,EASTERN,4730
KANGUNDO,Urban,57,836,884,1720,Machakos,EASTERN,4731
KANGUNDO,Urban,58,402,387,789,Machakos,EASTERN,4732
KANGUNDO,Urban,59,504,537,1041,Machakos,EASTERN,4733
KANGUNDO,Urban,60,677,770,1447,Machakos,EASTERN,4734
KANGUNDO,Urban,61,535,567,1102,Machakos,EASTERN,4735
KANGUNDO,Urban,62,358,380,738,Machakos,EASTERN,4736
KANGUNDO,Urban,63,391,381,772,Machakos,EASTERN,4737
KANGUNDO,Urban,64,397,379,776,Machakos,EASTERN,4738
KANGUNDO,Urban,65,321,426,747,Machakos,EASTERN,4739
KANGUNDO,Urban,66,217,262,479,Machakos,EASTERN,4740
KANGUNDO,Urban,67,401,516,917,Machakos,EASTERN,4741
KANGUNDO,Urban,68,201,248,449,Machakos,EASTERN,4742
KANGUNDO,Urban,69,254,401,655,Machakos,EASTERN,4743
KANGUNDO,Urban,70,455,587,1042,Machakos,EASTERN,4744
KANGUNDO,Urban,71,233,296,529,Machakos,EASTERN,4745
KANGUNDO,Urban,72,224,203,427,Machakos,EASTERN,4746
KANGUNDO,Urban,73,276,329,605,Machakos,EASTERN,4747
KANGUNDO,Urban,74,185,254,439,Machakos,EASTERN,4748
KANGUNDO,Urban,75,188,251,439,Machakos,EASTERN,4749
KANGUNDO,Urban,76,151,138,289,Machakos,EASTERN,4750
KANGUNDO,Urban,77,191,235,426,Machakos,EASTERN,4751
KANGUNDO,Urban,78,133,145,278,Machakos,EASTERN,4752
KANGUNDO,Urban,79,153,341,494,Machakos,EASTERN,4753
KANGUNDO,Urban,80+,1614,2524,4138,Machakos,EASTERN,4754
KANGUNDO,Urban,Age NS,135,126,261,Machakos,EASTERN,4755
MAKUENI,Urban,0,915,864,1779,Makueni,EASTERN,4756
MAKUENI,Urban,1,815,827,1642,Makueni,EASTERN,4757
MAKUENI,Urban,2,938,917,1855,Makueni,EASTERN,4758
MAKUENI,Urban,3,882,897,1779,Makueni,EASTERN,4759
MAKUENI,Urban,4,969,862,1831,Makueni,EASTERN,4760
MAKUENI,Urban,5,953,910,1863,Makueni,EASTERN,4761
MAKUENI,Urban,6,895,874,1769,Makueni,EASTERN,4762
MAKUENI,Urban,7,962,877,1839,Makueni,EASTERN,4763
MAKUENI,Urban,8,895,815,1710,Makueni,EASTERN,4764
MAKUENI,Urban,9,990,952,1942,Makueni,EASTERN,4765
MAKUENI,Urban,10,1013,1007,2020,Makueni,EASTERN,4766
MAKUENI,Urban,11,912,867,1779,Makueni,EASTERN,4767
MAKUENI,Urban,12,978,931,1909,Makueni,EASTERN,4768
MAKUENI,Urban,13,1093,1037,2130,Makueni,EASTERN,4769
MAKUENI,Urban,14,908,865,1773,Makueni,EASTERN,4770
MAKUENI,Urban,15,953,916,1869,Makueni,EASTERN,4771
MAKUENI,Urban,16,821,836,1657,Makueni,EASTERN,4772
MAKUENI,Urban,17,882,794,1676,Makueni,EASTERN,4773
MAKUENI,Urban,18,845,721,1566,Makueni,EASTERN,4774
MAKUENI,Urban,19,842,683,1525,Makueni,EASTERN,4775
MAKUENI,Urban,20,833,733,1566,Makueni,EASTERN,4776
MAKUENI,Urban,21,639,564,1203,Makueni,EASTERN,4777
MAKUENI,Urban,22,625,607,1232,Makueni,EASTERN,4778
MAKUENI,Urban,23,668,654,1322,Makueni,EASTERN,4779
MAKUENI,Urban,24,472,588,1060,Makueni,EASTERN,4780
MAKUENI,Urban,25,660,680,1340,Makueni,EASTERN,4781
MAKUENI,Urban,26,492,513,1005,Makueni,EASTERN,4782
MAKUENI,Urban,27,503,569,1072,Makueni,EASTERN,4783
MAKUENI,Urban,28,427,490,917,Makueni,EASTERN,4784
MAKUENI,Urban,29,498,495,993,Makueni,EASTERN,4785
MAKUENI,Urban,30,607,662,1269,Makueni,EASTERN,4786
MAKUENI,Urban,31,399,412,811,Makueni,EASTERN,4787
MAKUENI,Urban,32,378,465,843,Makueni,EASTERN,4788
MAKUENI,Urban,33,307,372,679,Makueni,EASTERN,4789
MAKUENI,Urban,34,333,380,713,Makueni,EASTERN,4790
MAKUENI,Urban,35,579,585,1164,Makueni,EASTERN,4791
MAKUENI,Urban,36,307,349,656,Makueni,EASTERN,4792
MAKUENI,Urban,37,347,353,700,Makueni,EASTERN,4793
MAKUENI,Urban,38,313,314,627,Makueni,EASTERN,4794
MAKUENI,Urban,39,353,344,697,Makueni,EASTERN,4795
MAKUENI,Urban,40,421,431,852,Makueni,EASTERN,4796
MAKUENI,Urban,41,274,251,525,Makueni,EASTERN,4797
MAKUENI,Urban,42,229,274,503,Makueni,EASTERN,4798
MAKUENI,Urban,43,212,212,424,Makueni,EASTERN,4799
MAKUENI,Urban,44,210,214,424,Makueni,EASTERN,4800
MAKUENI,Urban,45,343,385,728,Makueni,EASTERN,4801
MAKUENI,Urban,46,240,259,499,Makueni,EASTERN,4802
MAKUENI,Urban,47,256,301,557,Makueni,EASTERN,4803
MAKUENI,Urban,48,192,250,442,Makueni,EASTERN,4804
MAKUENI,Urban,49,261,274,535,Makueni,EASTERN,4805
MAKUENI,Urban,50,314,312,626,Makueni,EASTERN,4806
MAKUENI,Urban,51,222,196,418,Makueni,EASTERN,4807
MAKUENI,Urban,52,258,171,429,Makueni,EASTERN,4808
MAKUENI,Urban,53,209,187,396,Makueni,EASTERN,4809
MAKUENI,Urban,54,177,130,307,Makueni,EASTERN,4810
MAKUENI,Urban,55,229,186,415,Makueni,EASTERN,4811
MAKUENI,Urban,56,184,152,336,Makueni,EASTERN,4812
MAKUENI,Urban,57,180,209,389,Makueni,EASTERN,4813
MAKUENI,Urban,58,107,119,226,Makueni,EASTERN,4814
MAKUENI,Urban,59,138,146,284,Makueni,EASTERN,4815
MAKUENI,Urban,60,224,188,412,Makueni,EASTERN,4816
MAKUENI,Urban,61,144,126,270,Makueni,EASTERN,4817
MAKUENI,Urban,62,115,71,186,Makueni,EASTERN,4818
MAKUENI,Urban,63,80,84,164,Makueni,EASTERN,4819
MAKUENI,Urban,64,88,82,170,Makueni,EASTERN,4820
MAKUENI,Urban,65,110,89,199,Makueni,EASTERN,4821
MAKUENI,Urban,66,47,57,104,Makueni,EASTERN,4822
MAKUENI,Urban,67,79,98,177,Makueni,EASTERN,4823
MAKUENI,Urban,68,48,64,112,Makueni,EASTERN,4824
MAKUENI,Urban,69,58,69,127,Makueni,EASTERN,4825
MAKUENI,Urban,70,97,174,271,Makueni,EASTERN,4826
MAKUENI,Urban,71,57,71,128,Makueni,EASTERN,4827
MAKUENI,Urban,72,41,59,100,Makueni,EASTERN,4828
MAKUENI,Urban,73,58,67,125,Makueni,EASTERN,4829
MAKUENI,Urban,74,43,58,101,Makueni,EASTERN,4830
MAKUENI,Urban,75,47,75,122,Makueni,EASTERN,4831
MAKUENI,Urban,76,31,35,66,Makueni,EASTERN,4832
MAKUENI,Urban,77,38,56,94,Makueni,EASTERN,4833
MAKUENI,Urban,78,32,49,81,Makueni,EASTERN,4834
MAKUENI,Urban,79,40,78,118,Makueni,EASTERN,4835
MAKUENI,Urban,80+,529,792,1321,Makueni,EASTERN,4836
MAKUENI,Urban,Age NS,9,14,23,Makueni,EASTERN,4837
MBOONI,Urban,0,16,25,41,Makueni,EASTERN,4838
MBOONI,Urban,1,22,12,34,Makueni,EASTERN,4839
MBOONI,Urban,2,24,13,37,Makueni,EASTERN,4840
MBOONI,Urban,3,11,15,26,Makueni,EASTERN,4841
MBOONI,Urban,4,23,15,38,Makueni,EASTERN,4842
MBOONI,Urban,5,15,15,30,Makueni,EASTERN,4843
MBOONI,Urban,6,18,6,24,Makueni,EASTERN,4844
MBOONI,Urban,7,20,16,36,Makueni,EASTERN,4845
MBOONI,Urban,8,15,19,34,Makueni,EASTERN,4846
MBOONI,Urban,9,9,14,23,Makueni,EASTERN,4847
MBOONI,Urban,10,10,17,27,Makueni,EASTERN,4848
MBOONI,Urban,11,6,20,26,Makueni,EASTERN,4849
MBOONI,Urban,12,11,10,21,Makueni,EASTERN,4850
MBOONI,Urban,13,13,10,23,Makueni,EASTERN,4851
MBOONI,Urban,14,15,15,30,Makueni,EASTERN,4852
MBOONI,Urban,15,19,13,32,Makueni,EASTERN,4853
MBOONI,Urban,16,12,11,23,Makueni,EASTERN,4854
MBOONI,Urban,17,15,14,29,Makueni,EASTERN,4855
MBOONI,Urban,18,17,28,45,Makueni,EASTERN,4856
MBOONI,Urban,19,19,20,39,Makueni,EASTERN,4857
MBOONI,Urban,20,20,18,38,Makueni,EASTERN,4858
MBOONI,Urban,21,17,19,36,Makueni,EASTERN,4859
MBOONI,Urban,22,23,20,43,Makueni,EASTERN,4860
MBOONI,Urban,23,10,17,27,Makueni,EASTERN,4861
MBOONI,Urban,24,18,25,43,Makueni,EASTERN,4862
MBOONI,Urban,25,18,22,40,Makueni,EASTERN,4863
MBOONI,Urban,26,19,16,35,Makueni,EASTERN,4864
MBOONI,Urban,27,21,24,45,Makueni,EASTERN,4865
MBOONI,Urban,28,16,19,35,Makueni,EASTERN,4866
MBOONI,Urban,29,12,19,31,Makueni,EASTERN,4867
MBOONI,Urban,30,20,16,36,Makueni,EASTERN,4868
MBOONI,Urban,31,18,13,31,Makueni,EASTERN,4869
MBOONI,Urban,32,17,16,33,Makueni,EASTERN,4870
MBOONI,Urban,33,9,10,19,Makueni,EASTERN,4871
MBOONI,Urban,34,12,7,19,Makueni,EASTERN,4872
MBOONI,Urban,35,21,14,35,Makueni,EASTERN,4873
MBOONI,Urban,36,14,9,23,Makueni,EASTERN,4874
MBOONI,Urban,37,8,8,16,Makueni,EASTERN,4875
MBOONI,Urban,38,10,12,22,Makueni,EASTERN,4876
MBOONI,Urban,39,14,11,25,Makueni,EASTERN,4877
MBOONI,Urban,40,11,14,25,Makueni,EASTERN,4878
MBOONI,Urban,41,8,6,14,Makueni,EASTERN,4879
MBOONI,Urban,42,8,7,15,Makueni,EASTERN,4880
MBOONI,Urban,43,16,3,19,Makueni,EASTERN,4881
MBOONI,Urban,44,4,3,7,Makueni,EASTERN,4882
MBOONI,Urban,45,8,10,18,Makueni,EASTERN,4883
MBOONI,Urban,46,8,3,11,Makueni,EASTERN,4884
MBOONI,Urban,47,11,7,18,Makueni,EASTERN,4885
MBOONI,Urban,48,2,6,8,Makueni,EASTERN,4886
MBOONI,Urban,49,9,1,10,Makueni,EASTERN,4887
MBOONI,Urban,50,8,9,17,Makueni,EASTERN,4888
MBOONI,Urban,51,2,2,4,Makueni,EASTERN,4889
MBOONI,Urban,52,9,6,15,Makueni,EASTERN,4890
MBOONI,Urban,53,4,4,8,Makueni,EASTERN,4891
MBOONI,Urban,54,4,3,7,Makueni,EASTERN,4892
MBOONI,Urban,55,3,3,6,Makueni,EASTERN,4893
MBOONI,Urban,56,5,3,8,Makueni,EASTERN,4894
MBOONI,Urban,57,4,1,5,Makueni,EASTERN,4895
MBOONI,Urban,58,2,0,2,Makueni,EASTERN,4896
MBOONI,Urban,59,0,4,4,Makueni,EASTERN,4897
MBOONI,Urban,60,7,2,9,Makueni,EASTERN,4898
MBOONI,Urban,61,2,2,4,Makueni,EASTERN,4899
MBOONI,Urban,62,3,1,4,Makueni,EASTERN,4900
MBOONI,Urban,63,2,1,3,Makueni,EASTERN,4901
MBOONI,Urban,64,4,0,4,Makueni,EASTERN,4902
MBOONI,Urban,65,3,2,5,Makueni,EASTERN,4903
MBOONI,Urban,66,0,1,1,Makueni,EASTERN,4904
MBOONI,Urban,67,1,2,3,Makueni,EASTERN,4905
MBOONI,Urban,68,1,1,2,Makueni,EASTERN,4906
MBOONI,Urban,69,1,1,2,Makueni,EASTERN,4907
MBOONI,Urban,70,2,2,4,Makueni,EASTERN,4908
MBOONI,Urban,71,1,0,1,Makueni,EASTERN,4909
MBOONI,Urban,72,0,1,1,Makueni,EASTERN,4910
MBOONI,Urban,73,0,2,2,Makueni,EASTERN,4911
MBOONI,Urban,74,1,1,2,Makueni,EASTERN,4912
MBOONI,Urban,75,0,2,2,Makueni,EASTERN,4913
MBOONI,Urban,76,1,1,2,Makueni,EASTERN,4914
MBOONI,Urban,77,0,0,0,Makueni,EASTERN,4915
MBOONI,Urban,78,1,1,2,Makueni,EASTERN,4916
MBOONI,Urban,79,0,0,0,Makueni,EASTERN,4917
MBOONI,Urban,80+,8,11,19,Makueni,EASTERN,4918
MBOONI,Urban,Age NS,0,0,0,Makueni,EASTERN,4919
KIBWEZI,Urban,0,360,332,692,Makueni,EASTERN,4920
KIBWEZI,Urban,1,326,276,602,Makueni,EASTERN,4921
KIBWEZI,Urban,2,271,273,544,Makueni,EASTERN,4922
KIBWEZI,Urban,3,288,304,592,Makueni,EASTERN,4923
KIBWEZI,Urban,4,258,290,548,Makueni,EASTERN,4924
KIBWEZI,Urban,5,276,312,588,Makueni,EASTERN,4925
KIBWEZI,Urban,6,226,259,485,Makueni,EASTERN,4926
KIBWEZI,Urban,7,252,241,493,Makueni,EASTERN,4927
KIBWEZI,Urban,8,237,246,483,Makueni,EASTERN,4928
KIBWEZI,Urban,9,262,246,508,Makueni,EASTERN,4929
KIBWEZI,Urban,10,230,227,457,Makueni,EASTERN,4930
KIBWEZI,Urban,11,187,172,359,Makueni,EASTERN,4931
KIBWEZI,Urban,12,228,207,435,Makueni,EASTERN,4932
KIBWEZI,Urban,13,199,243,442,Makueni,EASTERN,4933
KIBWEZI,Urban,14,171,179,350,Makueni,EASTERN,4934
KIBWEZI,Urban,15,202,189,391,Makueni,EASTERN,4935
KIBWEZI,Urban,16,173,188,361,Makueni,EASTERN,4936
KIBWEZI,Urban,17,190,220,410,Makueni,EASTERN,4937
KIBWEZI,Urban,18,218,247,465,Makueni,EASTERN,4938
KIBWEZI,Urban,19,220,298,518,Makueni,EASTERN,4939
KIBWEZI,Urban,20,226,393,619,Makueni,EASTERN,4940
KIBWEZI,Urban,21,225,307,532,Makueni,EASTERN,4941
KIBWEZI,Urban,22,255,399,654,Makueni,EASTERN,4942
KIBWEZI,Urban,23,267,383,650,Makueni,EASTERN,4943
KIBWEZI,Urban,24,221,345,566,Makueni,EASTERN,4944
KIBWEZI,Urban,25,277,369,646,Makueni,EASTERN,4945
KIBWEZI,Urban,26,235,309,544,Makueni,EASTERN,4946
KIBWEZI,Urban,27,262,307,569,Makueni,EASTERN,4947
KIBWEZI,Urban,28,258,292,550,Makueni,EASTERN,4948
KIBWEZI,Urban,29,243,258,501,Makueni,EASTERN,4949
KIBWEZI,Urban,30,353,333,686,Makueni,EASTERN,4950
KIBWEZI,Urban,31,209,146,355,Makueni,EASTERN,4951
KIBWEZI,Urban,32,223,207,430,Makueni,EASTERN,4952
KIBWEZI,Urban,33,167,120,287,Makueni,EASTERN,4953
KIBWEZI,Urban,34,142,167,309,Makueni,EASTERN,4954
KIBWEZI,Urban,35,258,218,476,Makueni,EASTERN,4955
KIBWEZI,Urban,36,177,128,305,Makueni,EASTERN,4956
KIBWEZI,Urban,37,160,114,274,Makueni,EASTERN,4957
KIBWEZI,Urban,38,155,139,294,Makueni,EASTERN,4958
KIBWEZI,Urban,39,164,125,289,Makueni,EASTERN,4959
KIBWEZI,Urban,40,204,155,359,Makueni,EASTERN,4960
KIBWEZI,Urban,41,107,80,187,Makueni,EASTERN,4961
KIBWEZI,Urban,42,110,88,198,Makueni,EASTERN,4962
KIBWEZI,Urban,43,81,74,155,Makueni,EASTERN,4963
KIBWEZI,Urban,44,76,66,142,Makueni,EASTERN,4964
KIBWEZI,Urban,45,138,84,222,Makueni,EASTERN,4965
KIBWEZI,Urban,46,111,79,190,Makueni,EASTERN,4966
KIBWEZI,Urban,47,77,65,142,Makueni,EASTERN,4967
KIBWEZI,Urban,48,76,66,142,Makueni,EASTERN,4968
KIBWEZI,Urban,49,86,53,139,Makueni,EASTERN,4969
KIBWEZI,Urban,50,108,80,188,Makueni,EASTERN,4970
KIBWEZI,Urban,51,55,48,103,Makueni,EASTERN,4971
KIBWEZI,Urban,52,50,46,96,Makueni,EASTERN,4972
KIBWEZI,Urban,53,59,34,93,Makueni,EASTERN,4973
KIBWEZI,Urban,54,46,36,82,Makueni,EASTERN,4974
KIBWEZI,Urban,55,66,47,113,Makueni,EASTERN,4975
KIBWEZI,Urban,56,45,27,72,Makueni,EASTERN,4976
KIBWEZI,Urban,57,42,45,87,Makueni,EASTERN,4977
KIBWEZI,Urban,58,22,18,40,Makueni,EASTERN,4978
KIBWEZI,Urban,59,31,26,57,Makueni,EASTERN,4979
KIBWEZI,Urban,60,60,26,86,Makueni,EASTERN,4980
KIBWEZI,Urban,61,23,17,40,Makueni,EASTERN,4981
KIBWEZI,Urban,62,27,13,40,Makueni,EASTERN,4982
KIBWEZI,Urban,63,25,12,37,Makueni,EASTERN,4983
KIBWEZI,Urban,64,21,23,44,Makueni,EASTERN,4984
KIBWEZI,Urban,65,21,28,49,Makueni,EASTERN,4985
KIBWEZI,Urban,66,6,4,10,Makueni,EASTERN,4986
KIBWEZI,Urban,67,22,13,35,Makueni,EASTERN,4987
KIBWEZI,Urban,68,9,12,21,Makueni,EASTERN,4988
KIBWEZI,Urban,69,13,12,25,Makueni,EASTERN,4989
KIBWEZI,Urban,70,28,33,61,Makueni,EASTERN,4990
KIBWEZI,Urban,71,11,6,17,Makueni,EASTERN,4991
KIBWEZI,Urban,72,15,8,23,Makueni,EASTERN,4992
KIBWEZI,Urban,73,6,6,12,Makueni,EASTERN,4993
KIBWEZI,Urban,74,9,5,14,Makueni,EASTERN,4994
KIBWEZI,Urban,75,7,12,19,Makueni,EASTERN,4995
KIBWEZI,Urban,76,5,12,17,Makueni,EASTERN,4996
KIBWEZI,Urban,77,10,3,13,Makueni,EASTERN,4997
KIBWEZI,Urban,78,6,8,14,Makueni,EASTERN,4998
KIBWEZI,Urban,79,4,13,17,Makueni,EASTERN,4999
KIBWEZI,Urban,80+,70,98,168,Makueni,EASTERN,5000
KIBWEZI,Urban,Age NS,17,8,25,Makueni,EASTERN,5001
NZAUI,Urban,0,132,153,285,Makueni,EASTERN,5002
NZAUI,Urban,1,116,148,264,Makueni,EASTERN,5003
NZAUI,Urban,2,120,133,253,Makueni,EASTERN,5004
NZAUI,Urban,3,139,118,257,Makueni,EASTERN,5005
NZAUI,Urban,4,143,115,258,Makueni,EASTERN,5006
NZAUI,Urban,5,118,119,237,Makueni,EASTERN,5007
NZAUI,Urban,6,92,91,183,Makueni,EASTERN,5008
NZAUI,Urban,7,114,105,219,Makueni,EASTERN,5009
NZAUI,Urban,8,82,90,172,Makueni,EASTERN,5010
NZAUI,Urban,9,107,89,196,Makueni,EASTERN,5011
NZAUI,Urban,10,93,81,174,Makueni,EASTERN,5012
NZAUI,Urban,11,74,66,140,Makueni,EASTERN,5013
NZAUI,Urban,12,78,84,162,Makueni,EASTERN,5014
NZAUI,Urban,13,76,83,159,Makueni,EASTERN,5015
NZAUI,Urban,14,73,72,145,Makueni,EASTERN,5016
NZAUI,Urban,15,74,72,146,Makueni,EASTERN,5017
NZAUI,Urban,16,60,68,128,Makueni,EASTERN,5018
NZAUI,Urban,17,77,84,161,Makueni,EASTERN,5019
NZAUI,Urban,18,122,104,226,Makueni,EASTERN,5020
NZAUI,Urban,19,104,129,233,Makueni,EASTERN,5021
NZAUI,Urban,20,153,175,328,Makueni,EASTERN,5022
NZAUI,Urban,21,132,119,251,Makueni,EASTERN,5023
NZAUI,Urban,22,163,183,346,Makueni,EASTERN,5024
NZAUI,Urban,23,165,201,366,Makueni,EASTERN,5025
NZAUI,Urban,24,175,173,348,Makueni,EASTERN,5026
NZAUI,Urban,25,190,187,377,Makueni,EASTERN,5027
NZAUI,Urban,26,137,126,263,Makueni,EASTERN,5028
NZAUI,Urban,27,160,141,301,Makueni,EASTERN,5029
NZAUI,Urban,28,146,132,278,Makueni,EASTERN,5030
NZAUI,Urban,29,122,109,231,Makueni,EASTERN,5031
NZAUI,Urban,30,227,170,397,Makueni,EASTERN,5032
NZAUI,Urban,31,82,61,143,Makueni,EASTERN,5033
NZAUI,Urban,32,162,91,253,Makueni,EASTERN,5034
NZAUI,Urban,33,80,70,150,Makueni,EASTERN,5035
NZAUI,Urban,34,110,57,167,Makueni,EASTERN,5036
NZAUI,Urban,35,143,123,266,Makueni,EASTERN,5037
NZAUI,Urban,36,82,51,133,Makueni,EASTERN,5038
NZAUI,Urban,37,60,54,114,Makueni,EASTERN,5039
NZAUI,Urban,38,75,63,138,Makueni,EASTERN,5040
NZAUI,Urban,39,67,42,109,Makueni,EASTERN,5041
NZAUI,Urban,40,87,68,155,Makueni,EASTERN,5042
NZAUI,Urban,41,38,21,59,Makueni,EASTERN,5043
NZAUI,Urban,42,53,29,82,Makueni,EASTERN,5044
NZAUI,Urban,43,33,27,60,Makueni,EASTERN,5045
NZAUI,Urban,44,30,18,48,Makueni,EASTERN,5046
NZAUI,Urban,45,76,36,112,Makueni,EASTERN,5047
NZAUI,Urban,46,26,21,47,Makueni,EASTERN,5048
NZAUI,Urban,47,38,21,59,Makueni,EASTERN,5049
NZAUI,Urban,48,48,34,82,Makueni,EASTERN,5050
NZAUI,Urban,49,43,19,62,Makueni,EASTERN,5051
NZAUI,Urban,50,45,27,72,Makueni,EASTERN,5052
NZAUI,Urban,51,14,13,27,Makueni,EASTERN,5053
NZAUI,Urban,52,38,9,47,Makueni,EASTERN,5054
NZAUI,Urban,53,24,8,32,Makueni,EASTERN,5055
NZAUI,Urban,54,19,13,32,Makueni,EASTERN,5056
NZAUI,Urban,55,26,19,45,Makueni,EASTERN,5057
NZAUI,Urban,56,17,18,35,Makueni,EASTERN,5058
NZAUI,Urban,57,21,15,36,Makueni,EASTERN,5059
NZAUI,Urban,58,5,8,13,Makueni,EASTERN,5060
NZAUI,Urban,59,18,10,28,Makueni,EASTERN,5061
NZAUI,Urban,60,17,22,39,Makueni,EASTERN,5062
NZAUI,Urban,61,12,5,17,Makueni,EASTERN,5063
NZAUI,Urban,62,8,3,11,Makueni,EASTERN,5064
NZAUI,Urban,63,7,6,13,Makueni,EASTERN,5065
NZAUI,Urban,64,7,4,11,Makueni,EASTERN,5066
NZAUI,Urban,65,11,10,21,Makueni,EASTERN,5067
NZAUI,Urban,66,4,1,5,Makueni,EASTERN,5068
NZAUI,Urban,67,5,3,8,Makueni,EASTERN,5069
NZAUI,Urban,68,1,2,3,Makueni,EASTERN,5070
NZAUI,Urban,69,4,4,8,Makueni,EASTERN,5071
NZAUI,Urban,70,5,5,10,Makueni,EASTERN,5072
NZAUI,Urban,71,3,5,8,Makueni,EASTERN,5073
NZAUI,Urban,72,5,2,7,Makueni,EASTERN,5074
NZAUI,Urban,73,1,1,2,Makueni,EASTERN,5075
NZAUI,Urban,74,6,0,6,Makueni,EASTERN,5076
NZAUI,Urban,75,2,4,6,Makueni,EASTERN,5077
NZAUI,Urban,76,0,2,2,Makueni,EASTERN,5078
NZAUI,Urban,77,1,2,3,Makueni,EASTERN,5079
NZAUI,Urban,78,1,1,2,Makueni,EASTERN,5080
NZAUI,Urban,79,3,0,3,Makueni,EASTERN,5081
NZAUI,Urban,80+,19,35,54,Makueni,EASTERN,5082
NZAUI,Urban,Age NS,3,1,4,Makueni,EASTERN,5083
GARISSA,Urban,0,1836,1717,3553,Garissa,NORTH EASTERN,5084
GARISSA,Urban,1,1444,1267,2711,Garissa,NORTH EASTERN,5085
GARISSA,Urban,2,2060,1769,3829,Garissa,NORTH EASTERN,5086
GARISSA,Urban,3,1815,1733,3548,Garissa,NORTH EASTERN,5087
GARISSA,Urban,4,1954,1757,3711,Garissa,NORTH EASTERN,5088
GARISSA,Urban,5,1816,1717,3533,Garissa,NORTH EASTERN,5089
GARISSA,Urban,6,1905,1747,3652,Garissa,NORTH EASTERN,5090
GARISSA,Urban,7,1758,1663,3421,Garissa,NORTH EASTERN,5091
GARISSA,Urban,8,1978,1833,3811,Garissa,NORTH EASTERN,5092
GARISSA,Urban,9,1421,1406,2827,Garissa,NORTH EASTERN,5093
GARISSA,Urban,10,2116,1877,3993,Garissa,NORTH EASTERN,5094
GARISSA,Urban,11,1232,1182,2414,Garissa,NORTH EASTERN,5095
GARISSA,Urban,12,1978,1566,3544,Garissa,NORTH EASTERN,5096
GARISSA,Urban,13,1737,1367,3104,Garissa,NORTH EASTERN,5097
GARISSA,Urban,14,1713,1457,3170,Garissa,NORTH EASTERN,5098
GARISSA,Urban,15,1754,1546,3300,Garissa,NORTH EASTERN,5099
GARISSA,Urban,16,1593,1376,2969,Garissa,NORTH EASTERN,5100
GARISSA,Urban,17,1360,1203,2563,Garissa,NORTH EASTERN,5101
GARISSA,Urban,18,2114,2009,4123,Garissa,NORTH EASTERN,5102
GARISSA,Urban,19,1113,1117,2230,Garissa,NORTH EASTERN,5103
GARISSA,Urban,20,2279,2537,4816,Garissa,NORTH EASTERN,5104
GARISSA,Urban,21,796,764,1560,Garissa,NORTH EASTERN,5105
GARISSA,Urban,22,1174,1294,2468,Garissa,NORTH EASTERN,5106
GARISSA,Urban,23,898,930,1828,Garissa,NORTH EASTERN,5107
GARISSA,Urban,24,904,843,1747,Garissa,NORTH EASTERN,5108
GARISSA,Urban,25,1718,1950,3668,Garissa,NORTH EASTERN,5109
GARISSA,Urban,26,727,766,1493,Garissa,NORTH EASTERN,5110
GARISSA,Urban,27,705,783,1488,Garissa,NORTH EASTERN,5111
GARISSA,Urban,28,962,1080,2042,Garissa,NORTH EASTERN,5112
GARISSA,Urban,29,516,493,1009,Garissa,NORTH EASTERN,5113
GARISSA,Urban,30,1809,2058,3867,Garissa,NORTH EASTERN,5114
GARISSA,Urban,31,307,256,563,Garissa,NORTH EASTERN,5115
GARISSA,Urban,32,673,602,1275,Garissa,NORTH EASTERN,5116
GARISSA,Urban,33,337,311,648,Garissa,NORTH EASTERN,5117
GARISSA,Urban,34,365,277,642,Garissa,NORTH EASTERN,5118
GARISSA,Urban,35,1173,1168,2341,Garissa,NORTH EASTERN,5119
GARISSA,Urban,36,362,356,718,Garissa,NORTH EASTERN,5120
GARISSA,Urban,37,287,322,609,Garissa,NORTH EASTERN,5121
GARISSA,Urban,38,504,495,999,Garissa,NORTH EASTERN,5122
GARISSA,Urban,39,223,198,421,Garissa,NORTH EASTERN,5123
GARISSA,Urban,40,1538,1392,2930,Garissa,NORTH EASTERN,5124
GARISSA,Urban,41,173,127,300,Garissa,NORTH EASTERN,5125
GARISSA,Urban,42,373,237,610,Garissa,NORTH EASTERN,5126
GARISSA,Urban,43,187,138,325,Garissa,NORTH EASTERN,5127
GARISSA,Urban,44,157,109,266,Garissa,NORTH EASTERN,5128
GARISSA,Urban,45,717,550,1267,Garissa,NORTH EASTERN,5129
GARISSA,Urban,46,254,136,390,Garissa,NORTH EASTERN,5130
GARISSA,Urban,47,210,140,350,Garissa,NORTH EASTERN,5131
GARISSA,Urban,48,324,220,544,Garissa,NORTH EASTERN,5132
GARISSA,Urban,49,175,95,270,Garissa,NORTH EASTERN,5133
GARISSA,Urban,50,1012,885,1897,Garissa,NORTH EASTERN,5134
GARISSA,Urban,51,119,55,174,Garissa,NORTH EASTERN,5135
GARISSA,Urban,52,207,134,341,Garissa,NORTH EASTERN,5136
GARISSA,Urban,53,137,82,219,Garissa,NORTH EASTERN,5137
GARISSA,Urban,54,166,78,244,Garissa,NORTH EASTERN,5138
GARISSA,Urban,55,317,265,582,Garissa,NORTH EASTERN,5139
GARISSA,Urban,56,143,114,257,Garissa,NORTH EASTERN,5140
GARISSA,Urban,57,103,73,176,Garissa,NORTH EASTERN,5141
GARISSA,Urban,58,114,85,199,Garissa,NORTH EASTERN,5142
GARISSA,Urban,59,59,43,102,Garissa,NORTH EASTERN,5143
GARISSA,Urban,60,622,664,1286,Garissa,NORTH EASTERN,5144
GARISSA,Urban,61,45,36,81,Garissa,NORTH EASTERN,5145
GARISSA,Urban,62,77,52,129,Garissa,NORTH EASTERN,5146
GARISSA,Urban,63,73,48,121,Garissa,NORTH EASTERN,5147
GARISSA,Urban,64,76,49,125,Garissa,NORTH EASTERN,5148
GARISSA,Urban,65,169,173,342,Garissa,NORTH EASTERN,5149
GARISSA,Urban,66,42,34,76,Garissa,NORTH EASTERN,5150
GARISSA,Urban,67,75,52,127,Garissa,NORTH EASTERN,5151
GARISSA,Urban,68,55,55,110,Garissa,NORTH EASTERN,5152
GARISSA,Urban,69,37,22,59,Garissa,NORTH EASTERN,5153
GARISSA,Urban,70,332,464,796,Garissa,NORTH EASTERN,5154
GARISSA,Urban,71,24,19,43,Garissa,NORTH EASTERN,5155
GARISSA,Urban,72,56,44,100,Garissa,NORTH EASTERN,5156
GARISSA,Urban,73,53,29,82,Garissa,NORTH EASTERN,5157
GARISSA,Urban,74,56,26,82,Garissa,NORTH EASTERN,5158
GARISSA,Urban,75,82,101,183,Garissa,NORTH EASTERN,5159
GARISSA,Urban,76,35,25,60,Garissa,NORTH EASTERN,5160
GARISSA,Urban,77,34,32,66,Garissa,NORTH EASTERN,5161
GARISSA,Urban,78,42,36,78,Garissa,NORTH EASTERN,5162
GARISSA,Urban,79,20,27,47,Garissa,NORTH EASTERN,5163
GARISSA,Urban,80+,524,711,1235,Garissa,NORTH EASTERN,5164
GARISSA,Urban,Age NS,39,35,74,Garissa,NORTH EASTERN,5165
LAGDERA,Urban,0,131,118,249,Garissa,NORTH EASTERN,5166
LAGDERA,Urban,1,92,101,193,Garissa,NORTH EASTERN,5167
LAGDERA,Urban,2,196,145,341,Garissa,NORTH EASTERN,5168
LAGDERA,Urban,3,149,168,317,Garissa,NORTH EASTERN,5169
LAGDERA,Urban,4,187,180,367,Garissa,NORTH EASTERN,5170
LAGDERA,Urban,5,174,188,362,Garissa,NORTH EASTERN,5171
LAGDERA,Urban,6,225,221,446,Garissa,NORTH EASTERN,5172
LAGDERA,Urban,7,171,170,341,Garissa,NORTH EASTERN,5173
LAGDERA,Urban,8,267,225,492,Garissa,NORTH EASTERN,5174
LAGDERA,Urban,9,177,150,327,Garissa,NORTH EASTERN,5175
LAGDERA,Urban,10,292,253,545,Garissa,NORTH EASTERN,5176
LAGDERA,Urban,11,146,129,275,Garissa,NORTH EASTERN,5177
LAGDERA,Urban,12,243,176,419,Garissa,NORTH EASTERN,5178
LAGDERA,Urban,13,178,122,300,Garissa,NORTH EASTERN,5179
LAGDERA,Urban,14,201,157,358,Garissa,NORTH EASTERN,5180
LAGDERA,Urban,15,190,158,348,Garissa,NORTH EASTERN,5181
LAGDERA,Urban,16,193,154,347,Garissa,NORTH EASTERN,5182
LAGDERA,Urban,17,121,98,219,Garissa,NORTH EASTERN,5183
LAGDERA,Urban,18,254,223,477,Garissa,NORTH EASTERN,5184
LAGDERA,Urban,19,88,110,198,Garissa,NORTH EASTERN,5185
LAGDERA,Urban,20,266,243,509,Garissa,NORTH EASTERN,5186
LAGDERA,Urban,21,68,60,128,Garissa,NORTH EASTERN,5187
LAGDERA,Urban,22,111,115,226,Garissa,NORTH EASTERN,5188
LAGDERA,Urban,23,108,92,200,Garissa,NORTH EASTERN,5189
LAGDERA,Urban,24,92,63,155,Garissa,NORTH EASTERN,5190
LAGDERA,Urban,25,188,213,401,Garissa,NORTH EASTERN,5191
LAGDERA,Urban,26,62,77,139,Garissa,NORTH EASTERN,5192
LAGDERA,Urban,27,59,74,133,Garissa,NORTH EASTERN,5193
LAGDERA,Urban,28,107,106,213,Garissa,NORTH EASTERN,5194
LAGDERA,Urban,29,55,41,96,Garissa,NORTH EASTERN,5195
LAGDERA,Urban,30,210,223,433,Garissa,NORTH EASTERN,5196
LAGDERA,Urban,31,36,18,54,Garissa,NORTH EASTERN,5197
LAGDERA,Urban,32,53,44,97,Garissa,NORTH EASTERN,5198
LAGDERA,Urban,33,51,40,91,Garissa,NORTH EASTERN,5199
LAGDERA,Urban,34,26,26,52,Garissa,NORTH EASTERN,5200
LAGDERA,Urban,35,123,143,266,Garissa,NORTH EASTERN,5201
LAGDERA,Urban,36,31,44,75,Garissa,NORTH EASTERN,5202
LAGDERA,Urban,37,25,30,55,Garissa,NORTH EASTERN,5203
LAGDERA,Urban,38,60,62,122,Garissa,NORTH EASTERN,5204
LAGDERA,Urban,39,34,22,56,Garissa,NORTH EASTERN,5205
LAGDERA,Urban,40,201,190,391,Garissa,NORTH EASTERN,5206
LAGDERA,Urban,41,17,10,27,Garissa,NORTH EASTERN,5207
LAGDERA,Urban,42,33,33,66,Garissa,NORTH EASTERN,5208
FAFI,Urban,9,14,16,30,Garissa,NORTH EASTERN,5209
LAGDERA,Urban,43,21,22,43,Garissa,NORTH EASTERN,5210
LAGDERA,Urban,44,15,6,21,Garissa,NORTH EASTERN,5211
LAGDERA,Urban,45,92,74,166,Garissa,NORTH EASTERN,5212
LAGDERA,Urban,46,21,11,32,Garissa,NORTH EASTERN,5213
LAGDERA,Urban,47,25,9,34,Garissa,NORTH EASTERN,5214
LAGDERA,Urban,48,30,27,57,Garissa,NORTH EASTERN,5215
LAGDERA,Urban,49,15,7,22,Garissa,NORTH EASTERN,5216
LAGDERA,Urban,50,153,89,242,Garissa,NORTH EASTERN,5217
LAGDERA,Urban,51,9,7,16,Garissa,NORTH EASTERN,5218
LAGDERA,Urban,52,30,11,41,Garissa,NORTH EASTERN,5219
LAGDERA,Urban,53,12,6,18,Garissa,NORTH EASTERN,5220
LAGDERA,Urban,54,11,4,15,Garissa,NORTH EASTERN,5221
LAGDERA,Urban,55,55,29,84,Garissa,NORTH EASTERN,5222
LAGDERA,Urban,56,27,7,34,Garissa,NORTH EASTERN,5223
LAGDERA,Urban,57,11,5,16,Garissa,NORTH EASTERN,5224
LAGDERA,Urban,58,14,13,27,Garissa,NORTH EASTERN,5225
LAGDERA,Urban,59,9,5,14,Garissa,NORTH EASTERN,5226
LAGDERA,Urban,60,97,56,153,Garissa,NORTH EASTERN,5227
LAGDERA,Urban,61,7,2,9,Garissa,NORTH EASTERN,5228
LAGDERA,Urban,62,12,2,14,Garissa,NORTH EASTERN,5229
LAGDERA,Urban,63,8,7,15,Garissa,NORTH EASTERN,5230
LAGDERA,Urban,64,8,1,9,Garissa,NORTH EASTERN,5231
LAGDERA,Urban,65,17,13,30,Garissa,NORTH EASTERN,5232
LAGDERA,Urban,66,5,0,5,Garissa,NORTH EASTERN,5233
LAGDERA,Urban,67,5,4,9,Garissa,NORTH EASTERN,5234
LAGDERA,Urban,68,9,6,15,Garissa,NORTH EASTERN,5235
LAGDERA,Urban,69,5,1,6,Garissa,NORTH EASTERN,5236
LAGDERA,Urban,70,40,37,77,Garissa,NORTH EASTERN,5237
LAGDERA,Urban,71,5,1,6,Garissa,NORTH EASTERN,5238
LAGDERA,Urban,72,2,7,9,Garissa,NORTH EASTERN,5239
LAGDERA,Urban,73,9,2,11,Garissa,NORTH EASTERN,5240
LAGDERA,Urban,74,2,2,4,Garissa,NORTH EASTERN,5241
LAGDERA,Urban,75,10,4,14,Garissa,NORTH EASTERN,5242
LAGDERA,Urban,76,4,0,4,Garissa,NORTH EASTERN,5243
LAGDERA,Urban,77,3,3,6,Garissa,NORTH EASTERN,5244
LAGDERA,Urban,78,4,3,7,Garissa,NORTH EASTERN,5245
LAGDERA,Urban,79,3,3,6,Garissa,NORTH EASTERN,5246
LAGDERA,Urban,80+,55,52,107,Garissa,NORTH EASTERN,5247
LAGDERA,Urban,Age NS,1,1,2,Garissa,NORTH EASTERN,5248
FAFI,Urban,0,30,27,57,Garissa,NORTH EASTERN,5249
FAFI,Urban,1,7,15,22,Garissa,NORTH EASTERN,5250
FAFI,Urban,2,35,31,66,Garissa,NORTH EASTERN,5251
FAFI,Urban,3,31,19,50,Garissa,NORTH EASTERN,5252
FAFI,Urban,4,28,32,60,Garissa,NORTH EASTERN,5253
FAFI,Urban,5,25,28,53,Garissa,NORTH EASTERN,5254
FAFI,Urban,6,28,30,58,Garissa,NORTH EASTERN,5255
FAFI,Urban,7,8,17,25,Garissa,NORTH EASTERN,5256
FAFI,Urban,8,24,24,48,Garissa,NORTH EASTERN,5257
FAFI,Urban,10,32,21,53,Garissa,NORTH EASTERN,5258
FAFI,Urban,11,9,13,22,Garissa,NORTH EASTERN,5259
FAFI,Urban,12,25,25,50,Garissa,NORTH EASTERN,5260
FAFI,Urban,13,17,8,25,Garissa,NORTH EASTERN,5261
FAFI,Urban,14,17,10,27,Garissa,NORTH EASTERN,5262
FAFI,Urban,15,18,9,27,Garissa,NORTH EASTERN,5263
FAFI,Urban,16,22,9,31,Garissa,NORTH EASTERN,5264
FAFI,Urban,17,16,14,30,Garissa,NORTH EASTERN,5265
FAFI,Urban,18,12,28,40,Garissa,NORTH EASTERN,5266
FAFI,Urban,19,5,8,13,Garissa,NORTH EASTERN,5267
FAFI,Urban,20,22,33,55,Garissa,NORTH EASTERN,5268
FAFI,Urban,21,15,7,22,Garissa,NORTH EASTERN,5269
FAFI,Urban,22,16,14,30,Garissa,NORTH EASTERN,5270
FAFI,Urban,23,13,15,28,Garissa,NORTH EASTERN,5271
FAFI,Urban,24,10,6,16,Garissa,NORTH EASTERN,5272
FAFI,Urban,25,22,25,47,Garissa,NORTH EASTERN,5273
FAFI,Urban,26,8,4,12,Garissa,NORTH EASTERN,5274
FAFI,Urban,27,10,11,21,Garissa,NORTH EASTERN,5275
FAFI,Urban,28,12,9,21,Garissa,NORTH EASTERN,5276
FAFI,Urban,29,9,7,16,Garissa,NORTH EASTERN,5277
FAFI,Urban,30,22,31,53,Garissa,NORTH EASTERN,5278
FAFI,Urban,31,11,2,13,Garissa,NORTH EASTERN,5279
FAFI,Urban,32,6,4,10,Garissa,NORTH EASTERN,5280
FAFI,Urban,33,13,2,15,Garissa,NORTH EASTERN,5281
FAFI,Urban,34,4,0,4,Garissa,NORTH EASTERN,5282
FAFI,Urban,35,29,9,38,Garissa,NORTH EASTERN,5283
FAFI,Urban,36,7,3,10,Garissa,NORTH EASTERN,5284
FAFI,Urban,37,5,0,5,Garissa,NORTH EASTERN,5285
FAFI,Urban,38,5,6,11,Garissa,NORTH EASTERN,5286
FAFI,Urban,39,3,1,4,Garissa,NORTH EASTERN,5287
FAFI,Urban,40,13,28,41,Garissa,NORTH EASTERN,5288
FAFI,Urban,41,3,1,4,Garissa,NORTH EASTERN,5289
FAFI,Urban,42,6,6,12,Garissa,NORTH EASTERN,5290
FAFI,Urban,43,2,1,3,Garissa,NORTH EASTERN,5291
FAFI,Urban,44,2,0,2,Garissa,NORTH EASTERN,5292
FAFI,Urban,45,11,10,21,Garissa,NORTH EASTERN,5293
FAFI,Urban,46,4,2,6,Garissa,NORTH EASTERN,5294
FAFI,Urban,47,8,1,9,Garissa,NORTH EASTERN,5295
FAFI,Urban,48,5,5,10,Garissa,NORTH EASTERN,5296
FAFI,Urban,49,3,1,4,Garissa,NORTH EASTERN,5297
FAFI,Urban,50,14,11,25,Garissa,NORTH EASTERN,5298
FAFI,Urban,51,2,2,4,Garissa,NORTH EASTERN,5299
FAFI,Urban,52,6,1,7,Garissa,NORTH EASTERN,5300
FAFI,Urban,53,3,1,4,Garissa,NORTH EASTERN,5301
FAFI,Urban,54,5,3,8,Garissa,NORTH EASTERN,5302
FAFI,Urban,55,3,4,7,Garissa,NORTH EASTERN,5303
FAFI,Urban,56,0,1,1,Garissa,NORTH EASTERN,5304
FAFI,Urban,57,2,2,4,Garissa,NORTH EASTERN,5305
FAFI,Urban,58,2,0,2,Garissa,NORTH EASTERN,5306
FAFI,Urban,59,1,1,2,Garissa,NORTH EASTERN,5307
FAFI,Urban,60,7,20,27,Garissa,NORTH EASTERN,5308
FAFI,Urban,61,1,1,2,Garissa,NORTH EASTERN,5309
FAFI,Urban,62,1,0,1,Garissa,NORTH EASTERN,5310
FAFI,Urban,63,0,2,2,Garissa,NORTH EASTERN,5311
FAFI,Urban,64,0,0,0,Garissa,NORTH EASTERN,5312
FAFI,Urban,65,5,3,8,Garissa,NORTH EASTERN,5313
FAFI,Urban,66,0,0,0,Garissa,NORTH EASTERN,5314
FAFI,Urban,67,1,0,1,Garissa,NORTH EASTERN,5315
FAFI,Urban,68,2,0,2,Garissa,NORTH EASTERN,5316
FAFI,Urban,69,0,0,0,Garissa,NORTH EASTERN,5317
FAFI,Urban,70,10,6,16,Garissa,NORTH EASTERN,5318
FAFI,Urban,71,1,3,4,Garissa,NORTH EASTERN,5319
FAFI,Urban,72,0,0,0,Garissa,NORTH EASTERN,5320
FAFI,Urban,73,0,0,0,Garissa,NORTH EASTERN,5321
FAFI,Urban,74,0,0,0,Garissa,NORTH EASTERN,5322
FAFI,Urban,75,0,2,2,Garissa,NORTH EASTERN,5323
FAFI,Urban,76,1,1,2,Garissa,NORTH EASTERN,5324
FAFI,Urban,77,3,0,3,Garissa,NORTH EASTERN,5325
FAFI,Urban,78,0,0,0,Garissa,NORTH EASTERN,5326
FAFI,Urban,79,0,1,1,Garissa,NORTH EASTERN,5327
FAFI,Urban,80+,13,12,25,Garissa,NORTH EASTERN,5328
FAFI,Urban,Age NS,2,0,2,Garissa,NORTH EASTERN,5329
IJARA,Urban,0,163,157,320,Garissa,NORTH EASTERN,5330
IJARA,Urban,1,166,176,342,Garissa,NORTH EASTERN,5331
IJARA,Urban,2,262,267,529,Garissa,NORTH EASTERN,5332
IJARA,Urban,3,224,196,420,Garissa,NORTH EASTERN,5333
IJARA,Urban,4,297,258,555,Garissa,NORTH EASTERN,5334
IJARA,Urban,5,257,208,465,Garissa,NORTH EASTERN,5335
IJARA,Urban,6,355,298,653,Garissa,NORTH EASTERN,5336
IJARA,Urban,7,212,175,387,Garissa,NORTH EASTERN,5337
IJARA,Urban,8,391,350,741,Garissa,NORTH EASTERN,5338
IJARA,Urban,9,205,158,363,Garissa,NORTH EASTERN,5339
IJARA,Urban,10,427,416,843,Garissa,NORTH EASTERN,5340
IJARA,Urban,11,175,149,324,Garissa,NORTH EASTERN,5341
IJARA,Urban,12,369,359,728,Garissa,NORTH EASTERN,5342
IJARA,Urban,13,235,174,409,Garissa,NORTH EASTERN,5343
IJARA,Urban,14,317,226,543,Garissa,NORTH EASTERN,5344
IJARA,Urban,15,266,256,522,Garissa,NORTH EASTERN,5345
IJARA,Urban,16,281,198,479,Garissa,NORTH EASTERN,5346
IJARA,Urban,17,145,120,265,Garissa,NORTH EASTERN,5347
IJARA,Urban,18,332,240,572,Garissa,NORTH EASTERN,5348
IJARA,Urban,19,95,93,188,Garissa,NORTH EASTERN,5349
IJARA,Urban,20,275,287,562,Garissa,NORTH EASTERN,5350
IJARA,Urban,21,74,67,141,Garissa,NORTH EASTERN,5351
IJARA,Urban,22,105,123,228,Garissa,NORTH EASTERN,5352
IJARA,Urban,23,80,77,157,Garissa,NORTH EASTERN,5353
IJARA,Urban,24,91,76,167,Garissa,NORTH EASTERN,5354
IJARA,Urban,25,142,232,374,Garissa,NORTH EASTERN,5355
IJARA,Urban,26,82,79,161,Garissa,NORTH EASTERN,5356
IJARA,Urban,27,60,95,155,Garissa,NORTH EASTERN,5357
IJARA,Urban,28,111,157,268,Garissa,NORTH EASTERN,5358
IJARA,Urban,29,59,61,120,Garissa,NORTH EASTERN,5359
IJARA,Urban,30,262,314,576,Garissa,NORTH EASTERN,5360
IJARA,Urban,31,33,35,68,Garissa,NORTH EASTERN,5361
IJARA,Urban,32,91,74,165,Garissa,NORTH EASTERN,5362
IJARA,Urban,33,55,55,110,Garissa,NORTH EASTERN,5363
IJARA,Urban,34,45,39,84,Garissa,NORTH EASTERN,5364
IJARA,Urban,35,166,166,332,Garissa,NORTH EASTERN,5365
IJARA,Urban,36,41,62,103,Garissa,NORTH EASTERN,5366
IJARA,Urban,37,29,31,60,Garissa,NORTH EASTERN,5367
IJARA,Urban,38,62,81,143,Garissa,NORTH EASTERN,5368
IJARA,Urban,39,31,25,56,Garissa,NORTH EASTERN,5369
IJARA,Urban,40,221,200,421,Garissa,NORTH EASTERN,5370
IJARA,Urban,41,34,21,55,Garissa,NORTH EASTERN,5371
IJARA,Urban,42,61,32,93,Garissa,NORTH EASTERN,5372
IJARA,Urban,43,30,14,44,Garissa,NORTH EASTERN,5373
IJARA,Urban,44,24,20,44,Garissa,NORTH EASTERN,5374
IJARA,Urban,45,124,85,209,Garissa,NORTH EASTERN,5375
IJARA,Urban,46,36,24,60,Garissa,NORTH EASTERN,5376
IJARA,Urban,47,24,7,31,Garissa,NORTH EASTERN,5377
IJARA,Urban,48,53,20,73,Garissa,NORTH EASTERN,5378
IJARA,Urban,49,29,11,40,Garissa,NORTH EASTERN,5379
IJARA,Urban,50,122,93,215,Garissa,NORTH EASTERN,5380
IJARA,Urban,51,19,12,31,Garissa,NORTH EASTERN,5381
IJARA,Urban,52,31,13,44,Garissa,NORTH EASTERN,5382
IJARA,Urban,53,9,6,15,Garissa,NORTH EASTERN,5383
IJARA,Urban,54,16,6,22,Garissa,NORTH EASTERN,5384
IJARA,Urban,55,46,26,72,Garissa,NORTH EASTERN,5385
IJARA,Urban,56,29,12,41,Garissa,NORTH EASTERN,5386
IJARA,Urban,57,10,6,16,Garissa,NORTH EASTERN,5387
IJARA,Urban,58,25,11,36,Garissa,NORTH EASTERN,5388
IJARA,Urban,59,13,6,19,Garissa,NORTH EASTERN,5389
IJARA,Urban,60,89,53,142,Garissa,NORTH EASTERN,5390
IJARA,Urban,61,8,2,10,Garissa,NORTH EASTERN,5391
IJARA,Urban,62,9,8,17,Garissa,NORTH EASTERN,5392
IJARA,Urban,63,8,9,17,Garissa,NORTH EASTERN,5393
IJARA,Urban,64,13,6,19,Garissa,NORTH EASTERN,5394
IJARA,Urban,65,15,27,42,Garissa,NORTH EASTERN,5395
IJARA,Urban,66,12,6,18,Garissa,NORTH EASTERN,5396
IJARA,Urban,67,11,5,16,Garissa,NORTH EASTERN,5397
IJARA,Urban,68,9,9,18,Garissa,NORTH EASTERN,5398
IJARA,Urban,69,6,6,12,Garissa,NORTH EASTERN,5399
IJARA,Urban,70,44,52,96,Garissa,NORTH EASTERN,5400
IJARA,Urban,71,6,5,11,Garissa,NORTH EASTERN,5401
IJARA,Urban,72,5,5,10,Garissa,NORTH EASTERN,5402
IJARA,Urban,73,8,3,11,Garissa,NORTH EASTERN,5403
IJARA,Urban,74,8,2,10,Garissa,NORTH EASTERN,5404
IJARA,Urban,75,7,12,19,Garissa,NORTH EASTERN,5405
IJARA,Urban,76,3,1,4,Garissa,NORTH EASTERN,5406
IJARA,Urban,77,2,2,4,Garissa,NORTH EASTERN,5407
IJARA,Urban,78,5,5,10,Garissa,NORTH EASTERN,5408
IJARA,Urban,79,3,1,4,Garissa,NORTH EASTERN,5409
IJARA,Urban,80+,86,78,164,Garissa,NORTH EASTERN,5410
IJARA,Urban,Age NS,2,2,4,Garissa,NORTH EASTERN,5411
WAJIR SOUTH,Urban,0,94,93,187,Wajir,NORTH EASTERN,5412
WAJIR SOUTH,Urban,1,88,79,167,Wajir,NORTH EASTERN,5413
WAJIR SOUTH,Urban,2,152,133,285,Wajir,NORTH EASTERN,5414
WAJIR SOUTH,Urban,3,120,111,231,Wajir,NORTH EASTERN,5415
WAJIR SOUTH,Urban,4,165,137,302,Wajir,NORTH EASTERN,5416
WAJIR SOUTH,Urban,5,137,131,268,Wajir,NORTH EASTERN,5417
WAJIR SOUTH,Urban,6,168,137,305,Wajir,NORTH EASTERN,5418
WAJIR SOUTH,Urban,7,143,115,258,Wajir,NORTH EASTERN,5419
WAJIR SOUTH,Urban,8,174,154,328,Wajir,NORTH EASTERN,5420
WAJIR SOUTH,Urban,9,90,90,180,Wajir,NORTH EASTERN,5421
WAJIR SOUTH,Urban,10,222,195,417,Wajir,NORTH EASTERN,5422
WAJIR SOUTH,Urban,11,78,80,158,Wajir,NORTH EASTERN,5423
WAJIR SOUTH,Urban,12,174,118,292,Wajir,NORTH EASTERN,5424
WAJIR SOUTH,Urban,13,118,86,204,Wajir,NORTH EASTERN,5425
WAJIR SOUTH,Urban,14,170,84,254,Wajir,NORTH EASTERN,5426
WAJIR SOUTH,Urban,15,127,93,220,Wajir,NORTH EASTERN,5427
WAJIR SOUTH,Urban,16,129,107,236,Wajir,NORTH EASTERN,5428
WAJIR SOUTH,Urban,17,93,76,169,Wajir,NORTH EASTERN,5429
WAJIR SOUTH,Urban,18,197,114,311,Wajir,NORTH EASTERN,5430
WAJIR SOUTH,Urban,19,56,36,92,Wajir,NORTH EASTERN,5431
WAJIR SOUTH,Urban,20,180,171,351,Wajir,NORTH EASTERN,5432
WAJIR SOUTH,Urban,21,56,28,84,Wajir,NORTH EASTERN,5433
WAJIR SOUTH,Urban,22,69,85,154,Wajir,NORTH EASTERN,5434
WAJIR SOUTH,Urban,23,56,66,122,Wajir,NORTH EASTERN,5435
WAJIR SOUTH,Urban,24,57,41,98,Wajir,NORTH EASTERN,5436
WAJIR SOUTH,Urban,25,103,135,238,Wajir,NORTH EASTERN,5437
WAJIR SOUTH,Urban,26,46,41,87,Wajir,NORTH EASTERN,5438
WAJIR SOUTH,Urban,27,53,33,86,Wajir,NORTH EASTERN,5439
WAJIR SOUTH,Urban,28,56,69,125,Wajir,NORTH EASTERN,5440
WAJIR SOUTH,Urban,29,41,21,62,Wajir,NORTH EASTERN,5441
WAJIR SOUTH,Urban,30,140,165,305,Wajir,NORTH EASTERN,5442
WAJIR SOUTH,Urban,31,29,14,43,Wajir,NORTH EASTERN,5443
WAJIR SOUTH,Urban,32,54,48,102,Wajir,NORTH EASTERN,5444
WAJIR SOUTH,Urban,33,22,22,44,Wajir,NORTH EASTERN,5445
WAJIR SOUTH,Urban,34,24,15,39,Wajir,NORTH EASTERN,5446
WAJIR SOUTH,Urban,35,82,83,165,Wajir,NORTH EASTERN,5447
WAJIR SOUTH,Urban,36,23,23,46,Wajir,NORTH EASTERN,5448
WAJIR SOUTH,Urban,37,21,16,37,Wajir,NORTH EASTERN,5449
WAJIR SOUTH,Urban,38,25,33,58,Wajir,NORTH EASTERN,5450
WAJIR SOUTH,Urban,39,18,19,37,Wajir,NORTH EASTERN,5451
WAJIR SOUTH,Urban,40,129,105,234,Wajir,NORTH EASTERN,5452
WAJIR SOUTH,Urban,41,17,10,27,Wajir,NORTH EASTERN,5453
WAJIR SOUTH,Urban,42,35,43,78,Wajir,NORTH EASTERN,5454
WAJIR SOUTH,Urban,43,18,20,38,Wajir,NORTH EASTERN,5455
WAJIR SOUTH,Urban,44,12,4,16,Wajir,NORTH EASTERN,5456
WAJIR SOUTH,Urban,45,47,44,91,Wajir,NORTH EASTERN,5457
WAJIR SOUTH,Urban,46,22,12,34,Wajir,NORTH EASTERN,5458
WAJIR SOUTH,Urban,47,20,9,29,Wajir,NORTH EASTERN,5459
WAJIR SOUTH,Urban,48,30,21,51,Wajir,NORTH EASTERN,5460
WAJIR SOUTH,Urban,49,15,3,18,Wajir,NORTH EASTERN,5461
WAJIR SOUTH,Urban,50,78,64,142,Wajir,NORTH EASTERN,5462
WAJIR SOUTH,Urban,51,8,2,10,Wajir,NORTH EASTERN,5463
WAJIR SOUTH,Urban,52,24,12,36,Wajir,NORTH EASTERN,5464
WAJIR SOUTH,Urban,53,6,11,17,Wajir,NORTH EASTERN,5465
WAJIR SOUTH,Urban,54,19,11,30,Wajir,NORTH EASTERN,5466
WAJIR SOUTH,Urban,55,27,8,35,Wajir,NORTH EASTERN,5467
WAJIR SOUTH,Urban,56,12,5,17,Wajir,NORTH EASTERN,5468
WAJIR SOUTH,Urban,57,4,2,6,Wajir,NORTH EASTERN,5469
WAJIR SOUTH,Urban,58,8,8,16,Wajir,NORTH EASTERN,5470
WAJIR SOUTH,Urban,59,5,2,7,Wajir,NORTH EASTERN,5471
WAJIR SOUTH,Urban,60,42,48,90,Wajir,NORTH EASTERN,5472
WAJIR SOUTH,Urban,61,1,2,3,Wajir,NORTH EASTERN,5473
WAJIR SOUTH,Urban,62,12,3,15,Wajir,NORTH EASTERN,5474
WAJIR SOUTH,Urban,63,4,3,7,Wajir,NORTH EASTERN,5475
WAJIR SOUTH,Urban,64,4,1,5,Wajir,NORTH EASTERN,5476
WAJIR SOUTH,Urban,65,11,10,21,Wajir,NORTH EASTERN,5477
WAJIR SOUTH,Urban,66,2,4,6,Wajir,NORTH EASTERN,5478
WAJIR SOUTH,Urban,67,8,4,12,Wajir,NORTH EASTERN,5479
WAJIR SOUTH,Urban,68,7,11,18,Wajir,NORTH EASTERN,5480
WAJIR SOUTH,Urban,69,4,4,8,Wajir,NORTH EASTERN,5481
WAJIR SOUTH,Urban,70,42,37,79,Wajir,NORTH EASTERN,5482
WAJIR SOUTH,Urban,71,3,2,5,Wajir,NORTH EASTERN,5483
WAJIR SOUTH,Urban,72,4,3,7,Wajir,NORTH EASTERN,5484
WAJIR SOUTH,Urban,73,5,3,8,Wajir,NORTH EASTERN,5485
WAJIR SOUTH,Urban,74,2,3,5,Wajir,NORTH EASTERN,5486
WAJIR SOUTH,Urban,75,3,5,8,Wajir,NORTH EASTERN,5487
WAJIR SOUTH,Urban,76,1,1,2,Wajir,NORTH EASTERN,5488
WAJIR SOUTH,Urban,77,5,1,6,Wajir,NORTH EASTERN,5489
WAJIR SOUTH,Urban,78,4,3,7,Wajir,NORTH EASTERN,5490
WAJIR SOUTH,Urban,79,1,0,1,Wajir,NORTH EASTERN,5491
WAJIR SOUTH,Urban,80+,38,60,98,Wajir,NORTH EASTERN,5492
WAJIR SOUTH,Urban,Age NS,5,5,10,Wajir,NORTH EASTERN,5493
WAJIR NORTH,Urban,0,0,0,0,Wajir,NORTH EASTERN,5494
WAJIR NORTH,Urban,1,0,0,0,Wajir,NORTH EASTERN,5495
WAJIR NORTH,Urban,2,0,0,0,Wajir,NORTH EASTERN,5496
WAJIR NORTH,Urban,3,0,0,0,Wajir,NORTH EASTERN,5497
WAJIR NORTH,Urban,4,0,0,0,Wajir,NORTH EASTERN,5498
WAJIR NORTH,Urban,5,0,0,0,Wajir,NORTH EASTERN,5499
WAJIR NORTH,Urban,6,0,0,0,Wajir,NORTH EASTERN,5500
WAJIR NORTH,Urban,7,0,0,0,Wajir,NORTH EASTERN,5501
WAJIR NORTH,Urban,8,0,0,0,Wajir,NORTH EASTERN,5502
WAJIR NORTH,Urban,9,0,0,0,Wajir,NORTH EASTERN,5503
WAJIR NORTH,Urban,10,0,0,0,Wajir,NORTH EASTERN,5504
WAJIR NORTH,Urban,11,0,0,0,Wajir,NORTH EASTERN,5505
WAJIR NORTH,Urban,12,0,0,0,Wajir,NORTH EASTERN,5506
WAJIR NORTH,Urban,13,0,0,0,Wajir,NORTH EASTERN,5507
WAJIR NORTH,Urban,14,0,0,0,Wajir,NORTH EASTERN,5508
WAJIR NORTH,Urban,15,0,0,0,Wajir,NORTH EASTERN,5509
WAJIR NORTH,Urban,16,0,0,0,Wajir,NORTH EASTERN,5510
WAJIR NORTH,Urban,17,0,0,0,Wajir,NORTH EASTERN,5511
WAJIR NORTH,Urban,18,0,0,0,Wajir,NORTH EASTERN,5512
WAJIR NORTH,Urban,19,0,0,0,Wajir,NORTH EASTERN,5513
WAJIR NORTH,Urban,20,0,0,0,Wajir,NORTH EASTERN,5514
WAJIR NORTH,Urban,21,0,0,0,Wajir,NORTH EASTERN,5515
WAJIR NORTH,Urban,22,0,0,0,Wajir,NORTH EASTERN,5516
WAJIR NORTH,Urban,23,0,0,0,Wajir,NORTH EASTERN,5517
WAJIR NORTH,Urban,24,0,0,0,Wajir,NORTH EASTERN,5518
WAJIR NORTH,Urban,25,0,0,0,Wajir,NORTH EASTERN,5519
WAJIR NORTH,Urban,26,0,0,0,Wajir,NORTH EASTERN,5520
WAJIR NORTH,Urban,27,0,0,0,Wajir,NORTH EASTERN,5521
WAJIR NORTH,Urban,28,0,0,0,Wajir,NORTH EASTERN,5522
WAJIR NORTH,Urban,29,0,0,0,Wajir,NORTH EASTERN,5523
WAJIR NORTH,Urban,30,0,0,0,Wajir,NORTH EASTERN,5524
WAJIR NORTH,Urban,31,0,0,0,Wajir,NORTH EASTERN,5525
WAJIR NORTH,Urban,32,0,0,0,Wajir,NORTH EASTERN,5526
WAJIR NORTH,Urban,33,0,0,0,Wajir,NORTH EASTERN,5527
WAJIR NORTH,Urban,34,0,0,0,Wajir,NORTH EASTERN,5528
WAJIR NORTH,Urban,35,0,0,0,Wajir,NORTH EASTERN,5529
WAJIR NORTH,Urban,36,0,0,0,Wajir,NORTH EASTERN,5530
WAJIR NORTH,Urban,37,0,0,0,Wajir,NORTH EASTERN,5531
WAJIR NORTH,Urban,38,0,0,0,Wajir,NORTH EASTERN,5532
WAJIR NORTH,Urban,39,0,0,0,Wajir,NORTH EASTERN,5533
WAJIR NORTH,Urban,40,0,0,0,Wajir,NORTH EASTERN,5534
WAJIR NORTH,Urban,41,0,0,0,Wajir,NORTH EASTERN,5535
WAJIR NORTH,Urban,42,0,0,0,Wajir,NORTH EASTERN,5536
WAJIR NORTH,Urban,43,0,0,0,Wajir,NORTH EASTERN,5537
WAJIR NORTH,Urban,44,0,0,0,Wajir,NORTH EASTERN,5538
WAJIR NORTH,Urban,45,0,0,0,Wajir,NORTH EASTERN,5539
WAJIR NORTH,Urban,46,0,0,0,Wajir,NORTH EASTERN,5540
WAJIR NORTH,Urban,47,0,0,0,Wajir,NORTH EASTERN,5541
WAJIR NORTH,Urban,48,0,0,0,Wajir,NORTH EASTERN,5542
WAJIR NORTH,Urban,49,0,0,0,Wajir,NORTH EASTERN,5543
WAJIR NORTH,Urban,50,0,0,0,Wajir,NORTH EASTERN,5544
WAJIR NORTH,Urban,51,0,0,0,Wajir,NORTH EASTERN,5545
WAJIR NORTH,Urban,52,0,0,0,Wajir,NORTH EASTERN,5546
WAJIR NORTH,Urban,53,0,0,0,Wajir,NORTH EASTERN,5547
WAJIR NORTH,Urban,54,0,0,0,Wajir,NORTH EASTERN,5548
WAJIR NORTH,Urban,55,0,0,0,Wajir,NORTH EASTERN,5549
WAJIR NORTH,Urban,56,0,0,0,Wajir,NORTH EASTERN,5550
WAJIR NORTH,Urban,57,0,0,0,Wajir,NORTH EASTERN,5551
WAJIR NORTH,Urban,58,0,0,0,Wajir,NORTH EASTERN,5552
WAJIR NORTH,Urban,59,0,0,0,Wajir,NORTH EASTERN,5553
WAJIR NORTH,Urban,60,0,0,0,Wajir,NORTH EASTERN,5554
WAJIR NORTH,Urban,61,0,0,0,Wajir,NORTH EASTERN,5555
WAJIR NORTH,Urban,62,0,0,0,Wajir,NORTH EASTERN,5556
WAJIR NORTH,Urban,63,0,0,0,Wajir,NORTH EASTERN,5557
WAJIR NORTH,Urban,64,0,0,0,Wajir,NORTH EASTERN,5558
WAJIR NORTH,Urban,65,0,0,0,Wajir,NORTH EASTERN,5559
WAJIR NORTH,Urban,66,0,0,0,Wajir,NORTH EASTERN,5560
WAJIR NORTH,Urban,67,0,0,0,Wajir,NORTH EASTERN,5561
WAJIR NORTH,Urban,68,0,0,0,Wajir,NORTH EASTERN,5562
WAJIR NORTH,Urban,69,0,0,0,Wajir,NORTH EASTERN,5563
WAJIR NORTH,Urban,70,0,0,0,Wajir,NORTH EASTERN,5564
WAJIR NORTH,Urban,71,0,0,0,Wajir,NORTH EASTERN,5565
WAJIR NORTH,Urban,72,0,0,0,Wajir,NORTH EASTERN,5566
WAJIR NORTH,Urban,73,0,0,0,Wajir,NORTH EASTERN,5567
WAJIR NORTH,Urban,74,0,0,0,Wajir,NORTH EASTERN,5568
WAJIR NORTH,Urban,75,0,0,0,Wajir,NORTH EASTERN,5569
WAJIR NORTH,Urban,76,0,0,0,Wajir,NORTH EASTERN,5570
WAJIR NORTH,Urban,77,0,0,0,Wajir,NORTH EASTERN,5571
WAJIR NORTH,Urban,78,0,0,0,Wajir,NORTH EASTERN,5572
WAJIR NORTH,Urban,79,0,0,0,Wajir,NORTH EASTERN,5573
WAJIR NORTH,Urban,80+,0,0,0,Wajir,NORTH EASTERN,5574
WAJIR NORTH,Urban,Age NS,0,0,0,Wajir,NORTH EASTERN,5575
WAJIR EAST,Urban,0,1108,1081,2189,Wajir,NORTH EASTERN,5576
WAJIR EAST,Urban,1,884,836,1720,Wajir,NORTH EASTERN,5577
WAJIR EAST,Urban,2,1488,1402,2890,Wajir,NORTH EASTERN,5578
WAJIR EAST,Urban,3,1264,1133,2397,Wajir,NORTH EASTERN,5579
WAJIR EAST,Urban,4,1517,1423,2940,Wajir,NORTH EASTERN,5580
WAJIR EAST,Urban,5,1315,1154,2469,Wajir,NORTH EASTERN,5581
WAJIR EAST,Urban,6,1589,1409,2998,Wajir,NORTH EASTERN,5582
WAJIR EAST,Urban,7,1282,1167,2449,Wajir,NORTH EASTERN,5583
WAJIR EAST,Urban,8,1681,1501,3182,Wajir,NORTH EASTERN,5584
WAJIR EAST,Urban,9,1000,847,1847,Wajir,NORTH EASTERN,5585
WAJIR EAST,Urban,10,1885,1644,3529,Wajir,NORTH EASTERN,5586
WAJIR EAST,Urban,11,859,763,1622,Wajir,NORTH EASTERN,5587
WAJIR EAST,Urban,12,1735,1412,3147,Wajir,NORTH EASTERN,5588
WAJIR EAST,Urban,13,1146,918,2064,Wajir,NORTH EASTERN,5589
WAJIR EAST,Urban,14,1484,1190,2674,Wajir,NORTH EASTERN,5590
WAJIR EAST,Urban,15,1367,1075,2442,Wajir,NORTH EASTERN,5591
WAJIR EAST,Urban,16,1394,1160,2554,Wajir,NORTH EASTERN,5592
WAJIR EAST,Urban,17,944,753,1697,Wajir,NORTH EASTERN,5593
WAJIR EAST,Urban,18,1935,1430,3365,Wajir,NORTH EASTERN,5594
WAJIR EAST,Urban,19,681,514,1195,Wajir,NORTH EASTERN,5595
WAJIR EAST,Urban,20,1822,1525,3347,Wajir,NORTH EASTERN,5596
WAJIR EAST,Urban,21,465,379,844,Wajir,NORTH EASTERN,5597
WAJIR EAST,Urban,22,781,666,1447,Wajir,NORTH EASTERN,5598
WAJIR EAST,Urban,23,521,541,1062,Wajir,NORTH EASTERN,5599
WAJIR EAST,Urban,24,468,475,943,Wajir,NORTH EASTERN,5600
WAJIR EAST,Urban,25,1073,1193,2266,Wajir,NORTH EASTERN,5601
WAJIR EAST,Urban,26,415,425,840,Wajir,NORTH EASTERN,5602
WAJIR EAST,Urban,27,418,433,851,Wajir,NORTH EASTERN,5603
WAJIR EAST,Urban,28,569,670,1239,Wajir,NORTH EASTERN,5604
WAJIR EAST,Urban,29,264,264,528,Wajir,NORTH EASTERN,5605
WAJIR EAST,Urban,30,1402,1378,2780,Wajir,NORTH EASTERN,5606
WAJIR EAST,Urban,31,175,131,306,Wajir,NORTH EASTERN,5607
WAJIR EAST,Urban,32,340,343,683,Wajir,NORTH EASTERN,5608
WAJIR EAST,Urban,33,217,194,411,Wajir,NORTH EASTERN,5609
WAJIR EAST,Urban,34,202,150,352,Wajir,NORTH EASTERN,5610
WAJIR EAST,Urban,35,739,868,1607,Wajir,NORTH EASTERN,5611
WAJIR EAST,Urban,36,173,174,347,Wajir,NORTH EASTERN,5612
WAJIR EAST,Urban,37,181,178,359,Wajir,NORTH EASTERN,5613
WAJIR EAST,Urban,38,232,311,543,Wajir,NORTH EASTERN,5614
WAJIR EAST,Urban,39,147,153,300,Wajir,NORTH EASTERN,5615
WAJIR EAST,Urban,40,1099,980,2079,Wajir,NORTH EASTERN,5616
WAJIR EAST,Urban,41,91,58,149,Wajir,NORTH EASTERN,5617
WAJIR EAST,Urban,42,205,136,341,Wajir,NORTH EASTERN,5618
WAJIR EAST,Urban,43,118,100,218,Wajir,NORTH EASTERN,5619
WAJIR EAST,Urban,44,94,79,173,Wajir,NORTH EASTERN,5620
WAJIR EAST,Urban,45,516,506,1022,Wajir,NORTH EASTERN,5621
WAJIR EAST,Urban,46,137,111,248,Wajir,NORTH EASTERN,5622
WAJIR EAST,Urban,47,131,88,219,Wajir,NORTH EASTERN,5623
WAJIR EAST,Urban,48,183,143,326,Wajir,NORTH EASTERN,5624
WAJIR EAST,Urban,49,113,64,177,Wajir,NORTH EASTERN,5625
WAJIR EAST,Urban,50,717,749,1466,Wajir,NORTH EASTERN,5626
WAJIR EAST,Urban,51,62,30,92,Wajir,NORTH EASTERN,5627
WAJIR EAST,Urban,52,128,100,228,Wajir,NORTH EASTERN,5628
WAJIR EAST,Urban,53,80,62,142,Wajir,NORTH EASTERN,5629
WAJIR EAST,Urban,54,78,71,149,Wajir,NORTH EASTERN,5630
WAJIR EAST,Urban,55,270,201,471,Wajir,NORTH EASTERN,5631
WAJIR EAST,Urban,56,104,79,183,Wajir,NORTH EASTERN,5632
WAJIR EAST,Urban,57,54,35,89,Wajir,NORTH EASTERN,5633
WAJIR EAST,Urban,58,80,60,140,Wajir,NORTH EASTERN,5634
WAJIR EAST,Urban,59,43,33,76,Wajir,NORTH EASTERN,5635
WAJIR EAST,Urban,60,526,471,997,Wajir,NORTH EASTERN,5636
WAJIR EAST,Urban,61,35,24,59,Wajir,NORTH EASTERN,5637
WAJIR EAST,Urban,62,60,47,107,Wajir,NORTH EASTERN,5638
WAJIR EAST,Urban,63,42,46,88,Wajir,NORTH EASTERN,5639
WAJIR EAST,Urban,64,50,31,81,Wajir,NORTH EASTERN,5640
WAJIR EAST,Urban,65,137,144,281,Wajir,NORTH EASTERN,5641
WAJIR EAST,Urban,66,32,29,61,Wajir,NORTH EASTERN,5642
WAJIR EAST,Urban,67,54,39,93,Wajir,NORTH EASTERN,5643
WAJIR EAST,Urban,68,57,33,90,Wajir,NORTH EASTERN,5644
WAJIR EAST,Urban,69,26,21,47,Wajir,NORTH EASTERN,5645
WAJIR EAST,Urban,70,361,388,749,Wajir,NORTH EASTERN,5646
WAJIR EAST,Urban,71,25,13,38,Wajir,NORTH EASTERN,5647
WAJIR EAST,Urban,72,50,32,82,Wajir,NORTH EASTERN,5648
WAJIR EAST,Urban,73,41,38,79,Wajir,NORTH EASTERN,5649
WAJIR EAST,Urban,74,25,25,50,Wajir,NORTH EASTERN,5650
WAJIR EAST,Urban,75,85,91,176,Wajir,NORTH EASTERN,5651
WAJIR EAST,Urban,76,32,28,60,Wajir,NORTH EASTERN,5652
WAJIR EAST,Urban,77,24,33,57,Wajir,NORTH EASTERN,5653
WAJIR EAST,Urban,78,35,48,83,Wajir,NORTH EASTERN,5654
WAJIR EAST,Urban,79,19,14,33,Wajir,NORTH EASTERN,5655
WAJIR EAST,Urban,80+,479,550,1029,Wajir,NORTH EASTERN,5656
WAJIR EAST,Urban,Age NS,24,23,47,Wajir,NORTH EASTERN,5657
WAJIR WEST,Urban,0,76,69,145,Wajir,NORTH EASTERN,5658
WAJIR WEST,Urban,1,47,74,121,Wajir,NORTH EASTERN,5659
WAJIR WEST,Urban,2,106,117,223,Wajir,NORTH EASTERN,5660
WAJIR WEST,Urban,3,105,79,184,Wajir,NORTH EASTERN,5661
WAJIR WEST,Urban,4,109,104,213,Wajir,NORTH EASTERN,5662
WAJIR WEST,Urban,5,112,100,212,Wajir,NORTH EASTERN,5663
WAJIR WEST,Urban,6,130,102,232,Wajir,NORTH EASTERN,5664
WAJIR WEST,Urban,7,96,77,173,Wajir,NORTH EASTERN,5665
WAJIR WEST,Urban,8,155,136,291,Wajir,NORTH EASTERN,5666
WAJIR WEST,Urban,9,91,79,170,Wajir,NORTH EASTERN,5667
WAJIR WEST,Urban,10,177,150,327,Wajir,NORTH EASTERN,5668
WAJIR WEST,Urban,11,75,57,132,Wajir,NORTH EASTERN,5669
WAJIR WEST,Urban,12,135,99,234,Wajir,NORTH EASTERN,5670
WAJIR WEST,Urban,13,77,69,146,Wajir,NORTH EASTERN,5671
WAJIR WEST,Urban,14,126,78,204,Wajir,NORTH EASTERN,5672
WAJIR WEST,Urban,15,81,63,144,Wajir,NORTH EASTERN,5673
WAJIR WEST,Urban,16,123,76,199,Wajir,NORTH EASTERN,5674
WAJIR WEST,Urban,17,52,30,82,Wajir,NORTH EASTERN,5675
WAJIR WEST,Urban,18,114,67,181,Wajir,NORTH EASTERN,5676
WAJIR WEST,Urban,19,25,13,38,Wajir,NORTH EASTERN,5677
WAJIR WEST,Urban,20,112,77,189,Wajir,NORTH EASTERN,5678
WAJIR WEST,Urban,21,19,18,37,Wajir,NORTH EASTERN,5679
WAJIR WEST,Urban,22,35,33,68,Wajir,NORTH EASTERN,5680
WAJIR WEST,Urban,23,29,27,56,Wajir,NORTH EASTERN,5681
WAJIR WEST,Urban,24,19,30,49,Wajir,NORTH EASTERN,5682
WAJIR WEST,Urban,25,50,53,103,Wajir,NORTH EASTERN,5683
WAJIR WEST,Urban,26,27,25,52,Wajir,NORTH EASTERN,5684
WAJIR WEST,Urban,27,14,34,48,Wajir,NORTH EASTERN,5685
WAJIR WEST,Urban,28,31,34,65,Wajir,NORTH EASTERN,5686
WAJIR WEST,Urban,29,14,27,41,Wajir,NORTH EASTERN,5687
WAJIR WEST,Urban,30,64,96,160,Wajir,NORTH EASTERN,5688
WAJIR WEST,Urban,31,9,17,26,Wajir,NORTH EASTERN,5689
WAJIR WEST,Urban,32,17,32,49,Wajir,NORTH EASTERN,5690
WAJIR WEST,Urban,33,13,20,33,Wajir,NORTH EASTERN,5691
WAJIR WEST,Urban,34,8,16,24,Wajir,NORTH EASTERN,5692
WAJIR WEST,Urban,35,38,38,76,Wajir,NORTH EASTERN,5693
WAJIR WEST,Urban,36,9,15,24,Wajir,NORTH EASTERN,5694
WAJIR WEST,Urban,37,18,17,35,Wajir,NORTH EASTERN,5695
WAJIR WEST,Urban,38,24,17,41,Wajir,NORTH EASTERN,5696
WAJIR WEST,Urban,39,16,9,25,Wajir,NORTH EASTERN,5697
WAJIR WEST,Urban,40,78,67,145,Wajir,NORTH EASTERN,5698
WAJIR WEST,Urban,41,18,5,23,Wajir,NORTH EASTERN,5699
WAJIR WEST,Urban,42,17,13,30,Wajir,NORTH EASTERN,5700
WAJIR WEST,Urban,43,6,4,10,Wajir,NORTH EASTERN,5701
WAJIR WEST,Urban,44,4,7,11,Wajir,NORTH EASTERN,5702
WAJIR WEST,Urban,45,14,18,32,Wajir,NORTH EASTERN,5703
WAJIR WEST,Urban,46,13,5,18,Wajir,NORTH EASTERN,5704
WAJIR WEST,Urban,47,13,0,13,Wajir,NORTH EASTERN,5705
WAJIR WEST,Urban,48,11,9,20,Wajir,NORTH EASTERN,5706
WAJIR WEST,Urban,49,9,4,13,Wajir,NORTH EASTERN,5707
WAJIR WEST,Urban,50,55,34,89,Wajir,NORTH EASTERN,5708
WAJIR WEST,Urban,51,8,1,9,Wajir,NORTH EASTERN,5709
WAJIR WEST,Urban,52,14,5,19,Wajir,NORTH EASTERN,5710
WAJIR WEST,Urban,53,15,9,24,Wajir,NORTH EASTERN,5711
WAJIR WEST,Urban,54,12,5,17,Wajir,NORTH EASTERN,5712
WAJIR WEST,Urban,55,5,10,15,Wajir,NORTH EASTERN,5713
WAJIR WEST,Urban,56,7,0,7,Wajir,NORTH EASTERN,5714
WAJIR WEST,Urban,57,1,2,3,Wajir,NORTH EASTERN,5715
WAJIR WEST,Urban,58,3,2,5,Wajir,NORTH EASTERN,5716
WAJIR WEST,Urban,59,1,1,2,Wajir,NORTH EASTERN,5717
WAJIR WEST,Urban,60,51,18,69,Wajir,NORTH EASTERN,5718
WAJIR WEST,Urban,61,3,1,4,Wajir,NORTH EASTERN,5719
WAJIR WEST,Urban,62,5,1,6,Wajir,NORTH EASTERN,5720
WAJIR WEST,Urban,63,2,1,3,Wajir,NORTH EASTERN,5721
WAJIR WEST,Urban,64,2,1,3,Wajir,NORTH EASTERN,5722
WAJIR WEST,Urban,65,9,9,18,Wajir,NORTH EASTERN,5723
WAJIR WEST,Urban,66,3,0,3,Wajir,NORTH EASTERN,5724
WAJIR WEST,Urban,67,2,1,3,Wajir,NORTH EASTERN,5725
WAJIR WEST,Urban,68,2,0,2,Wajir,NORTH EASTERN,5726
WAJIR WEST,Urban,69,2,0,2,Wajir,NORTH EASTERN,5727
WAJIR WEST,Urban,70,24,9,33,Wajir,NORTH EASTERN,5728
WAJIR WEST,Urban,71,1,1,2,Wajir,NORTH EASTERN,5729
WAJIR WEST,Urban,72,2,2,4,Wajir,NORTH EASTERN,5730
WAJIR WEST,Urban,73,2,0,2,Wajir,NORTH EASTERN,5731
WAJIR WEST,Urban,74,1,0,1,Wajir,NORTH EASTERN,5732
WAJIR WEST,Urban,75,5,6,11,Wajir,NORTH EASTERN,5733
WAJIR WEST,Urban,76,3,0,3,Wajir,NORTH EASTERN,5734
WAJIR WEST,Urban,77,1,0,1,Wajir,NORTH EASTERN,5735
WAJIR WEST,Urban,78,3,2,5,Wajir,NORTH EASTERN,5736
WAJIR WEST,Urban,79,0,0,0,Wajir,NORTH EASTERN,5737
SIAYA,Urban,33,197,186,383,Siaya,NYANZA,5738
WAJIR WEST,Urban,80+,17,5,22,Wajir,NORTH EASTERN,5739
WAJIR WEST,Urban,Age NS,0,1,1,Wajir,NORTH EASTERN,5740
MANDERA CENTRAL,Urban,0,515,454,969,Mandera,NORTH EASTERN,5741
MANDERA CENTRAL,Urban,1,538,561,1099,Mandera,NORTH EASTERN,5742
MANDERA CENTRAL,Urban,2,1265,1203,2468,Mandera,NORTH EASTERN,5743
MANDERA CENTRAL,Urban,3,1003,886,1889,Mandera,NORTH EASTERN,5744
MANDERA CENTRAL,Urban,4,1585,1409,2994,Mandera,NORTH EASTERN,5745
MANDERA CENTRAL,Urban,5,1174,1060,2234,Mandera,NORTH EASTERN,5746
MANDERA CENTRAL,Urban,6,1934,1554,3488,Mandera,NORTH EASTERN,5747
MANDERA CENTRAL,Urban,7,1138,1009,2147,Mandera,NORTH EASTERN,5748
MANDERA CENTRAL,Urban,8,2253,1872,4125,Mandera,NORTH EASTERN,5749
MANDERA CENTRAL,Urban,9,1150,977,2127,Mandera,NORTH EASTERN,5750
MANDERA CENTRAL,Urban,10,2560,1907,4467,Mandera,NORTH EASTERN,5751
MANDERA CENTRAL,Urban,11,890,816,1706,Mandera,NORTH EASTERN,5752
MANDERA CENTRAL,Urban,12,2243,1510,3753,Mandera,NORTH EASTERN,5753
MANDERA CENTRAL,Urban,13,1176,908,2084,Mandera,NORTH EASTERN,5754
MANDERA CENTRAL,Urban,14,1923,1283,3206,Mandera,NORTH EASTERN,5755
MANDERA CENTRAL,Urban,15,1350,1024,2374,Mandera,NORTH EASTERN,5756
MANDERA CENTRAL,Urban,16,1777,1133,2910,Mandera,NORTH EASTERN,5757
MANDERA CENTRAL,Urban,17,971,657,1628,Mandera,NORTH EASTERN,5758
MANDERA CENTRAL,Urban,18,2015,1187,3202,Mandera,NORTH EASTERN,5759
MANDERA CENTRAL,Urban,19,608,371,979,Mandera,NORTH EASTERN,5760
MANDERA CENTRAL,Urban,20,1580,980,2560,Mandera,NORTH EASTERN,5761
MANDERA CENTRAL,Urban,21,391,224,615,Mandera,NORTH EASTERN,5762
MANDERA CENTRAL,Urban,22,622,421,1043,Mandera,NORTH EASTERN,5763
MANDERA CENTRAL,Urban,23,349,249,598,Mandera,NORTH EASTERN,5764
MANDERA CENTRAL,Urban,24,425,294,719,Mandera,NORTH EASTERN,5765
MANDERA CENTRAL,Urban,25,614,608,1222,Mandera,NORTH EASTERN,5766
MANDERA CENTRAL,Urban,26,339,279,618,Mandera,NORTH EASTERN,5767
MANDERA CENTRAL,Urban,27,149,244,393,Mandera,NORTH EASTERN,5768
MANDERA CENTRAL,Urban,28,389,451,840,Mandera,NORTH EASTERN,5769
MANDERA CENTRAL,Urban,29,133,189,322,Mandera,NORTH EASTERN,5770
MANDERA CENTRAL,Urban,30,743,925,1668,Mandera,NORTH EASTERN,5771
MANDERA CENTRAL,Urban,31,93,129,222,Mandera,NORTH EASTERN,5772
MANDERA CENTRAL,Urban,32,195,273,468,Mandera,NORTH EASTERN,5773
MANDERA CENTRAL,Urban,33,116,163,279,Mandera,NORTH EASTERN,5774
MANDERA CENTRAL,Urban,34,105,143,248,Mandera,NORTH EASTERN,5775
MANDERA CENTRAL,Urban,35,531,732,1263,Mandera,NORTH EASTERN,5776
MANDERA CENTRAL,Urban,36,159,213,372,Mandera,NORTH EASTERN,5777
MANDERA CENTRAL,Urban,37,131,186,317,Mandera,NORTH EASTERN,5778
MANDERA CENTRAL,Urban,38,244,397,641,Mandera,NORTH EASTERN,5779
MANDERA CENTRAL,Urban,39,114,185,299,Mandera,NORTH EASTERN,5780
MANDERA CENTRAL,Urban,40,781,730,1511,Mandera,NORTH EASTERN,5781
MANDERA CENTRAL,Urban,41,87,84,171,Mandera,NORTH EASTERN,5782
MANDERA CENTRAL,Urban,42,185,217,402,Mandera,NORTH EASTERN,5783
SIAYA,Urban,34,192,191,383,Siaya,NYANZA,5784
MANDERA CENTRAL,Urban,43,117,116,233,Mandera,NORTH EASTERN,5785
MANDERA CENTRAL,Urban,44,78,74,152,Mandera,NORTH EASTERN,5786
MANDERA CENTRAL,Urban,45,480,391,871,Mandera,NORTH EASTERN,5787
MANDERA CENTRAL,Urban,46,127,108,235,Mandera,NORTH EASTERN,5788
MANDERA CENTRAL,Urban,47,82,89,171,Mandera,NORTH EASTERN,5789
MANDERA CENTRAL,Urban,48,219,195,414,Mandera,NORTH EASTERN,5790
MANDERA CENTRAL,Urban,49,117,85,202,Mandera,NORTH EASTERN,5791
MANDERA CENTRAL,Urban,50,536,403,939,Mandera,NORTH EASTERN,5792
MANDERA CENTRAL,Urban,51,61,45,106,Mandera,NORTH EASTERN,5793
MANDERA CENTRAL,Urban,52,129,98,227,Mandera,NORTH EASTERN,5794
MANDERA CENTRAL,Urban,53,76,61,137,Mandera,NORTH EASTERN,5795
MANDERA CENTRAL,Urban,54,82,67,149,Mandera,NORTH EASTERN,5796
MANDERA CENTRAL,Urban,55,263,207,470,Mandera,NORTH EASTERN,5797
MANDERA CENTRAL,Urban,56,99,57,156,Mandera,NORTH EASTERN,5798
MANDERA CENTRAL,Urban,57,51,42,93,Mandera,NORTH EASTERN,5799
MANDERA CENTRAL,Urban,58,86,46,132,Mandera,NORTH EASTERN,5800
MANDERA CENTRAL,Urban,59,39,21,60,Mandera,NORTH EASTERN,5801
MANDERA CENTRAL,Urban,60,404,203,607,Mandera,NORTH EASTERN,5802
MANDERA CENTRAL,Urban,61,33,11,44,Mandera,NORTH EASTERN,5803
MANDERA CENTRAL,Urban,62,67,34,101,Mandera,NORTH EASTERN,5804
MANDERA CENTRAL,Urban,63,44,17,61,Mandera,NORTH EASTERN,5805
MANDERA CENTRAL,Urban,64,29,17,46,Mandera,NORTH EASTERN,5806
MANDERA CENTRAL,Urban,65,154,70,224,Mandera,NORTH EASTERN,5807
MANDERA CENTRAL,Urban,66,18,19,37,Mandera,NORTH EASTERN,5808
MANDERA CENTRAL,Urban,67,30,14,44,Mandera,NORTH EASTERN,5809
MANDERA CENTRAL,Urban,68,47,33,80,Mandera,NORTH EASTERN,5810
MANDERA CENTRAL,Urban,69,19,8,27,Mandera,NORTH EASTERN,5811
MANDERA CENTRAL,Urban,70,238,105,343,Mandera,NORTH EASTERN,5812
MANDERA CENTRAL,Urban,71,7,9,16,Mandera,NORTH EASTERN,5813
MANDERA CENTRAL,Urban,72,31,19,50,Mandera,NORTH EASTERN,5814
MANDERA CENTRAL,Urban,73,21,17,38,Mandera,NORTH EASTERN,5815
MANDERA CENTRAL,Urban,74,14,19,33,Mandera,NORTH EASTERN,5816
MANDERA CENTRAL,Urban,75,58,22,80,Mandera,NORTH EASTERN,5817
MANDERA CENTRAL,Urban,76,14,10,24,Mandera,NORTH EASTERN,5818
MANDERA CENTRAL,Urban,77,10,10,20,Mandera,NORTH EASTERN,5819
MANDERA CENTRAL,Urban,78,14,19,33,Mandera,NORTH EASTERN,5820
MANDERA CENTRAL,Urban,79,8,7,15,Mandera,NORTH EASTERN,5821
MANDERA CENTRAL,Urban,80+,229,179,408,Mandera,NORTH EASTERN,5822
MANDERA CENTRAL,Urban,Age NS,14,19,33,Mandera,NORTH EASTERN,5823
MANDERA EAST,Urban,0,1140,1089,2229,Mandera,NORTH EASTERN,5824
MANDERA EAST,Urban,1,810,851,1661,Mandera,NORTH EASTERN,5825
MANDERA EAST,Urban,2,1636,1469,3105,Mandera,NORTH EASTERN,5826
MANDERA EAST,Urban,3,1436,1354,2790,Mandera,NORTH EASTERN,5827
MANDERA EAST,Urban,4,1589,1550,3139,Mandera,NORTH EASTERN,5828
MANDERA EAST,Urban,5,1386,1227,2613,Mandera,NORTH EASTERN,5829
MANDERA EAST,Urban,6,1639,1527,3166,Mandera,NORTH EASTERN,5830
MANDERA EAST,Urban,7,1335,1239,2574,Mandera,NORTH EASTERN,5831
MANDERA EAST,Urban,8,1835,1650,3485,Mandera,NORTH EASTERN,5832
MANDERA EAST,Urban,9,1058,1041,2099,Mandera,NORTH EASTERN,5833
MANDERA EAST,Urban,10,2003,1718,3721,Mandera,NORTH EASTERN,5834
MANDERA EAST,Urban,11,907,894,1801,Mandera,NORTH EASTERN,5835
MANDERA EAST,Urban,12,1836,1555,3391,Mandera,NORTH EASTERN,5836
MANDERA EAST,Urban,13,1402,1190,2592,Mandera,NORTH EASTERN,5837
MANDERA EAST,Urban,14,1756,1387,3143,Mandera,NORTH EASTERN,5838
MANDERA EAST,Urban,15,1580,1289,2869,Mandera,NORTH EASTERN,5839
MANDERA EAST,Urban,16,1628,1297,2925,Mandera,NORTH EASTERN,5840
MANDERA EAST,Urban,17,1208,896,2104,Mandera,NORTH EASTERN,5841
MANDERA EAST,Urban,18,2228,1610,3838,Mandera,NORTH EASTERN,5842
MANDERA EAST,Urban,19,860,638,1498,Mandera,NORTH EASTERN,5843
MANDERA EAST,Urban,20,2167,1596,3763,Mandera,NORTH EASTERN,5844
MANDERA EAST,Urban,21,522,398,920,Mandera,NORTH EASTERN,5845
MANDERA EAST,Urban,22,867,729,1596,Mandera,NORTH EASTERN,5846
MANDERA EAST,Urban,23,556,510,1066,Mandera,NORTH EASTERN,5847
MANDERA EAST,Urban,24,478,450,928,Mandera,NORTH EASTERN,5848
MANDERA EAST,Urban,25,1086,1122,2208,Mandera,NORTH EASTERN,5849
MANDERA EAST,Urban,26,432,422,854,Mandera,NORTH EASTERN,5850
MANDERA EAST,Urban,27,367,377,744,Mandera,NORTH EASTERN,5851
MANDERA EAST,Urban,28,550,621,1171,Mandera,NORTH EASTERN,5852
MANDERA EAST,Urban,29,208,230,438,Mandera,NORTH EASTERN,5853
MANDERA EAST,Urban,30,1208,1243,2451,Mandera,NORTH EASTERN,5854
MANDERA EAST,Urban,31,142,152,294,Mandera,NORTH EASTERN,5855
MANDERA EAST,Urban,32,307,310,617,Mandera,NORTH EASTERN,5856
MANDERA EAST,Urban,33,192,172,364,Mandera,NORTH EASTERN,5857
MANDERA EAST,Urban,34,166,156,322,Mandera,NORTH EASTERN,5858
MANDERA EAST,Urban,35,784,875,1659,Mandera,NORTH EASTERN,5859
MANDERA EAST,Urban,36,187,208,395,Mandera,NORTH EASTERN,5860
MANDERA EAST,Urban,37,161,209,370,Mandera,NORTH EASTERN,5861
MANDERA EAST,Urban,38,267,363,630,Mandera,NORTH EASTERN,5862
MANDERA EAST,Urban,39,112,131,243,Mandera,NORTH EASTERN,5863
MANDERA EAST,Urban,40,1036,1058,2094,Mandera,NORTH EASTERN,5864
MANDERA EAST,Urban,41,64,76,140,Mandera,NORTH EASTERN,5865
MANDERA EAST,Urban,42,190,198,388,Mandera,NORTH EASTERN,5866
MANDERA EAST,Urban,43,109,116,225,Mandera,NORTH EASTERN,5867
MANDERA EAST,Urban,44,76,61,137,Mandera,NORTH EASTERN,5868
MANDERA EAST,Urban,45,526,561,1087,Mandera,NORTH EASTERN,5869
MANDERA EAST,Urban,46,107,97,204,Mandera,NORTH EASTERN,5870
MANDERA EAST,Urban,47,108,92,200,Mandera,NORTH EASTERN,5871
MANDERA EAST,Urban,48,164,145,309,Mandera,NORTH EASTERN,5872
MANDERA EAST,Urban,49,98,86,184,Mandera,NORTH EASTERN,5873
MANDERA EAST,Urban,50,688,764,1452,Mandera,NORTH EASTERN,5874
MANDERA EAST,Urban,51,45,49,94,Mandera,NORTH EASTERN,5875
MANDERA EAST,Urban,52,125,101,226,Mandera,NORTH EASTERN,5876
MANDERA EAST,Urban,53,79,52,131,Mandera,NORTH EASTERN,5877
MANDERA EAST,Urban,54,66,65,131,Mandera,NORTH EASTERN,5878
MANDERA EAST,Urban,55,258,212,470,Mandera,NORTH EASTERN,5879
MANDERA EAST,Urban,56,74,65,139,Mandera,NORTH EASTERN,5880
MANDERA EAST,Urban,57,62,34,96,Mandera,NORTH EASTERN,5881
MANDERA EAST,Urban,58,68,50,118,Mandera,NORTH EASTERN,5882
MANDERA EAST,Urban,59,39,28,67,Mandera,NORTH EASTERN,5883
MANDERA EAST,Urban,60,501,489,990,Mandera,NORTH EASTERN,5884
MANDERA EAST,Urban,61,18,16,34,Mandera,NORTH EASTERN,5885
MANDERA EAST,Urban,62,62,59,121,Mandera,NORTH EASTERN,5886
MANDERA EAST,Urban,63,43,31,74,Mandera,NORTH EASTERN,5887
MANDERA EAST,Urban,64,38,25,63,Mandera,NORTH EASTERN,5888
MANDERA EAST,Urban,65,135,154,289,Mandera,NORTH EASTERN,5889
MANDERA EAST,Urban,66,29,20,49,Mandera,NORTH EASTERN,5890
MANDERA EAST,Urban,67,43,34,77,Mandera,NORTH EASTERN,5891
MANDERA EAST,Urban,68,39,33,72,Mandera,NORTH EASTERN,5892
MANDERA EAST,Urban,69,27,12,39,Mandera,NORTH EASTERN,5893
MANDERA EAST,Urban,70,319,377,696,Mandera,NORTH EASTERN,5894
MANDERA EAST,Urban,71,20,12,32,Mandera,NORTH EASTERN,5895
MANDERA EAST,Urban,72,37,33,70,Mandera,NORTH EASTERN,5896
MANDERA EAST,Urban,73,40,20,60,Mandera,NORTH EASTERN,5897
MANDERA EAST,Urban,74,30,13,43,Mandera,NORTH EASTERN,5898
MANDERA EAST,Urban,75,96,79,175,Mandera,NORTH EASTERN,5899
MANDERA EAST,Urban,76,19,26,45,Mandera,NORTH EASTERN,5900
MANDERA EAST,Urban,77,20,14,34,Mandera,NORTH EASTERN,5901
MANDERA EAST,Urban,78,31,28,59,Mandera,NORTH EASTERN,5902
MANDERA EAST,Urban,79,11,9,20,Mandera,NORTH EASTERN,5903
MANDERA EAST,Urban,80+,435,516,951,Mandera,NORTH EASTERN,5904
MANDERA EAST,Urban,Age NS,16,15,31,Mandera,NORTH EASTERN,5905
MANDERA WEST,Urban,0,152,148,300,Mandera,NORTH EASTERN,5906
MANDERA WEST,Urban,1,185,215,400,Mandera,NORTH EASTERN,5907
MANDERA WEST,Urban,2,448,427,875,Mandera,NORTH EASTERN,5908
MANDERA WEST,Urban,3,272,273,545,Mandera,NORTH EASTERN,5909
MANDERA WEST,Urban,4,516,483,999,Mandera,NORTH EASTERN,5910
MANDERA WEST,Urban,5,341,319,660,Mandera,NORTH EASTERN,5911
MANDERA WEST,Urban,6,612,624,1236,Mandera,NORTH EASTERN,5912
MANDERA WEST,Urban,7,344,323,667,Mandera,NORTH EASTERN,5913
MANDERA WEST,Urban,8,733,606,1339,Mandera,NORTH EASTERN,5914
MANDERA WEST,Urban,9,370,334,704,Mandera,NORTH EASTERN,5915
MANDERA WEST,Urban,10,789,683,1472,Mandera,NORTH EASTERN,5916
MANDERA WEST,Urban,11,249,248,497,Mandera,NORTH EASTERN,5917
MANDERA WEST,Urban,12,709,583,1292,Mandera,NORTH EASTERN,5918
MANDERA WEST,Urban,13,308,285,593,Mandera,NORTH EASTERN,5919
MANDERA WEST,Urban,14,637,485,1122,Mandera,NORTH EASTERN,5920
MANDERA WEST,Urban,15,450,309,759,Mandera,NORTH EASTERN,5921
MANDERA WEST,Urban,16,600,386,986,Mandera,NORTH EASTERN,5922
MANDERA WEST,Urban,17,284,182,466,Mandera,NORTH EASTERN,5923
MANDERA WEST,Urban,18,688,371,1059,Mandera,NORTH EASTERN,5924
MANDERA WEST,Urban,19,221,108,329,Mandera,NORTH EASTERN,5925
MANDERA WEST,Urban,20,601,318,919,Mandera,NORTH EASTERN,5926
MANDERA WEST,Urban,21,132,66,198,Mandera,NORTH EASTERN,5927
MANDERA WEST,Urban,22,227,141,368,Mandera,NORTH EASTERN,5928
MANDERA WEST,Urban,23,116,80,196,Mandera,NORTH EASTERN,5929
MANDERA WEST,Urban,24,132,112,244,Mandera,NORTH EASTERN,5930
MANDERA WEST,Urban,25,179,168,347,Mandera,NORTH EASTERN,5931
MANDERA WEST,Urban,26,106,112,218,Mandera,NORTH EASTERN,5932
MANDERA WEST,Urban,27,55,60,115,Mandera,NORTH EASTERN,5933
MANDERA WEST,Urban,28,147,186,333,Mandera,NORTH EASTERN,5934
MANDERA WEST,Urban,29,46,63,109,Mandera,NORTH EASTERN,5935
MANDERA WEST,Urban,30,224,256,480,Mandera,NORTH EASTERN,5936
MANDERA WEST,Urban,31,27,42,69,Mandera,NORTH EASTERN,5937
MANDERA WEST,Urban,32,101,118,219,Mandera,NORTH EASTERN,5938
MANDERA WEST,Urban,33,39,65,104,Mandera,NORTH EASTERN,5939
MANDERA WEST,Urban,34,44,62,106,Mandera,NORTH EASTERN,5940
MANDERA WEST,Urban,35,136,196,332,Mandera,NORTH EASTERN,5941
MANDERA WEST,Urban,36,72,89,161,Mandera,NORTH EASTERN,5942
MANDERA WEST,Urban,37,46,64,110,Mandera,NORTH EASTERN,5943
MANDERA WEST,Urban,38,79,127,206,Mandera,NORTH EASTERN,5944
MANDERA WEST,Urban,39,48,54,102,Mandera,NORTH EASTERN,5945
MANDERA WEST,Urban,40,253,230,483,Mandera,NORTH EASTERN,5946
MANDERA WEST,Urban,41,41,31,72,Mandera,NORTH EASTERN,5947
MANDERA WEST,Urban,42,88,73,161,Mandera,NORTH EASTERN,5948
MANDERA WEST,Urban,43,46,36,82,Mandera,NORTH EASTERN,5949
MANDERA WEST,Urban,44,28,28,56,Mandera,NORTH EASTERN,5950
MANDERA WEST,Urban,45,128,124,252,Mandera,NORTH EASTERN,5951
MANDERA WEST,Urban,46,51,39,90,Mandera,NORTH EASTERN,5952
MANDERA WEST,Urban,47,35,17,52,Mandera,NORTH EASTERN,5953
MANDERA WEST,Urban,48,86,74,160,Mandera,NORTH EASTERN,5954
MANDERA WEST,Urban,49,33,26,59,Mandera,NORTH EASTERN,5955
MANDERA WEST,Urban,50,189,83,272,Mandera,NORTH EASTERN,5956
MANDERA WEST,Urban,51,19,12,31,Mandera,NORTH EASTERN,5957
MANDERA WEST,Urban,52,40,28,68,Mandera,NORTH EASTERN,5958
MANDERA WEST,Urban,53,26,16,42,Mandera,NORTH EASTERN,5959
MANDERA WEST,Urban,54,40,14,54,Mandera,NORTH EASTERN,5960
MANDERA WEST,Urban,55,64,48,112,Mandera,NORTH EASTERN,5961
MANDERA WEST,Urban,56,40,21,61,Mandera,NORTH EASTERN,5962
MANDERA WEST,Urban,57,20,15,35,Mandera,NORTH EASTERN,5963
MANDERA WEST,Urban,58,28,5,33,Mandera,NORTH EASTERN,5964
MANDERA WEST,Urban,59,13,10,23,Mandera,NORTH EASTERN,5965
MANDERA WEST,Urban,60,119,53,172,Mandera,NORTH EASTERN,5966
MANDERA WEST,Urban,61,12,5,17,Mandera,NORTH EASTERN,5967
MANDERA WEST,Urban,62,18,11,29,Mandera,NORTH EASTERN,5968
MANDERA WEST,Urban,63,15,3,18,Mandera,NORTH EASTERN,5969
MANDERA WEST,Urban,64,13,3,16,Mandera,NORTH EASTERN,5970
MANDERA WEST,Urban,65,32,19,51,Mandera,NORTH EASTERN,5971
MANDERA WEST,Urban,66,2,3,5,Mandera,NORTH EASTERN,5972
MANDERA WEST,Urban,67,7,5,12,Mandera,NORTH EASTERN,5973
MANDERA WEST,Urban,68,11,6,17,Mandera,NORTH EASTERN,5974
MANDERA WEST,Urban,69,9,4,13,Mandera,NORTH EASTERN,5975
MANDERA WEST,Urban,70,66,42,108,Mandera,NORTH EASTERN,5976
MANDERA WEST,Urban,71,4,4,8,Mandera,NORTH EASTERN,5977
MANDERA WEST,Urban,72,7,7,14,Mandera,NORTH EASTERN,5978
MANDERA WEST,Urban,73,3,3,6,Mandera,NORTH EASTERN,5979
MANDERA WEST,Urban,74,5,5,10,Mandera,NORTH EASTERN,5980
MANDERA WEST,Urban,75,16,16,32,Mandera,NORTH EASTERN,5981
MANDERA WEST,Urban,76,5,1,6,Mandera,NORTH EASTERN,5982
MANDERA WEST,Urban,77,3,1,4,Mandera,NORTH EASTERN,5983
MANDERA WEST,Urban,78,9,1,10,Mandera,NORTH EASTERN,5984
MANDERA WEST,Urban,79,5,3,8,Mandera,NORTH EASTERN,5985
MANDERA WEST,Urban,80+,82,48,130,Mandera,NORTH EASTERN,5986
MANDERA WEST,Urban,Age NS,3,2,5,Mandera,NORTH EASTERN,5987
SIAYA,Urban,0,776,769,1545,Siaya,NYANZA,5988
SIAYA,Urban,1,640,630,1270,Siaya,NYANZA,5989
SIAYA,Urban,2,701,694,1395,Siaya,NYANZA,5990
SIAYA,Urban,3,693,650,1343,Siaya,NYANZA,5991
SIAYA,Urban,4,601,626,1227,Siaya,NYANZA,5992
SIAYA,Urban,5,555,619,1174,Siaya,NYANZA,5993
SIAYA,Urban,6,505,556,1061,Siaya,NYANZA,5994
SIAYA,Urban,7,541,487,1028,Siaya,NYANZA,5995
SIAYA,Urban,8,456,562,1018,Siaya,NYANZA,5996
SIAYA,Urban,9,477,515,992,Siaya,NYANZA,5997
SIAYA,Urban,10,601,511,1112,Siaya,NYANZA,5998
SIAYA,Urban,11,466,502,968,Siaya,NYANZA,5999
SIAYA,Urban,12,618,639,1257,Siaya,NYANZA,6000
SIAYA,Urban,13,579,606,1185,Siaya,NYANZA,6001
SIAYA,Urban,14,497,536,1033,Siaya,NYANZA,6002
SIAYA,Urban,15,478,538,1016,Siaya,NYANZA,6003
SIAYA,Urban,16,431,530,961,Siaya,NYANZA,6004
SIAYA,Urban,17,496,528,1024,Siaya,NYANZA,6005
SIAYA,Urban,18,471,524,995,Siaya,NYANZA,6006
SIAYA,Urban,19,390,487,877,Siaya,NYANZA,6007
SIAYA,Urban,20,446,697,1143,Siaya,NYANZA,6008
SIAYA,Urban,21,353,480,833,Siaya,NYANZA,6009
SIAYA,Urban,22,387,526,913,Siaya,NYANZA,6010
SIAYA,Urban,23,353,467,820,Siaya,NYANZA,6011
SIAYA,Urban,24,378,460,838,Siaya,NYANZA,6012
SIAYA,Urban,25,469,510,979,Siaya,NYANZA,6013
SIAYA,Urban,26,331,409,740,Siaya,NYANZA,6014
SIAYA,Urban,27,375,386,761,Siaya,NYANZA,6015
SIAYA,Urban,28,276,367,643,Siaya,NYANZA,6016
SIAYA,Urban,29,280,281,561,Siaya,NYANZA,6017
SIAYA,Urban,30,452,458,910,Siaya,NYANZA,6018
SIAYA,Urban,31,246,178,424,Siaya,NYANZA,6019
SIAYA,Urban,32,272,290,562,Siaya,NYANZA,6020
SIAYA,Urban,35,313,291,604,Siaya,NYANZA,6021
SIAYA,Urban,36,169,155,324,Siaya,NYANZA,6022
SIAYA,Urban,37,171,172,343,Siaya,NYANZA,6023
SIAYA,Urban,38,153,197,350,Siaya,NYANZA,6024
SIAYA,Urban,39,147,139,286,Siaya,NYANZA,6025
SIAYA,Urban,40,246,281,527,Siaya,NYANZA,6026
SIAYA,Urban,41,107,116,223,Siaya,NYANZA,6027
SIAYA,Urban,42,145,158,303,Siaya,NYANZA,6028
SIAYA,Urban,43,113,97,210,Siaya,NYANZA,6029
SIAYA,Urban,44,121,96,217,Siaya,NYANZA,6030
SIAYA,Urban,45,180,177,357,Siaya,NYANZA,6031
SIAYA,Urban,46,121,141,262,Siaya,NYANZA,6032
SIAYA,Urban,47,95,126,221,Siaya,NYANZA,6033
SIAYA,Urban,48,80,96,176,Siaya,NYANZA,6034
SIAYA,Urban,49,101,93,194,Siaya,NYANZA,6035
SIAYA,Urban,50,132,152,284,Siaya,NYANZA,6036
SIAYA,Urban,51,67,66,133,Siaya,NYANZA,6037
SIAYA,Urban,52,80,53,133,Siaya,NYANZA,6038
SIAYA,Urban,53,68,62,130,Siaya,NYANZA,6039
SIAYA,Urban,54,66,75,141,Siaya,NYANZA,6040
SIAYA,Urban,55,79,80,159,Siaya,NYANZA,6041
SIAYA,Urban,56,59,70,129,Siaya,NYANZA,6042
SIAYA,Urban,57,58,69,127,Siaya,NYANZA,6043
SIAYA,Urban,58,32,39,71,Siaya,NYANZA,6044
SIAYA,Urban,59,40,46,86,Siaya,NYANZA,6045
SIAYA,Urban,60,79,96,175,Siaya,NYANZA,6046
SIAYA,Urban,61,28,35,63,Siaya,NYANZA,6047
SIAYA,Urban,62,27,33,60,Siaya,NYANZA,6048
SIAYA,Urban,63,30,29,59,Siaya,NYANZA,6049
SIAYA,Urban,64,30,21,51,Siaya,NYANZA,6050
SIAYA,Urban,65,38,44,82,Siaya,NYANZA,6051
SIAYA,Urban,66,20,21,41,Siaya,NYANZA,6052
SIAYA,Urban,67,18,22,40,Siaya,NYANZA,6053
SIAYA,Urban,68,13,15,28,Siaya,NYANZA,6054
SIAYA,Urban,69,18,20,38,Siaya,NYANZA,6055
SIAYA,Urban,70,34,46,80,Siaya,NYANZA,6056
SIAYA,Urban,71,19,26,45,Siaya,NYANZA,6057
SIAYA,Urban,72,12,15,27,Siaya,NYANZA,6058
SIAYA,Urban,73,9,10,19,Siaya,NYANZA,6059
SIAYA,Urban,74,17,21,38,Siaya,NYANZA,6060
SIAYA,Urban,75,23,23,46,Siaya,NYANZA,6061
SIAYA,Urban,76,8,9,17,Siaya,NYANZA,6062
SIAYA,Urban,77,8,12,20,Siaya,NYANZA,6063
SIAYA,Urban,78,15,8,23,Siaya,NYANZA,6064
SIAYA,Urban,79,17,20,37,Siaya,NYANZA,6065
SIAYA,Urban,80+,67,124,191,Siaya,NYANZA,6066
SIAYA,Urban,Age NS,6,5,11,Siaya,NYANZA,6067
BONDO,Urban,0,922,882,1804,Siaya,NYANZA,6068
BONDO,Urban,1,800,791,1591,Siaya,NYANZA,6069
BONDO,Urban,2,850,867,1717,Siaya,NYANZA,6070
BONDO,Urban,3,793,885,1678,Siaya,NYANZA,6071
BONDO,Urban,4,766,814,1580,Siaya,NYANZA,6072
BONDO,Urban,5,738,733,1471,Siaya,NYANZA,6073
BONDO,Urban,6,686,747,1433,Siaya,NYANZA,6074
BONDO,Urban,7,610,628,1238,Siaya,NYANZA,6075
BONDO,Urban,8,561,642,1203,Siaya,NYANZA,6076
BONDO,Urban,9,592,612,1204,Siaya,NYANZA,6077
BONDO,Urban,10,644,671,1315,Siaya,NYANZA,6078
BONDO,Urban,11,500,475,975,Siaya,NYANZA,6079
BONDO,Urban,12,628,590,1218,Siaya,NYANZA,6080
BONDO,Urban,13,578,571,1149,Siaya,NYANZA,6081
BONDO,Urban,14,518,542,1060,Siaya,NYANZA,6082
BONDO,Urban,15,541,580,1121,Siaya,NYANZA,6083
BONDO,Urban,16,500,575,1075,Siaya,NYANZA,6084
BONDO,Urban,17,534,604,1138,Siaya,NYANZA,6085
BONDO,Urban,18,497,623,1120,Siaya,NYANZA,6086
BONDO,Urban,19,436,598,1034,Siaya,NYANZA,6087
BONDO,Urban,20,526,817,1343,Siaya,NYANZA,6088
BONDO,Urban,21,382,576,958,Siaya,NYANZA,6089
BONDO,Urban,22,475,614,1089,Siaya,NYANZA,6090
BONDO,Urban,23,499,595,1094,Siaya,NYANZA,6091
BONDO,Urban,24,472,546,1018,Siaya,NYANZA,6092
BONDO,Urban,25,612,618,1230,Siaya,NYANZA,6093
BONDO,Urban,26,425,443,868,Siaya,NYANZA,6094
BONDO,Urban,27,440,439,879,Siaya,NYANZA,6095
BONDO,Urban,28,393,395,788,Siaya,NYANZA,6096
BONDO,Urban,29,345,328,673,Siaya,NYANZA,6097
BONDO,Urban,30,550,478,1028,Siaya,NYANZA,6098
BONDO,Urban,31,281,200,481,Siaya,NYANZA,6099
BONDO,Urban,32,309,300,609,Siaya,NYANZA,6100
BONDO,Urban,33,199,178,377,Siaya,NYANZA,6101
BONDO,Urban,34,250,211,461,Siaya,NYANZA,6102
BONDO,Urban,35,365,333,698,Siaya,NYANZA,6103
BONDO,Urban,36,180,187,367,Siaya,NYANZA,6104
BONDO,Urban,37,199,168,367,Siaya,NYANZA,6105
BONDO,Urban,38,170,187,357,Siaya,NYANZA,6106
BONDO,Urban,39,157,131,288,Siaya,NYANZA,6107
BONDO,Urban,40,251,332,583,Siaya,NYANZA,6108
BONDO,Urban,41,119,114,233,Siaya,NYANZA,6109
BONDO,Urban,42,140,142,282,Siaya,NYANZA,6110
BONDO,Urban,43,104,113,217,Siaya,NYANZA,6111
BONDO,Urban,44,93,91,184,Siaya,NYANZA,6112
BONDO,Urban,45,154,187,341,Siaya,NYANZA,6113
BONDO,Urban,46,133,130,263,Siaya,NYANZA,6114
BONDO,Urban,47,116,114,230,Siaya,NYANZA,6115
BONDO,Urban,48,87,105,192,Siaya,NYANZA,6116
BONDO,Urban,49,113,96,209,Siaya,NYANZA,6117
BONDO,Urban,50,119,170,289,Siaya,NYANZA,6118
BONDO,Urban,51,76,90,166,Siaya,NYANZA,6119
BONDO,Urban,52,83,82,165,Siaya,NYANZA,6120
BONDO,Urban,53,59,78,137,Siaya,NYANZA,6121
BONDO,Urban,54,63,67,130,Siaya,NYANZA,6122
BONDO,Urban,55,78,99,177,Siaya,NYANZA,6123
BONDO,Urban,56,71,93,164,Siaya,NYANZA,6124
BONDO,Urban,57,80,86,166,Siaya,NYANZA,6125
BONDO,Urban,58,37,38,75,Siaya,NYANZA,6126
BONDO,Urban,59,57,71,128,Siaya,NYANZA,6127
BONDO,Urban,60,95,108,203,Siaya,NYANZA,6128
BONDO,Urban,61,50,59,109,Siaya,NYANZA,6129
BONDO,Urban,62,34,39,73,Siaya,NYANZA,6130
BONDO,Urban,63,34,38,72,Siaya,NYANZA,6131
BONDO,Urban,64,29,48,77,Siaya,NYANZA,6132
BONDO,Urban,65,39,52,91,Siaya,NYANZA,6133
BONDO,Urban,66,31,33,64,Siaya,NYANZA,6134
BONDO,Urban,67,29,54,83,Siaya,NYANZA,6135
BONDO,Urban,68,24,21,45,Siaya,NYANZA,6136
BONDO,Urban,69,21,29,50,Siaya,NYANZA,6137
BONDO,Urban,70,54,79,133,Siaya,NYANZA,6138
BONDO,Urban,71,16,19,35,Siaya,NYANZA,6139
BONDO,Urban,72,18,30,48,Siaya,NYANZA,6140
BONDO,Urban,73,19,16,35,Siaya,NYANZA,6141
BONDO,Urban,74,11,23,34,Siaya,NYANZA,6142
BONDO,Urban,75,18,29,47,Siaya,NYANZA,6143
BONDO,Urban,76,14,16,30,Siaya,NYANZA,6144
BONDO,Urban,77,24,33,57,Siaya,NYANZA,6145
BONDO,Urban,78,5,25,30,Siaya,NYANZA,6146
BONDO,Urban,79,9,32,41,Siaya,NYANZA,6147
BONDO,Urban,80+,109,150,259,Siaya,NYANZA,6148
BONDO,Urban,Age NS,6,6,12,Siaya,NYANZA,6149
RARIEDA,Urban,0,65,44,109,Siaya,NYANZA,6150
RARIEDA,Urban,1,59,47,106,Siaya,NYANZA,6151
RARIEDA,Urban,2,47,44,91,Siaya,NYANZA,6152
RARIEDA,Urban,3,44,73,117,Siaya,NYANZA,6153
RARIEDA,Urban,4,48,62,110,Siaya,NYANZA,6154
RARIEDA,Urban,5,43,42,85,Siaya,NYANZA,6155
RARIEDA,Urban,6,37,43,80,Siaya,NYANZA,6156
RARIEDA,Urban,7,35,44,79,Siaya,NYANZA,6157
RARIEDA,Urban,8,31,34,65,Siaya,NYANZA,6158
RARIEDA,Urban,9,31,42,73,Siaya,NYANZA,6159
RARIEDA,Urban,10,44,53,97,Siaya,NYANZA,6160
RARIEDA,Urban,11,25,28,53,Siaya,NYANZA,6161
RARIEDA,Urban,12,41,39,80,Siaya,NYANZA,6162
RARIEDA,Urban,13,39,37,76,Siaya,NYANZA,6163
RARIEDA,Urban,14,41,26,67,Siaya,NYANZA,6164
RARIEDA,Urban,15,31,25,56,Siaya,NYANZA,6165
RARIEDA,Urban,16,25,34,59,Siaya,NYANZA,6166
RARIEDA,Urban,17,44,46,90,Siaya,NYANZA,6167
RARIEDA,Urban,18,30,36,66,Siaya,NYANZA,6168
RARIEDA,Urban,19,29,43,72,Siaya,NYANZA,6169
RARIEDA,Urban,20,29,65,94,Siaya,NYANZA,6170
RARIEDA,Urban,21,18,36,54,Siaya,NYANZA,6171
RARIEDA,Urban,22,26,42,68,Siaya,NYANZA,6172
RARIEDA,Urban,23,36,50,86,Siaya,NYANZA,6173
RARIEDA,Urban,24,30,37,67,Siaya,NYANZA,6174
RARIEDA,Urban,25,49,41,90,Siaya,NYANZA,6175
RARIEDA,Urban,26,40,25,65,Siaya,NYANZA,6176
RARIEDA,Urban,27,35,25,60,Siaya,NYANZA,6177
RARIEDA,Urban,28,26,28,54,Siaya,NYANZA,6178
RARIEDA,Urban,29,21,19,40,Siaya,NYANZA,6179
RARIEDA,Urban,30,28,35,63,Siaya,NYANZA,6180
RARIEDA,Urban,31,23,16,39,Siaya,NYANZA,6181
RARIEDA,Urban,32,15,16,31,Siaya,NYANZA,6182
RARIEDA,Urban,33,20,12,32,Siaya,NYANZA,6183
RARIEDA,Urban,34,12,14,26,Siaya,NYANZA,6184
RARIEDA,Urban,35,20,24,44,Siaya,NYANZA,6185
RARIEDA,Urban,36,9,8,17,Siaya,NYANZA,6186
RARIEDA,Urban,37,16,6,22,Siaya,NYANZA,6187
RARIEDA,Urban,38,10,20,30,Siaya,NYANZA,6188
RARIEDA,Urban,39,8,8,16,Siaya,NYANZA,6189
RARIEDA,Urban,40,20,18,38,Siaya,NYANZA,6190
RARIEDA,Urban,41,7,5,12,Siaya,NYANZA,6191
RARIEDA,Urban,42,9,11,20,Siaya,NYANZA,6192
RARIEDA,Urban,43,11,13,24,Siaya,NYANZA,6193
RARIEDA,Urban,44,7,5,12,Siaya,NYANZA,6194
RARIEDA,Urban,45,11,13,24,Siaya,NYANZA,6195
RARIEDA,Urban,46,4,6,10,Siaya,NYANZA,6196
RARIEDA,Urban,47,5,3,8,Siaya,NYANZA,6197
RARIEDA,Urban,48,12,7,19,Siaya,NYANZA,6198
RARIEDA,Urban,49,8,10,18,Siaya,NYANZA,6199
RARIEDA,Urban,50,9,11,20,Siaya,NYANZA,6200
RARIEDA,Urban,51,4,3,7,Siaya,NYANZA,6201
RARIEDA,Urban,52,4,3,7,Siaya,NYANZA,6202
RARIEDA,Urban,53,2,4,6,Siaya,NYANZA,6203
RARIEDA,Urban,54,12,7,19,Siaya,NYANZA,6204
RARIEDA,Urban,55,7,5,12,Siaya,NYANZA,6205
RARIEDA,Urban,56,5,4,9,Siaya,NYANZA,6206
RARIEDA,Urban,57,2,3,5,Siaya,NYANZA,6207
RARIEDA,Urban,58,0,0,0,Siaya,NYANZA,6208
RARIEDA,Urban,59,2,4,6,Siaya,NYANZA,6209
RARIEDA,Urban,60,9,8,17,Siaya,NYANZA,6210
RARIEDA,Urban,61,3,2,5,Siaya,NYANZA,6211
RARIEDA,Urban,62,5,2,7,Siaya,NYANZA,6212
RARIEDA,Urban,63,2,5,7,Siaya,NYANZA,6213
RARIEDA,Urban,64,1,3,4,Siaya,NYANZA,6214
RARIEDA,Urban,65,3,1,4,Siaya,NYANZA,6215
RARIEDA,Urban,66,2,4,6,Siaya,NYANZA,6216
RARIEDA,Urban,67,1,0,1,Siaya,NYANZA,6217
RARIEDA,Urban,68,2,0,2,Siaya,NYANZA,6218
RARIEDA,Urban,69,2,2,4,Siaya,NYANZA,6219
RARIEDA,Urban,70,3,4,7,Siaya,NYANZA,6220
RARIEDA,Urban,71,1,3,4,Siaya,NYANZA,6221
RARIEDA,Urban,72,4,3,7,Siaya,NYANZA,6222
RARIEDA,Urban,73,2,1,3,Siaya,NYANZA,6223
RARIEDA,Urban,74,1,2,3,Siaya,NYANZA,6224
RARIEDA,Urban,75,2,0,2,Siaya,NYANZA,6225
RARIEDA,Urban,76,0,2,2,Siaya,NYANZA,6226
RARIEDA,Urban,77,0,0,0,Siaya,NYANZA,6227
RARIEDA,Urban,78,1,1,2,Siaya,NYANZA,6228
RARIEDA,Urban,79,1,3,4,Siaya,NYANZA,6229
RARIEDA,Urban,80+,5,12,17,Siaya,NYANZA,6230
RARIEDA,Urban,Age NS,2,1,3,Siaya,NYANZA,6231
KISUMU EAST,Urban,0,7020,6708,13728,Kisumu,NYANZA,6232
KISUMU EAST,Urban,1,5798,5754,11552,Kisumu,NYANZA,6233
KISUMU EAST,Urban,2,6307,6319,12626,Kisumu,NYANZA,6234
KISUMU EAST,Urban,3,5846,6209,12055,Kisumu,NYANZA,6235
KISUMU EAST,Urban,4,5510,5707,11217,Kisumu,NYANZA,6236
KISUMU EAST,Urban,5,5415,5339,10754,Kisumu,NYANZA,6237
KISUMU EAST,Urban,6,4882,5028,9910,Kisumu,NYANZA,6238
KISUMU EAST,Urban,7,4698,4706,9404,Kisumu,NYANZA,6239
KISUMU EAST,Urban,8,4443,4625,9068,Kisumu,NYANZA,6240
KISUMU EAST,Urban,9,4672,4992,9664,Kisumu,NYANZA,6241
KISUMU EAST,Urban,10,4932,5101,10033,Kisumu,NYANZA,6242
KISUMU EAST,Urban,11,3779,4154,7933,Kisumu,NYANZA,6243
KISUMU EAST,Urban,12,4813,5002,9815,Kisumu,NYANZA,6244
KISUMU EAST,Urban,13,4352,4633,8985,Kisumu,NYANZA,6245
KISUMU EAST,Urban,14,4018,4254,8272,Kisumu,NYANZA,6246
KISUMU EAST,Urban,15,3971,4408,8379,Kisumu,NYANZA,6247
KISUMU EAST,Urban,16,3815,4600,8415,Kisumu,NYANZA,6248
KISUMU EAST,Urban,17,4366,4819,9185,Kisumu,NYANZA,6249
KISUMU EAST,Urban,18,4581,5341,9922,Kisumu,NYANZA,6250
KISUMU EAST,Urban,19,3798,4874,8672,Kisumu,NYANZA,6251
KISUMU EAST,Urban,20,5165,7378,12543,Kisumu,NYANZA,6252
KISUMU EAST,Urban,21,3892,4654,8546,Kisumu,NYANZA,6253
KISUMU EAST,Urban,22,4738,5839,10577,Kisumu,NYANZA,6254
KISUMU EAST,Urban,23,4642,5286,9928,Kisumu,NYANZA,6255
KISUMU EAST,Urban,24,4757,5068,9825,Kisumu,NYANZA,6256
KISUMU EAST,Urban,25,5772,5643,11415,Kisumu,NYANZA,6257
KISUMU EAST,Urban,26,4302,4103,8405,Kisumu,NYANZA,6258
KISUMU EAST,Urban,27,4550,3799,8349,Kisumu,NYANZA,6259
KISUMU EAST,Urban,28,4148,3780,7928,Kisumu,NYANZA,6260
KISUMU EAST,Urban,29,3463,2838,6301,Kisumu,NYANZA,6261
KISUMU EAST,Urban,30,5373,4634,10007,Kisumu,NYANZA,6262
KISUMU EAST,Urban,31,2426,1708,4134,Kisumu,NYANZA,6263
KISUMU EAST,Urban,32,3523,2714,6237,Kisumu,NYANZA,6264
KISUMU EAST,Urban,33,2100,1609,3709,Kisumu,NYANZA,6265
KISUMU EAST,Urban,34,2283,1733,4016,Kisumu,NYANZA,6266
KISUMU EAST,Urban,35,3774,2819,6593,Kisumu,NYANZA,6267
KISUMU EAST,Urban,36,1917,1508,3425,Kisumu,NYANZA,6268
KISUMU EAST,Urban,37,1823,1383,3206,Kisumu,NYANZA,6269
KISUMU EAST,Urban,38,1770,1686,3456,Kisumu,NYANZA,6270
KISUMU EAST,Urban,39,1431,1217,2648,Kisumu,NYANZA,6271
KISUMU EAST,Urban,40,2783,2638,5421,Kisumu,NYANZA,6272
KISUMU EAST,Urban,41,1060,860,1920,Kisumu,NYANZA,6273
KISUMU EAST,Urban,42,1581,1210,2791,Kisumu,NYANZA,6274
KISUMU EAST,Urban,43,1034,873,1907,Kisumu,NYANZA,6275
KISUMU EAST,Urban,44,913,712,1625,Kisumu,NYANZA,6276
KISUMU EAST,Urban,45,1790,1729,3519,Kisumu,NYANZA,6277
KISUMU EAST,Urban,46,1136,994,2130,Kisumu,NYANZA,6278
KISUMU EAST,Urban,47,1044,914,1958,Kisumu,NYANZA,6279
KISUMU EAST,Urban,48,937,893,1830,Kisumu,NYANZA,6280
KISUMU EAST,Urban,49,964,760,1724,Kisumu,NYANZA,6281
KISUMU EAST,Urban,50,1408,1367,2775,Kisumu,NYANZA,6282
KISUMU EAST,Urban,51,727,545,1272,Kisumu,NYANZA,6283
KISUMU EAST,Urban,52,840,620,1460,Kisumu,NYANZA,6284
KISUMU EAST,Urban,53,683,546,1229,Kisumu,NYANZA,6285
KISUMU EAST,Urban,54,650,560,1210,Kisumu,NYANZA,6286
KISUMU EAST,Urban,55,828,663,1491,Kisumu,NYANZA,6287
KISUMU EAST,Urban,56,643,536,1179,Kisumu,NYANZA,6288
KISUMU EAST,Urban,57,592,551,1143,Kisumu,NYANZA,6289
KISUMU EAST,Urban,58,385,352,737,Kisumu,NYANZA,6290
KISUMU EAST,Urban,59,461,329,790,Kisumu,NYANZA,6291
KISUMU EAST,Urban,60,764,844,1608,Kisumu,NYANZA,6292
KISUMU EAST,Urban,61,369,280,649,Kisumu,NYANZA,6293
KISUMU EAST,Urban,62,342,269,611,Kisumu,NYANZA,6294
KISUMU EAST,Urban,63,278,213,491,Kisumu,NYANZA,6295
KISUMU EAST,Urban,64,269,261,530,Kisumu,NYANZA,6296
KISUMU EAST,Urban,65,364,344,708,Kisumu,NYANZA,6297
KISUMU EAST,Urban,66,190,224,414,Kisumu,NYANZA,6298
KISUMU EAST,Urban,67,238,258,496,Kisumu,NYANZA,6299
KISUMU EAST,Urban,68,127,155,282,Kisumu,NYANZA,6300
KISUMU EAST,Urban,69,160,225,385,Kisumu,NYANZA,6301
KISUMU EAST,Urban,70,346,470,816,Kisumu,NYANZA,6302
KISUMU EAST,Urban,71,135,161,296,Kisumu,NYANZA,6303
KISUMU EAST,Urban,72,151,171,322,Kisumu,NYANZA,6304
KISUMU EAST,Urban,73,142,119,261,Kisumu,NYANZA,6305
KISUMU EAST,Urban,74,132,150,282,Kisumu,NYANZA,6306
KISUMU EAST,Urban,75,157,202,359,Kisumu,NYANZA,6307
KISUMU EAST,Urban,76,92,101,193,Kisumu,NYANZA,6308
KISUMU EAST,Urban,77,95,114,209,Kisumu,NYANZA,6309
KISUMU EAST,Urban,78,77,143,220,Kisumu,NYANZA,6310
KISUMU EAST,Urban,79,76,143,219,Kisumu,NYANZA,6311
KISUMU EAST,Urban,80+,619,1034,1653,Kisumu,NYANZA,6312
KISUMU EAST,Urban,Age NS,138,74,212,Kisumu,NYANZA,6313
KISUMU WEST,Urban,0,107,80,187,Kisumu,NYANZA,6314
KISUMU WEST,Urban,1,75,75,150,Kisumu,NYANZA,6315
KISUMU WEST,Urban,2,73,84,157,Kisumu,NYANZA,6316
KISUMU WEST,Urban,3,92,68,160,Kisumu,NYANZA,6317
KISUMU WEST,Urban,4,69,61,130,Kisumu,NYANZA,6318
KISUMU WEST,Urban,5,81,75,156,Kisumu,NYANZA,6319
KISUMU WEST,Urban,6,53,67,120,Kisumu,NYANZA,6320
KISUMU WEST,Urban,7,51,59,110,Kisumu,NYANZA,6321
KISUMU WEST,Urban,8,71,59,130,Kisumu,NYANZA,6322
KISUMU WEST,Urban,9,58,75,133,Kisumu,NYANZA,6323
KISUMU WEST,Urban,10,66,78,144,Kisumu,NYANZA,6324
KISUMU WEST,Urban,11,58,92,150,Kisumu,NYANZA,6325
KISUMU WEST,Urban,12,79,149,228,Kisumu,NYANZA,6326
KISUMU WEST,Urban,13,71,164,235,Kisumu,NYANZA,6327
KISUMU WEST,Urban,14,60,123,183,Kisumu,NYANZA,6328
KISUMU WEST,Urban,15,52,80,132,Kisumu,NYANZA,6329
KISUMU WEST,Urban,16,55,67,122,Kisumu,NYANZA,6330
KISUMU WEST,Urban,17,62,87,149,Kisumu,NYANZA,6331
KISUMU WEST,Urban,18,81,75,156,Kisumu,NYANZA,6332
KISUMU WEST,Urban,19,156,168,324,Kisumu,NYANZA,6333
KISUMU WEST,Urban,20,260,233,493,Kisumu,NYANZA,6334
KISUMU WEST,Urban,21,225,176,401,Kisumu,NYANZA,6335
KISUMU WEST,Urban,22,213,172,385,Kisumu,NYANZA,6336
KISUMU WEST,Urban,23,159,139,298,Kisumu,NYANZA,6337
KISUMU WEST,Urban,24,116,86,202,Kisumu,NYANZA,6338
KISUMU WEST,Urban,25,85,82,167,Kisumu,NYANZA,6339
KISUMU WEST,Urban,26,70,62,132,Kisumu,NYANZA,6340
KISUMU WEST,Urban,27,59,52,111,Kisumu,NYANZA,6341
KISUMU WEST,Urban,28,46,58,104,Kisumu,NYANZA,6342
KISUMU WEST,Urban,29,49,36,85,Kisumu,NYANZA,6343
KISUMU WEST,Urban,30,80,53,133,Kisumu,NYANZA,6344
KISUMU WEST,Urban,31,36,21,57,Kisumu,NYANZA,6345
KISUMU WEST,Urban,32,29,40,69,Kisumu,NYANZA,6346
KISUMU WEST,Urban,33,21,32,53,Kisumu,NYANZA,6347
KISUMU WEST,Urban,34,23,24,47,Kisumu,NYANZA,6348
KISUMU WEST,Urban,35,51,52,103,Kisumu,NYANZA,6349
KISUMU WEST,Urban,36,31,26,57,Kisumu,NYANZA,6350
KISUMU WEST,Urban,37,21,27,48,Kisumu,NYANZA,6351
KISUMU WEST,Urban,38,23,29,52,Kisumu,NYANZA,6352
KISUMU WEST,Urban,39,23,23,46,Kisumu,NYANZA,6353
KISUMU WEST,Urban,40,32,38,70,Kisumu,NYANZA,6354
KISUMU WEST,Urban,41,16,14,30,Kisumu,NYANZA,6355
KISUMU WEST,Urban,42,15,20,35,Kisumu,NYANZA,6356
KISUMU WEST,Urban,43,22,10,32,Kisumu,NYANZA,6357
KISUMU WEST,Urban,44,17,7,24,Kisumu,NYANZA,6358
KISUMU WEST,Urban,45,24,16,40,Kisumu,NYANZA,6359
KISUMU WEST,Urban,46,28,13,41,Kisumu,NYANZA,6360
KISUMU WEST,Urban,47,21,17,38,Kisumu,NYANZA,6361
KISUMU WEST,Urban,48,13,16,29,Kisumu,NYANZA,6362
KISUMU WEST,Urban,49,15,17,32,Kisumu,NYANZA,6363
KISUMU WEST,Urban,50,20,20,40,Kisumu,NYANZA,6364
KISUMU WEST,Urban,51,10,5,15,Kisumu,NYANZA,6365
KISUMU WEST,Urban,52,7,8,15,Kisumu,NYANZA,6366
KISUMU WEST,Urban,53,6,6,12,Kisumu,NYANZA,6367
KISUMU WEST,Urban,54,10,8,18,Kisumu,NYANZA,6368
KISUMU WEST,Urban,55,9,4,13,Kisumu,NYANZA,6369
KISUMU WEST,Urban,56,13,4,17,Kisumu,NYANZA,6370
KISUMU WEST,Urban,57,5,4,9,Kisumu,NYANZA,6371
KISUMU WEST,Urban,58,4,3,7,Kisumu,NYANZA,6372
KISUMU WEST,Urban,59,2,4,6,Kisumu,NYANZA,6373
KISUMU WEST,Urban,60,7,11,18,Kisumu,NYANZA,6374
KISUMU WEST,Urban,61,4,2,6,Kisumu,NYANZA,6375
KISUMU WEST,Urban,62,7,2,9,Kisumu,NYANZA,6376
KISUMU WEST,Urban,63,0,1,1,Kisumu,NYANZA,6377
KISUMU WEST,Urban,64,2,2,4,Kisumu,NYANZA,6378
KISUMU WEST,Urban,65,2,4,6,Kisumu,NYANZA,6379
KISUMU WEST,Urban,66,2,1,3,Kisumu,NYANZA,6380
KISUMU WEST,Urban,67,1,4,5,Kisumu,NYANZA,6381
KISUMU WEST,Urban,68,0,2,2,Kisumu,NYANZA,6382
KISUMU WEST,Urban,69,1,0,1,Kisumu,NYANZA,6383
KISUMU WEST,Urban,70,2,3,5,Kisumu,NYANZA,6384
KISUMU WEST,Urban,71,1,1,2,Kisumu,NYANZA,6385
KISUMU WEST,Urban,72,4,1,5,Kisumu,NYANZA,6386
KISUMU WEST,Urban,73,0,0,0,Kisumu,NYANZA,6387
KISUMU WEST,Urban,74,1,3,4,Kisumu,NYANZA,6388
KISUMU WEST,Urban,75,2,6,8,Kisumu,NYANZA,6389
KISUMU WEST,Urban,76,0,0,0,Kisumu,NYANZA,6390
KISUMU WEST,Urban,77,2,2,4,Kisumu,NYANZA,6391
KISUMU WEST,Urban,78,2,0,2,Kisumu,NYANZA,6392
KISUMU WEST,Urban,79,1,1,2,Kisumu,NYANZA,6393
KISUMU WEST,Urban,80+,9,12,21,Kisumu,NYANZA,6394
KISUMU WEST,Urban,Age NS,1,1,2,Kisumu,NYANZA,6395
NYANDO,Urban,0,1982,2022,4004,Kisumu,NYANZA,6396
NYANDO,Urban,1,1671,1766,3437,Kisumu,NYANZA,6397
NYANDO,Urban,2,2002,1914,3916,Kisumu,NYANZA,6398
NYANDO,Urban,3,1930,1944,3874,Kisumu,NYANZA,6399
NYANDO,Urban,4,1839,1838,3677,Kisumu,NYANZA,6400
NYANDO,Urban,5,1810,1763,3573,Kisumu,NYANZA,6401
NYANDO,Urban,6,1598,1603,3201,Kisumu,NYANZA,6402
NYANDO,Urban,7,1534,1528,3062,Kisumu,NYANZA,6403
NYANDO,Urban,8,1432,1574,3006,Kisumu,NYANZA,6404
NYANDO,Urban,9,1565,1533,3098,Kisumu,NYANZA,6405
NYANDO,Urban,10,1676,1629,3305,Kisumu,NYANZA,6406
NYANDO,Urban,11,1229,1269,2498,Kisumu,NYANZA,6407
NYANDO,Urban,12,1620,1673,3293,Kisumu,NYANZA,6408
NYANDO,Urban,13,1439,1470,2909,Kisumu,NYANZA,6409
NYANDO,Urban,14,1384,1325,2709,Kisumu,NYANZA,6410
NYANDO,Urban,15,1461,1287,2748,Kisumu,NYANZA,6411
NYANDO,Urban,16,1321,1307,2628,Kisumu,NYANZA,6412
NYANDO,Urban,17,1485,1440,2925,Kisumu,NYANZA,6413
NYANDO,Urban,18,1471,1403,2874,Kisumu,NYANZA,6414
NYANDO,Urban,19,1130,1174,2304,Kisumu,NYANZA,6415
NYANDO,Urban,20,1265,1697,2962,Kisumu,NYANZA,6416
NYANDO,Urban,21,856,991,1847,Kisumu,NYANZA,6417
NYANDO,Urban,22,1025,1237,2262,Kisumu,NYANZA,6418
NYANDO,Urban,23,964,1171,2135,Kisumu,NYANZA,6419
NYANDO,Urban,24,979,1132,2111,Kisumu,NYANZA,6420
NYANDO,Urban,25,1117,1273,2390,Kisumu,NYANZA,6421
NYANDO,Urban,26,880,900,1780,Kisumu,NYANZA,6422
NYANDO,Urban,27,885,843,1728,Kisumu,NYANZA,6423
NYANDO,Urban,28,768,813,1581,Kisumu,NYANZA,6424
NYANDO,Urban,29,702,626,1328,Kisumu,NYANZA,6425
NYANDO,Urban,30,1206,1155,2361,Kisumu,NYANZA,6426
NYANDO,Urban,31,538,453,991,Kisumu,NYANZA,6427
NYANDO,Urban,32,707,666,1373,Kisumu,NYANZA,6428
NYANDO,Urban,33,504,417,921,Kisumu,NYANZA,6429
NYANDO,Urban,34,512,429,941,Kisumu,NYANZA,6430
NYANDO,Urban,35,830,772,1602,Kisumu,NYANZA,6431
NYANDO,Urban,36,473,391,864,Kisumu,NYANZA,6432
NYANDO,Urban,37,456,353,809,Kisumu,NYANZA,6433
NYANDO,Urban,38,364,417,781,Kisumu,NYANZA,6434
NYANDO,Urban,39,327,334,661,Kisumu,NYANZA,6435
NYANDO,Urban,40,670,723,1393,Kisumu,NYANZA,6436
NYANDO,Urban,41,294,266,560,Kisumu,NYANZA,6437
NYANDO,Urban,42,321,326,647,Kisumu,NYANZA,6438
NYANDO,Urban,43,262,243,505,Kisumu,NYANZA,6439
NYANDO,Urban,44,228,201,429,Kisumu,NYANZA,6440
NYANDO,Urban,45,513,514,1027,Kisumu,NYANZA,6441
NYANDO,Urban,46,302,289,591,Kisumu,NYANZA,6442
NYANDO,Urban,47,331,320,651,Kisumu,NYANZA,6443
NYANDO,Urban,48,285,259,544,Kisumu,NYANZA,6444
NYANDO,Urban,49,291,211,502,Kisumu,NYANZA,6445
NYANDO,Urban,50,442,519,961,Kisumu,NYANZA,6446
NYANDO,Urban,51,261,201,462,Kisumu,NYANZA,6447
NYANDO,Urban,52,318,234,552,Kisumu,NYANZA,6448
NYANDO,Urban,53,247,167,414,Kisumu,NYANZA,6449
NYANDO,Urban,54,211,198,409,Kisumu,NYANZA,6450
NYANDO,Urban,55,278,230,508,Kisumu,NYANZA,6451
NYANDO,Urban,56,215,199,414,Kisumu,NYANZA,6452
NYANDO,Urban,57,204,218,422,Kisumu,NYANZA,6453
NYANDO,Urban,58,127,101,228,Kisumu,NYANZA,6454
NYANDO,Urban,59,138,118,256,Kisumu,NYANZA,6455
NYANDO,Urban,60,251,330,581,Kisumu,NYANZA,6456
NYANDO,Urban,61,132,119,251,Kisumu,NYANZA,6457
NYANDO,Urban,62,141,115,256,Kisumu,NYANZA,6458
NYANDO,Urban,63,97,97,194,Kisumu,NYANZA,6459
NYANDO,Urban,64,81,94,175,Kisumu,NYANZA,6460
NYANDO,Urban,65,112,161,273,Kisumu,NYANZA,6461
NYANDO,Urban,66,66,84,150,Kisumu,NYANZA,6462
NYANDO,Urban,67,129,109,238,Kisumu,NYANZA,6463
NYANDO,Urban,68,40,69,109,Kisumu,NYANZA,6464
NYANDO,Urban,69,67,106,173,Kisumu,NYANZA,6465
NYANDO,Urban,70,135,207,342,Kisumu,NYANZA,6466
NYANDO,Urban,71,59,77,136,Kisumu,NYANZA,6467
NYANDO,Urban,72,73,75,148,Kisumu,NYANZA,6468
NYANDO,Urban,73,66,61,127,Kisumu,NYANZA,6469
NYANDO,Urban,74,48,64,112,Kisumu,NYANZA,6470
NYANDO,Urban,75,66,89,155,Kisumu,NYANZA,6471
NYANDO,Urban,76,53,39,92,Kisumu,NYANZA,6472
NYANDO,Urban,77,44,67,111,Kisumu,NYANZA,6473
NYANDO,Urban,78,45,87,132,Kisumu,NYANZA,6474
NYANDO,Urban,79,45,76,121,Kisumu,NYANZA,6475
NYANDO,Urban,80+,289,441,730,Kisumu,NYANZA,6476
NYANDO,Urban,Age NS,42,32,74,Kisumu,NYANZA,6477
HOMABAY,Urban,0,1088,1129,2217,Homa Bay,NYANZA,6478
HOMABAY,Urban,1,949,899,1848,Homa Bay,NYANZA,6479
HOMABAY,Urban,2,1033,1011,2044,Homa Bay,NYANZA,6480
HOMABAY,Urban,3,1028,1012,2040,Homa Bay,NYANZA,6481
HOMABAY,Urban,4,957,921,1878,Homa Bay,NYANZA,6482
HOMABAY,Urban,5,939,948,1887,Homa Bay,NYANZA,6483
HOMABAY,Urban,6,909,869,1778,Homa Bay,NYANZA,6484
HOMABAY,Urban,7,811,834,1645,Homa Bay,NYANZA,6485
HOMABAY,Urban,8,856,839,1695,Homa Bay,NYANZA,6486
HOMABAY,Urban,9,817,873,1690,Homa Bay,NYANZA,6487
HOMABAY,Urban,10,915,1033,1948,Homa Bay,NYANZA,6488
HOMABAY,Urban,11,669,716,1385,Homa Bay,NYANZA,6489
HOMABAY,Urban,12,962,1005,1967,Homa Bay,NYANZA,6490
HOMABAY,Urban,13,807,894,1701,Homa Bay,NYANZA,6491
HOMABAY,Urban,14,756,845,1601,Homa Bay,NYANZA,6492
HOMABAY,Urban,15,768,771,1539,Homa Bay,NYANZA,6493
HOMABAY,Urban,16,690,718,1408,Homa Bay,NYANZA,6494
HOMABAY,Urban,17,736,788,1524,Homa Bay,NYANZA,6495
HOMABAY,Urban,18,737,781,1518,Homa Bay,NYANZA,6496
HOMABAY,Urban,19,507,662,1169,Homa Bay,NYANZA,6497
HOMABAY,Urban,20,647,1065,1712,Homa Bay,NYANZA,6498
HOMABAY,Urban,21,458,604,1062,Homa Bay,NYANZA,6499
HOMABAY,Urban,22,520,717,1237,Homa Bay,NYANZA,6500
HOMABAY,Urban,23,476,652,1128,Homa Bay,NYANZA,6501
HOMABAY,Urban,24,461,641,1102,Homa Bay,NYANZA,6502
HOMABAY,Urban,25,670,749,1419,Homa Bay,NYANZA,6503
HOMABAY,Urban,26,472,525,997,Homa Bay,NYANZA,6504
HOMABAY,Urban,27,445,466,911,Homa Bay,NYANZA,6505
HOMABAY,Urban,28,419,448,867,Homa Bay,NYANZA,6506
HOMABAY,Urban,29,361,299,660,Homa Bay,NYANZA,6507
HOMABAY,Urban,30,609,702,1311,Homa Bay,NYANZA,6508
HOMABAY,Urban,31,246,215,461,Homa Bay,NYANZA,6509
HOMABAY,Urban,32,379,399,778,Homa Bay,NYANZA,6510
HOMABAY,Urban,33,231,218,449,Homa Bay,NYANZA,6511
HOMABAY,Urban,34,226,242,468,Homa Bay,NYANZA,6512
HOMABAY,Urban,35,445,458,903,Homa Bay,NYANZA,6513
HOMABAY,Urban,36,190,228,418,Homa Bay,NYANZA,6514
HOMABAY,Urban,37,193,218,411,Homa Bay,NYANZA,6515
HOMABAY,Urban,38,174,260,434,Homa Bay,NYANZA,6516
HOMABAY,Urban,39,167,162,329,Homa Bay,NYANZA,6517
HOMABAY,Urban,40,319,447,766,Homa Bay,NYANZA,6518
HOMABAY,Urban,41,159,117,276,Homa Bay,NYANZA,6519
HOMABAY,Urban,42,173,192,365,Homa Bay,NYANZA,6520
HOMABAY,Urban,43,113,131,244,Homa Bay,NYANZA,6521
HOMABAY,Urban,44,107,137,244,Homa Bay,NYANZA,6522
HOMABAY,Urban,45,249,307,556,Homa Bay,NYANZA,6523
HOMABAY,Urban,46,144,177,321,Homa Bay,NYANZA,6524
HOMABAY,Urban,47,152,181,333,Homa Bay,NYANZA,6525
HOMABAY,Urban,48,114,134,248,Homa Bay,NYANZA,6526
HOMABAY,Urban,49,122,123,245,Homa Bay,NYANZA,6527
HOMABAY,Urban,50,186,257,443,Homa Bay,NYANZA,6528
HOMABAY,Urban,51,105,87,192,Homa Bay,NYANZA,6529
HOMABAY,Urban,52,115,96,211,Homa Bay,NYANZA,6530
HOMABAY,Urban,53,98,105,203,Homa Bay,NYANZA,6531
HOMABAY,Urban,54,89,93,182,Homa Bay,NYANZA,6532
HOMABAY,Urban,55,126,121,247,Homa Bay,NYANZA,6533
HOMABAY,Urban,56,88,91,179,Homa Bay,NYANZA,6534
HOMABAY,Urban,57,87,93,180,Homa Bay,NYANZA,6535
HOMABAY,Urban,58,49,54,103,Homa Bay,NYANZA,6536
HOMABAY,Urban,59,65,62,127,Homa Bay,NYANZA,6537
HOMABAY,Urban,60,111,139,250,Homa Bay,NYANZA,6538
HOMABAY,Urban,61,75,44,119,Homa Bay,NYANZA,6539
HOMABAY,Urban,62,67,47,114,Homa Bay,NYANZA,6540
HOMABAY,Urban,63,55,56,111,Homa Bay,NYANZA,6541
HOMABAY,Urban,64,63,45,108,Homa Bay,NYANZA,6542
HOMABAY,Urban,65,43,81,124,Homa Bay,NYANZA,6543
HOMABAY,Urban,66,26,30,56,Homa Bay,NYANZA,6544
HOMABAY,Urban,67,41,53,94,Homa Bay,NYANZA,6545
HOMABAY,Urban,68,17,38,55,Homa Bay,NYANZA,6546
HOMABAY,Urban,69,26,36,62,Homa Bay,NYANZA,6547
HOMABAY,Urban,70,61,91,152,Homa Bay,NYANZA,6548
HOMABAY,Urban,71,22,39,61,Homa Bay,NYANZA,6549
HOMABAY,Urban,72,24,24,48,Homa Bay,NYANZA,6550
HOMABAY,Urban,73,20,23,43,Homa Bay,NYANZA,6551
HOMABAY,Urban,74,27,26,53,Homa Bay,NYANZA,6552
HOMABAY,Urban,75,34,50,84,Homa Bay,NYANZA,6553
HOMABAY,Urban,76,17,26,43,Homa Bay,NYANZA,6554
HOMABAY,Urban,77,30,24,54,Homa Bay,NYANZA,6555
HOMABAY,Urban,78,18,32,50,Homa Bay,NYANZA,6556
HOMABAY,Urban,79,16,34,50,Homa Bay,NYANZA,6557
HOMABAY,Urban,80+,137,198,335,Homa Bay,NYANZA,6558
HOMABAY,Urban,Age NS,12,11,23,Homa Bay,NYANZA,6559
SUBA,Urban,0,420,425,845,Homa Bay,NYANZA,6560
SUBA,Urban,1,319,318,637,Homa Bay,NYANZA,6561
SUBA,Urban,2,356,342,698,Homa Bay,NYANZA,6562
SUBA,Urban,3,362,360,722,Homa Bay,NYANZA,6563
SUBA,Urban,4,313,345,658,Homa Bay,NYANZA,6564
SUBA,Urban,5,289,328,617,Homa Bay,NYANZA,6565
SUBA,Urban,6,241,292,533,Homa Bay,NYANZA,6566
SUBA,Urban,7,244,297,541,Homa Bay,NYANZA,6567
SUBA,Urban,8,217,249,466,Homa Bay,NYANZA,6568
SUBA,Urban,9,240,231,471,Homa Bay,NYANZA,6569
SUBA,Urban,10,239,257,496,Homa Bay,NYANZA,6570
SUBA,Urban,11,157,203,360,Homa Bay,NYANZA,6571
SUBA,Urban,12,180,231,411,Homa Bay,NYANZA,6572
SUBA,Urban,13,179,219,398,Homa Bay,NYANZA,6573
SUBA,Urban,14,170,188,358,Homa Bay,NYANZA,6574
SUBA,Urban,15,150,199,349,Homa Bay,NYANZA,6575
SUBA,Urban,16,157,215,372,Homa Bay,NYANZA,6576
SUBA,Urban,17,175,223,398,Homa Bay,NYANZA,6577
SUBA,Urban,18,153,264,417,Homa Bay,NYANZA,6578
SUBA,Urban,19,118,233,351,Homa Bay,NYANZA,6579
SUBA,Urban,20,235,424,659,Homa Bay,NYANZA,6580
SUBA,Urban,21,169,242,411,Homa Bay,NYANZA,6581
SUBA,Urban,22,195,287,482,Homa Bay,NYANZA,6582
SUBA,Urban,23,209,244,453,Homa Bay,NYANZA,6583
SUBA,Urban,24,215,268,483,Homa Bay,NYANZA,6584
SUBA,Urban,25,278,279,557,Homa Bay,NYANZA,6585
SUBA,Urban,26,206,202,408,Homa Bay,NYANZA,6586
SUBA,Urban,27,190,169,359,Homa Bay,NYANZA,6587
SUBA,Urban,28,212,193,405,Homa Bay,NYANZA,6588
SUBA,Urban,29,158,142,300,Homa Bay,NYANZA,6589
SUBA,Urban,30,288,227,515,Homa Bay,NYANZA,6590
SUBA,Urban,31,120,96,216,Homa Bay,NYANZA,6591
SUBA,Urban,32,156,120,276,Homa Bay,NYANZA,6592
SUBA,Urban,33,110,76,186,Homa Bay,NYANZA,6593
SUBA,Urban,34,109,68,177,Homa Bay,NYANZA,6594
SUBA,Urban,35,176,119,295,Homa Bay,NYANZA,6595
SUBA,Urban,36,71,69,140,Homa Bay,NYANZA,6596
SUBA,Urban,37,79,57,136,Homa Bay,NYANZA,6597
SUBA,Urban,38,76,62,138,Homa Bay,NYANZA,6598
SUBA,Urban,39,78,33,111,Homa Bay,NYANZA,6599
SUBA,Urban,40,134,98,232,Homa Bay,NYANZA,6600
SUBA,Urban,41,51,39,90,Homa Bay,NYANZA,6601
SUBA,Urban,42,51,46,97,Homa Bay,NYANZA,6602
SUBA,Urban,43,37,43,80,Homa Bay,NYANZA,6603
SUBA,Urban,44,35,27,62,Homa Bay,NYANZA,6604
SUBA,Urban,45,59,59,118,Homa Bay,NYANZA,6605
SUBA,Urban,46,45,22,67,Homa Bay,NYANZA,6606
SUBA,Urban,47,32,22,54,Homa Bay,NYANZA,6607
SUBA,Urban,48,29,28,57,Homa Bay,NYANZA,6608
SUBA,Urban,49,25,18,43,Homa Bay,NYANZA,6609
SUBA,Urban,50,55,40,95,Homa Bay,NYANZA,6610
SUBA,Urban,51,29,15,44,Homa Bay,NYANZA,6611
SUBA,Urban,52,31,11,42,Homa Bay,NYANZA,6612
SUBA,Urban,53,27,17,44,Homa Bay,NYANZA,6613
SUBA,Urban,54,15,18,33,Homa Bay,NYANZA,6614
SUBA,Urban,55,23,10,33,Homa Bay,NYANZA,6615
SUBA,Urban,56,20,15,35,Homa Bay,NYANZA,6616
SUBA,Urban,57,11,14,25,Homa Bay,NYANZA,6617
SUBA,Urban,58,11,5,16,Homa Bay,NYANZA,6618
SUBA,Urban,59,11,7,18,Homa Bay,NYANZA,6619
SUBA,Urban,60,21,15,36,Homa Bay,NYANZA,6620
SUBA,Urban,61,9,9,18,Homa Bay,NYANZA,6621
SUBA,Urban,62,10,5,15,Homa Bay,NYANZA,6622
SUBA,Urban,63,8,2,10,Homa Bay,NYANZA,6623
SUBA,Urban,64,6,5,11,Homa Bay,NYANZA,6624
SUBA,Urban,65,3,12,15,Homa Bay,NYANZA,6625
SUBA,Urban,66,7,4,11,Homa Bay,NYANZA,6626
SUBA,Urban,67,7,9,16,Homa Bay,NYANZA,6627
SUBA,Urban,68,5,3,8,Homa Bay,NYANZA,6628
SUBA,Urban,69,2,3,5,Homa Bay,NYANZA,6629
SUBA,Urban,70,7,13,20,Homa Bay,NYANZA,6630
SUBA,Urban,71,3,3,6,Homa Bay,NYANZA,6631
SUBA,Urban,72,4,6,10,Homa Bay,NYANZA,6632
SUBA,Urban,73,2,2,4,Homa Bay,NYANZA,6633
SUBA,Urban,74,2,1,3,Homa Bay,NYANZA,6634
SUBA,Urban,75,2,7,9,Homa Bay,NYANZA,6635
SUBA,Urban,76,1,4,5,Homa Bay,NYANZA,6636
SUBA,Urban,77,2,1,3,Homa Bay,NYANZA,6637
SUBA,Urban,78,2,2,4,Homa Bay,NYANZA,6638
SUBA,Urban,79,2,1,3,Homa Bay,NYANZA,6639
SUBA,Urban,80+,5,37,42,Homa Bay,NYANZA,6640
SUBA,Urban,Age NS,3,3,6,Homa Bay,NYANZA,6641
RACHUONYO,Urban,0,1036,1039,2075,Homa Bay,NYANZA,6642
RACHUONYO,Urban,1,926,980,1906,Homa Bay,NYANZA,6643
RACHUONYO,Urban,2,1059,1056,2115,Homa Bay,NYANZA,6644
RACHUONYO,Urban,3,1005,1075,2080,Homa Bay,NYANZA,6645
RACHUONYO,Urban,4,983,1044,2027,Homa Bay,NYANZA,6646
RACHUONYO,Urban,5,984,1030,2014,Homa Bay,NYANZA,6647
RACHUONYO,Urban,6,902,878,1780,Homa Bay,NYANZA,6648
RACHUONYO,Urban,7,867,874,1741,Homa Bay,NYANZA,6649
RACHUONYO,Urban,8,846,861,1707,Homa Bay,NYANZA,6650
RACHUONYO,Urban,9,837,887,1724,Homa Bay,NYANZA,6651
RACHUONYO,Urban,10,955,1009,1964,Homa Bay,NYANZA,6652
RACHUONYO,Urban,11,639,720,1359,Homa Bay,NYANZA,6653
RACHUONYO,Urban,12,978,920,1898,Homa Bay,NYANZA,6654
RACHUONYO,Urban,13,836,887,1723,Homa Bay,NYANZA,6655
RACHUONYO,Urban,14,744,749,1493,Homa Bay,NYANZA,6656
RACHUONYO,Urban,15,838,823,1661,Homa Bay,NYANZA,6657
RACHUONYO,Urban,16,715,727,1442,Homa Bay,NYANZA,6658
RACHUONYO,Urban,17,734,777,1511,Homa Bay,NYANZA,6659
RACHUONYO,Urban,18,762,763,1525,Homa Bay,NYANZA,6660
RACHUONYO,Urban,19,517,614,1131,Homa Bay,NYANZA,6661
RACHUONYO,Urban,20,693,995,1688,Homa Bay,NYANZA,6662
RACHUONYO,Urban,21,407,617,1024,Homa Bay,NYANZA,6663
RACHUONYO,Urban,22,523,733,1256,Homa Bay,NYANZA,6664
RACHUONYO,Urban,23,487,666,1153,Homa Bay,NYANZA,6665
RACHUONYO,Urban,24,442,586,1028,Homa Bay,NYANZA,6666
RACHUONYO,Urban,25,586,750,1336,Homa Bay,NYANZA,6667
RACHUONYO,Urban,26,434,516,950,Homa Bay,NYANZA,6668
RACHUONYO,Urban,27,450,446,896,Homa Bay,NYANZA,6669
RACHUONYO,Urban,28,375,503,878,Homa Bay,NYANZA,6670
RACHUONYO,Urban,29,343,327,670,Homa Bay,NYANZA,6671
RACHUONYO,Urban,30,594,677,1271,Homa Bay,NYANZA,6672
RACHUONYO,Urban,31,259,256,515,Homa Bay,NYANZA,6673
RACHUONYO,Urban,32,355,369,724,Homa Bay,NYANZA,6674
RACHUONYO,Urban,33,240,201,441,Homa Bay,NYANZA,6675
RACHUONYO,Urban,34,225,261,486,Homa Bay,NYANZA,6676
RACHUONYO,Urban,35,396,446,842,Homa Bay,NYANZA,6677
RACHUONYO,Urban,36,208,233,441,Homa Bay,NYANZA,6678
RACHUONYO,Urban,37,201,225,426,Homa Bay,NYANZA,6679
RACHUONYO,Urban,38,186,248,434,Homa Bay,NYANZA,6680
RACHUONYO,Urban,39,142,153,295,Homa Bay,NYANZA,6681
RACHUONYO,Urban,40,327,467,794,Homa Bay,NYANZA,6682
RACHUONYO,Urban,41,134,153,287,Homa Bay,NYANZA,6683
RACHUONYO,Urban,42,130,185,315,Homa Bay,NYANZA,6684
RACHUONYO,Urban,43,110,133,243,Homa Bay,NYANZA,6685
RACHUONYO,Urban,44,121,101,222,Homa Bay,NYANZA,6686
RACHUONYO,Urban,45,227,290,517,Homa Bay,NYANZA,6687
RACHUONYO,Urban,46,151,170,321,Homa Bay,NYANZA,6688
RACHUONYO,Urban,47,135,152,287,Homa Bay,NYANZA,6689
RACHUONYO,Urban,48,96,137,233,Homa Bay,NYANZA,6690
RACHUONYO,Urban,49,134,137,271,Homa Bay,NYANZA,6691
RACHUONYO,Urban,50,187,274,461,Homa Bay,NYANZA,6692
RACHUONYO,Urban,51,103,141,244,Homa Bay,NYANZA,6693
RACHUONYO,Urban,52,121,148,269,Homa Bay,NYANZA,6694
RACHUONYO,Urban,53,98,127,225,Homa Bay,NYANZA,6695
RACHUONYO,Urban,54,85,98,183,Homa Bay,NYANZA,6696
RACHUONYO,Urban,55,129,147,276,Homa Bay,NYANZA,6697
RACHUONYO,Urban,56,113,87,200,Homa Bay,NYANZA,6698
RACHUONYO,Urban,57,108,129,237,Homa Bay,NYANZA,6699
RACHUONYO,Urban,58,86,78,164,Homa Bay,NYANZA,6700
RACHUONYO,Urban,59,71,77,148,Homa Bay,NYANZA,6701
RACHUONYO,Urban,60,175,213,388,Homa Bay,NYANZA,6702
RACHUONYO,Urban,61,72,87,159,Homa Bay,NYANZA,6703
RACHUONYO,Urban,62,65,67,132,Homa Bay,NYANZA,6704
RACHUONYO,Urban,63,56,51,107,Homa Bay,NYANZA,6705
RACHUONYO,Urban,64,51,68,119,Homa Bay,NYANZA,6706
RACHUONYO,Urban,65,76,81,157,Homa Bay,NYANZA,6707
RACHUONYO,Urban,66,26,45,71,Homa Bay,NYANZA,6708
RACHUONYO,Urban,67,62,59,121,Homa Bay,NYANZA,6709
RACHUONYO,Urban,68,43,43,86,Homa Bay,NYANZA,6710
RACHUONYO,Urban,69,49,70,119,Homa Bay,NYANZA,6711
RACHUONYO,Urban,70,83,134,217,Homa Bay,NYANZA,6712
RACHUONYO,Urban,71,47,53,100,Homa Bay,NYANZA,6713
RACHUONYO,Urban,72,34,51,85,Homa Bay,NYANZA,6714
RACHUONYO,Urban,73,39,50,89,Homa Bay,NYANZA,6715
RACHUONYO,Urban,74,35,40,75,Homa Bay,NYANZA,6716
RACHUONYO,Urban,75,34,60,94,Homa Bay,NYANZA,6717
RACHUONYO,Urban,76,25,28,53,Homa Bay,NYANZA,6718
RACHUONYO,Urban,77,33,27,60,Homa Bay,NYANZA,6719
RACHUONYO,Urban,78,31,35,66,Homa Bay,NYANZA,6720
RACHUONYO,Urban,79,24,48,72,Homa Bay,NYANZA,6721
RACHUONYO,Urban,80+,196,296,492,Homa Bay,NYANZA,6722
RACHUONYO,Urban,Age NS,11,8,19,Homa Bay,NYANZA,6723
MIGORI,Urban,0,1677,1635,3312,Migori,NYANZA,6724
MIGORI,Urban,1,1357,1300,2657,Migori,NYANZA,6725
MIGORI,Urban,2,1437,1549,2986,Migori,NYANZA,6726
MIGORI,Urban,3,1468,1493,2961,Migori,NYANZA,6727
MIGORI,Urban,4,1373,1313,2686,Migori,NYANZA,6728
MIGORI,Urban,5,1359,1347,2706,Migori,NYANZA,6729
MIGORI,Urban,6,1140,1194,2334,Migori,NYANZA,6730
MIGORI,Urban,7,1062,1152,2214,Migori,NYANZA,6731
MIGORI,Urban,8,1134,1215,2349,Migori,NYANZA,6732
MIGORI,Urban,9,1091,1098,2189,Migori,NYANZA,6733
MIGORI,Urban,10,1211,1246,2457,Migori,NYANZA,6734
MIGORI,Urban,11,833,999,1832,Migori,NYANZA,6735
MIGORI,Urban,12,1037,1153,2190,Migori,NYANZA,6736
MIGORI,Urban,13,877,1033,1910,Migori,NYANZA,6737
MIGORI,Urban,14,960,1043,2003,Migori,NYANZA,6738
MIGORI,Urban,15,908,1044,1952,Migori,NYANZA,6739
MIGORI,Urban,16,839,1009,1848,Migori,NYANZA,6740
MIGORI,Urban,17,858,992,1850,Migori,NYANZA,6741
MIGORI,Urban,18,982,1072,2054,Migori,NYANZA,6742
MIGORI,Urban,19,740,997,1737,Migori,NYANZA,6743
MIGORI,Urban,20,1021,1478,2499,Migori,NYANZA,6744
MIGORI,Urban,21,651,918,1569,Migori,NYANZA,6745
MIGORI,Urban,22,803,1073,1876,Migori,NYANZA,6746
MIGORI,Urban,23,711,936,1647,Migori,NYANZA,6747
MIGORI,Urban,24,811,998,1809,Migori,NYANZA,6748
MIGORI,Urban,25,1065,1023,2088,Migori,NYANZA,6749
MIGORI,Urban,26,800,809,1609,Migori,NYANZA,6750
MIGORI,Urban,27,716,741,1457,Migori,NYANZA,6751
MIGORI,Urban,28,699,742,1441,Migori,NYANZA,6752
MIGORI,Urban,29,623,531,1154,Migori,NYANZA,6753
MIGORI,Urban,30,953,981,1934,Migori,NYANZA,6754
MIGORI,Urban,31,460,376,836,Migori,NYANZA,6755
MIGORI,Urban,32,624,575,1199,Migori,NYANZA,6756
MIGORI,Urban,33,360,351,711,Migori,NYANZA,6757
MIGORI,Urban,34,410,397,807,Migori,NYANZA,6758
MIGORI,Urban,35,695,558,1253,Migori,NYANZA,6759
MIGORI,Urban,36,384,333,717,Migori,NYANZA,6760
MIGORI,Urban,37,362,308,670,Migori,NYANZA,6761
MIGORI,Urban,38,318,316,634,Migori,NYANZA,6762
MIGORI,Urban,39,262,242,504,Migori,NYANZA,6763
MIGORI,Urban,40,446,517,963,Migori,NYANZA,6764
MIGORI,Urban,41,231,190,421,Migori,NYANZA,6765
MIGORI,Urban,42,234,228,462,Migori,NYANZA,6766
MIGORI,Urban,43,187,199,386,Migori,NYANZA,6767
MIGORI,Urban,44,167,169,336,Migori,NYANZA,6768
MIGORI,Urban,45,342,351,693,Migori,NYANZA,6769
MIGORI,Urban,46,199,219,418,Migori,NYANZA,6770
MIGORI,Urban,47,197,200,397,Migori,NYANZA,6771
MIGORI,Urban,48,190,147,337,Migori,NYANZA,6772
MIGORI,Urban,49,164,153,317,Migori,NYANZA,6773
MIGORI,Urban,50,261,310,571,Migori,NYANZA,6774
MIGORI,Urban,51,142,145,287,Migori,NYANZA,6775
MIGORI,Urban,52,153,125,278,Migori,NYANZA,6776
MIGORI,Urban,53,118,121,239,Migori,NYANZA,6777
MIGORI,Urban,54,136,136,272,Migori,NYANZA,6778
MIGORI,Urban,55,165,158,323,Migori,NYANZA,6779
MIGORI,Urban,56,124,119,243,Migori,NYANZA,6780
MIGORI,Urban,57,119,124,243,Migori,NYANZA,6781
MIGORI,Urban,58,82,74,156,Migori,NYANZA,6782
MIGORI,Urban,59,68,80,148,Migori,NYANZA,6783
MIGORI,Urban,60,154,175,329,Migori,NYANZA,6784
MIGORI,Urban,61,68,68,136,Migori,NYANZA,6785
MIGORI,Urban,62,69,51,120,Migori,NYANZA,6786
MIGORI,Urban,63,52,45,97,Migori,NYANZA,6787
MIGORI,Urban,64,62,62,124,Migori,NYANZA,6788
MIGORI,Urban,65,75,64,139,Migori,NYANZA,6789
MIGORI,Urban,66,42,46,88,Migori,NYANZA,6790
MIGORI,Urban,67,53,58,111,Migori,NYANZA,6791
MIGORI,Urban,68,28,28,56,Migori,NYANZA,6792
MIGORI,Urban,69,30,39,69,Migori,NYANZA,6793
MIGORI,Urban,70,65,74,139,Migori,NYANZA,6794
MIGORI,Urban,71,24,30,54,Migori,NYANZA,6795
MIGORI,Urban,72,26,25,51,Migori,NYANZA,6796
MIGORI,Urban,73,23,33,56,Migori,NYANZA,6797
MIGORI,Urban,74,27,28,55,Migori,NYANZA,6798
MIGORI,Urban,75,35,19,54,Migori,NYANZA,6799
MIGORI,Urban,76,23,26,49,Migori,NYANZA,6800
MIGORI,Urban,77,20,25,45,Migori,NYANZA,6801
MIGORI,Urban,78,22,37,59,Migori,NYANZA,6802
MIGORI,Urban,79,9,25,34,Migori,NYANZA,6803
MIGORI,Urban,80+,177,261,438,Migori,NYANZA,6804
MIGORI,Urban,Age NS,22,8,30,Migori,NYANZA,6805
RONGO,Urban,0,3892,3878,7770,Migori,NYANZA,6806
RONGO,Urban,1,3454,3433,6887,Migori,NYANZA,6807
RONGO,Urban,2,3885,3826,7711,Migori,NYANZA,6808
RONGO,Urban,3,3519,3597,7116,Migori,NYANZA,6809
RONGO,Urban,4,3472,3500,6972,Migori,NYANZA,6810
RONGO,Urban,5,3314,3234,6548,Migori,NYANZA,6811
RONGO,Urban,6,2967,3049,6016,Migori,NYANZA,6812
RONGO,Urban,7,2645,2705,5350,Migori,NYANZA,6813
RONGO,Urban,8,2894,2930,5824,Migori,NYANZA,6814
RONGO,Urban,9,2579,2805,5384,Migori,NYANZA,6815
RONGO,Urban,10,3039,3089,6128,Migori,NYANZA,6816
RONGO,Urban,11,2148,2252,4400,Migori,NYANZA,6817
RONGO,Urban,12,2949,2817,5766,Migori,NYANZA,6818
RONGO,Urban,13,2536,2526,5062,Migori,NYANZA,6819
RONGO,Urban,14,2385,2419,4804,Migori,NYANZA,6820
RONGO,Urban,15,2471,2478,4949,Migori,NYANZA,6821
RONGO,Urban,16,2301,2281,4582,Migori,NYANZA,6822
RONGO,Urban,17,2500,2419,4919,Migori,NYANZA,6823
RONGO,Urban,18,2531,2482,5013,Migori,NYANZA,6824
RONGO,Urban,19,1757,1937,3694,Migori,NYANZA,6825
RONGO,Urban,20,2167,3042,5209,Migori,NYANZA,6826
RONGO,Urban,21,1529,1851,3380,Migori,NYANZA,6827
RONGO,Urban,22,1604,2026,3630,Migori,NYANZA,6828
RONGO,Urban,23,1560,1945,3505,Migori,NYANZA,6829
RONGO,Urban,24,1482,1798,3280,Migori,NYANZA,6830
RONGO,Urban,25,1758,2227,3985,Migori,NYANZA,6831
RONGO,Urban,26,1382,1428,2810,Migori,NYANZA,6832
RONGO,Urban,27,1383,1354,2737,Migori,NYANZA,6833
RONGO,Urban,28,1172,1257,2429,Migori,NYANZA,6834
RONGO,Urban,29,1081,1017,2098,Migori,NYANZA,6835
RONGO,Urban,30,1640,1900,3540,Migori,NYANZA,6836
RONGO,Urban,31,902,755,1657,Migori,NYANZA,6837
RONGO,Urban,32,1019,1073,2092,Migori,NYANZA,6838
RONGO,Urban,33,769,687,1456,Migori,NYANZA,6839
RONGO,Urban,34,739,756,1495,Migori,NYANZA,6840
RONGO,Urban,35,1132,1245,2377,Migori,NYANZA,6841
RONGO,Urban,36,690,678,1368,Migori,NYANZA,6842
RONGO,Urban,37,580,712,1292,Migori,NYANZA,6843
RONGO,Urban,38,569,685,1254,Migori,NYANZA,6844
RONGO,Urban,39,489,548,1037,Migori,NYANZA,6845
RONGO,Urban,40,880,1250,2130,Migori,NYANZA,6846
RONGO,Urban,41,389,457,846,Migori,NYANZA,6847
RONGO,Urban,42,472,576,1048,Migori,NYANZA,6848
RONGO,Urban,43,387,412,799,Migori,NYANZA,6849
RONGO,Urban,44,355,432,787,Migori,NYANZA,6850
RONGO,Urban,45,619,858,1477,Migori,NYANZA,6851
RONGO,Urban,46,439,526,965,Migori,NYANZA,6852
RONGO,Urban,47,417,545,962,Migori,NYANZA,6853
RONGO,Urban,48,296,418,714,Migori,NYANZA,6854
RONGO,Urban,49,342,402,744,Migori,NYANZA,6855
RONGO,Urban,50,587,766,1353,Migori,NYANZA,6856
RONGO,Urban,51,335,382,717,Migori,NYANZA,6857
RONGO,Urban,52,353,408,761,Migori,NYANZA,6858
RONGO,Urban,53,286,313,599,Migori,NYANZA,6859
RONGO,Urban,54,280,320,600,Migori,NYANZA,6860
RONGO,Urban,55,325,391,716,Migori,NYANZA,6861
RONGO,Urban,56,296,405,701,Migori,NYANZA,6862
RONGO,Urban,57,330,377,707,Migori,NYANZA,6863
RONGO,Urban,58,188,226,414,Migori,NYANZA,6864
RONGO,Urban,59,200,256,456,Migori,NYANZA,6865
RONGO,Urban,60,389,505,894,Migori,NYANZA,6866
RONGO,Urban,61,220,214,434,Migori,NYANZA,6867
RONGO,Urban,62,190,191,381,Migori,NYANZA,6868
RONGO,Urban,63,164,162,326,Migori,NYANZA,6869
RONGO,Urban,64,153,222,375,Migori,NYANZA,6870
RONGO,Urban,65,171,260,431,Migori,NYANZA,6871
RONGO,Urban,66,108,181,289,Migori,NYANZA,6872
RONGO,Urban,67,182,192,374,Migori,NYANZA,6873
RONGO,Urban,68,79,149,228,Migori,NYANZA,6874
RONGO,Urban,69,107,183,290,Migori,NYANZA,6875
RONGO,Urban,70,206,336,542,Migori,NYANZA,6876
RONGO,Urban,71,107,104,211,Migori,NYANZA,6877
RONGO,Urban,72,91,139,230,Migori,NYANZA,6878
RONGO,Urban,73,126,99,225,Migori,NYANZA,6879
RONGO,Urban,74,89,120,209,Migori,NYANZA,6880
RONGO,Urban,75,109,156,265,Migori,NYANZA,6881
RONGO,Urban,76,80,103,183,Migori,NYANZA,6882
RONGO,Urban,77,101,121,222,Migori,NYANZA,6883
RONGO,Urban,78,73,164,237,Migori,NYANZA,6884
RONGO,Urban,79,72,130,202,Migori,NYANZA,6885
RONGO,Urban,80+,548,804,1352,Migori,NYANZA,6886
RONGO,Urban,Age NS,69,66,135,Migori,NYANZA,6887
KURIA WEST,Urban,0,698,717,1415,Migori,NYANZA,6888
KURIA WEST,Urban,1,501,475,976,Migori,NYANZA,6889
KURIA WEST,Urban,2,702,668,1370,Migori,NYANZA,6890
KURIA WEST,Urban,3,678,687,1365,Migori,NYANZA,6891
KURIA WEST,Urban,4,640,679,1319,Migori,NYANZA,6892
KURIA WEST,Urban,5,610,608,1218,Migori,NYANZA,6893
KURIA WEST,Urban,6,653,655,1308,Migori,NYANZA,6894
KURIA WEST,Urban,7,483,561,1044,Migori,NYANZA,6895
KURIA WEST,Urban,8,617,609,1226,Migori,NYANZA,6896
KURIA WEST,Urban,9,535,571,1106,Migori,NYANZA,6897
KURIA WEST,Urban,10,773,756,1529,Migori,NYANZA,6898
KURIA WEST,Urban,11,358,428,786,Migori,NYANZA,6899
KURIA WEST,Urban,12,639,585,1224,Migori,NYANZA,6900
KURIA WEST,Urban,13,486,442,928,Migori,NYANZA,6901
KURIA WEST,Urban,14,488,498,986,Migori,NYANZA,6902
KURIA WEST,Urban,15,461,485,946,Migori,NYANZA,6903
KURIA WEST,Urban,16,435,473,908,Migori,NYANZA,6904
KURIA WEST,Urban,17,363,387,750,Migori,NYANZA,6905
KURIA WEST,Urban,18,538,594,1132,Migori,NYANZA,6906
KURIA WEST,Urban,19,335,358,693,Migori,NYANZA,6907
KURIA WEST,Urban,20,562,685,1247,Migori,NYANZA,6908
KURIA WEST,Urban,21,275,322,597,Migori,NYANZA,6909
KURIA WEST,Urban,22,353,451,804,Migori,NYANZA,6910
KURIA WEST,Urban,23,288,369,657,Migori,NYANZA,6911
KURIA WEST,Urban,24,315,349,664,Migori,NYANZA,6912
KURIA WEST,Urban,25,475,538,1013,Migori,NYANZA,6913
KURIA WEST,Urban,26,296,327,623,Migori,NYANZA,6914
KURIA WEST,Urban,27,274,266,540,Migori,NYANZA,6915
KURIA WEST,Urban,28,357,402,759,Migori,NYANZA,6916
KURIA WEST,Urban,29,244,255,499,Migori,NYANZA,6917
KURIA WEST,Urban,30,532,479,1011,Migori,NYANZA,6918
KURIA WEST,Urban,31,174,156,330,Migori,NYANZA,6919
KURIA WEST,Urban,32,278,264,542,Migori,NYANZA,6920
KURIA WEST,Urban,33,159,148,307,Migori,NYANZA,6921
KURIA WEST,Urban,34,176,166,342,Migori,NYANZA,6922
KURIA WEST,Urban,35,393,326,719,Migori,NYANZA,6923
KURIA WEST,Urban,36,171,167,338,Migori,NYANZA,6924
KURIA WEST,Urban,37,143,130,273,Migori,NYANZA,6925
KURIA WEST,Urban,38,172,190,362,Migori,NYANZA,6926
KURIA WEST,Urban,39,145,124,269,Migori,NYANZA,6927
KURIA WEST,Urban,40,344,241,585,Migori,NYANZA,6928
KURIA WEST,Urban,41,92,72,164,Migori,NYANZA,6929
KURIA WEST,Urban,42,132,82,214,Migori,NYANZA,6930
KURIA WEST,Urban,43,79,76,155,Migori,NYANZA,6931
KURIA WEST,Urban,44,87,55,142,Migori,NYANZA,6932
KURIA WEST,Urban,45,181,142,323,Migori,NYANZA,6933
KURIA WEST,Urban,46,100,71,171,Migori,NYANZA,6934
KURIA WEST,Urban,47,94,63,157,Migori,NYANZA,6935
KURIA WEST,Urban,48,79,71,150,Migori,NYANZA,6936
KURIA WEST,Urban,49,64,47,111,Migori,NYANZA,6937
KURIA WEST,Urban,50,118,101,219,Migori,NYANZA,6938
KURIA WEST,Urban,51,61,28,89,Migori,NYANZA,6939
KURIA WEST,Urban,52,57,41,98,Migori,NYANZA,6940
KURIA WEST,Urban,53,39,37,76,Migori,NYANZA,6941
KURIA WEST,Urban,54,29,31,60,Migori,NYANZA,6942
KURIA WEST,Urban,55,59,54,113,Migori,NYANZA,6943
KURIA WEST,Urban,56,52,24,76,Migori,NYANZA,6944
KURIA WEST,Urban,57,37,23,60,Migori,NYANZA,6945
KURIA WEST,Urban,58,32,29,61,Migori,NYANZA,6946
KURIA WEST,Urban,59,24,18,42,Migori,NYANZA,6947
KURIA WEST,Urban,60,60,69,129,Migori,NYANZA,6948
KURIA WEST,Urban,61,14,13,27,Migori,NYANZA,6949
KURIA WEST,Urban,62,23,20,43,Migori,NYANZA,6950
KURIA WEST,Urban,63,14,13,27,Migori,NYANZA,6951
KURIA WEST,Urban,64,16,21,37,Migori,NYANZA,6952
KURIA WEST,Urban,65,28,27,55,Migori,NYANZA,6953
KURIA WEST,Urban,66,10,11,21,Migori,NYANZA,6954
KURIA WEST,Urban,67,16,10,26,Migori,NYANZA,6955
KURIA WEST,Urban,68,13,10,23,Migori,NYANZA,6956
KURIA WEST,Urban,69,17,9,26,Migori,NYANZA,6957
KURIA WEST,Urban,70,28,31,59,Migori,NYANZA,6958
KURIA WEST,Urban,71,9,9,18,Migori,NYANZA,6959
KURIA WEST,Urban,72,7,7,14,Migori,NYANZA,6960
KURIA WEST,Urban,73,7,5,12,Migori,NYANZA,6961
KURIA WEST,Urban,74,4,8,12,Migori,NYANZA,6962
KURIA WEST,Urban,75,14,12,26,Migori,NYANZA,6963
KURIA WEST,Urban,76,10,6,16,Migori,NYANZA,6964
KURIA WEST,Urban,77,4,4,8,Migori,NYANZA,6965
KURIA WEST,Urban,78,10,12,22,Migori,NYANZA,6966
KURIA WEST,Urban,79,6,11,17,Migori,NYANZA,6967
KURIA WEST,Urban,80+,72,99,171,Migori,NYANZA,6968
KURIA WEST,Urban,Age NS,7,4,11,Migori,NYANZA,6969
KURIA EAST,Urban,0,0,0,0,Migori,NYANZA,6970
KURIA EAST,Urban,1,0,0,0,Migori,NYANZA,6971
KURIA EAST,Urban,2,0,0,0,Migori,NYANZA,6972
KURIA EAST,Urban,3,0,0,0,Migori,NYANZA,6973
KURIA EAST,Urban,4,0,0,0,Migori,NYANZA,6974
KURIA EAST,Urban,5,0,0,0,Migori,NYANZA,6975
KURIA EAST,Urban,6,0,0,0,Migori,NYANZA,6976
KURIA EAST,Urban,7,0,0,0,Migori,NYANZA,6977
KURIA EAST,Urban,8,0,0,0,Migori,NYANZA,6978
KURIA EAST,Urban,9,0,0,0,Migori,NYANZA,6979
KURIA EAST,Urban,10,0,0,0,Migori,NYANZA,6980
KURIA EAST,Urban,11,0,0,0,Migori,NYANZA,6981
KURIA EAST,Urban,12,0,0,0,Migori,NYANZA,6982
KURIA EAST,Urban,13,0,0,0,Migori,NYANZA,6983
KURIA EAST,Urban,14,0,0,0,Migori,NYANZA,6984
KURIA EAST,Urban,15,0,0,0,Migori,NYANZA,6985
KURIA EAST,Urban,16,0,0,0,Migori,NYANZA,6986
KURIA EAST,Urban,17,0,0,0,Migori,NYANZA,6987
KURIA EAST,Urban,18,0,0,0,Migori,NYANZA,6988
KURIA EAST,Urban,19,0,0,0,Migori,NYANZA,6989
KURIA EAST,Urban,20,0,0,0,Migori,NYANZA,6990
KURIA EAST,Urban,21,0,0,0,Migori,NYANZA,6991
KURIA EAST,Urban,22,0,0,0,Migori,NYANZA,6992
KURIA EAST,Urban,23,0,0,0,Migori,NYANZA,6993
KURIA EAST,Urban,24,0,0,0,Migori,NYANZA,6994
KURIA EAST,Urban,25,0,0,0,Migori,NYANZA,6995
KURIA EAST,Urban,26,0,0,0,Migori,NYANZA,6996
KURIA EAST,Urban,27,0,0,0,Migori,NYANZA,6997
KURIA EAST,Urban,28,0,0,0,Migori,NYANZA,6998
KURIA EAST,Urban,29,0,0,0,Migori,NYANZA,6999
KURIA EAST,Urban,30,0,0,0,Migori,NYANZA,7000
KURIA EAST,Urban,31,0,0,0,Migori,NYANZA,7001
KURIA EAST,Urban,32,0,0,0,Migori,NYANZA,7002
KURIA EAST,Urban,33,0,0,0,Migori,NYANZA,7003
KURIA EAST,Urban,34,0,0,0,Migori,NYANZA,7004
KURIA EAST,Urban,35,0,0,0,Migori,NYANZA,7005
KURIA EAST,Urban,36,0,0,0,Migori,NYANZA,7006
KURIA EAST,Urban,37,0,0,0,Migori,NYANZA,7007
KURIA EAST,Urban,38,0,0,0,Migori,NYANZA,7008
KURIA EAST,Urban,39,0,0,0,Migori,NYANZA,7009
KURIA EAST,Urban,40,0,0,0,Migori,NYANZA,7010
KURIA EAST,Urban,41,0,0,0,Migori,NYANZA,7011
KURIA EAST,Urban,42,0,0,0,Migori,NYANZA,7012
KURIA EAST,Urban,43,0,0,0,Migori,NYANZA,7013
KURIA EAST,Urban,44,0,0,0,Migori,NYANZA,7014
KURIA EAST,Urban,45,0,0,0,Migori,NYANZA,7015
KURIA EAST,Urban,46,0,0,0,Migori,NYANZA,7016
KURIA EAST,Urban,47,0,0,0,Migori,NYANZA,7017
KURIA EAST,Urban,48,0,0,0,Migori,NYANZA,7018
KURIA EAST,Urban,49,0,0,0,Migori,NYANZA,7019
KURIA EAST,Urban,50,0,0,0,Migori,NYANZA,7020
KURIA EAST,Urban,51,0,0,0,Migori,NYANZA,7021
KURIA EAST,Urban,52,0,0,0,Migori,NYANZA,7022
KURIA EAST,Urban,53,0,0,0,Migori,NYANZA,7023
KURIA EAST,Urban,54,0,0,0,Migori,NYANZA,7024
KURIA EAST,Urban,55,0,0,0,Migori,NYANZA,7025
KURIA EAST,Urban,56,0,0,0,Migori,NYANZA,7026
KURIA EAST,Urban,57,0,0,0,Migori,NYANZA,7027
KURIA EAST,Urban,58,0,0,0,Migori,NYANZA,7028
KURIA EAST,Urban,59,0,0,0,Migori,NYANZA,7029
KURIA EAST,Urban,60,0,0,0,Migori,NYANZA,7030
KURIA EAST,Urban,61,0,0,0,Migori,NYANZA,7031
KURIA EAST,Urban,62,0,0,0,Migori,NYANZA,7032
KURIA EAST,Urban,63,0,0,0,Migori,NYANZA,7033
KURIA EAST,Urban,64,0,0,0,Migori,NYANZA,7034
KURIA EAST,Urban,65,0,0,0,Migori,NYANZA,7035
KURIA EAST,Urban,66,0,0,0,Migori,NYANZA,7036
KURIA EAST,Urban,67,0,0,0,Migori,NYANZA,7037
KURIA EAST,Urban,68,0,0,0,Migori,NYANZA,7038
KURIA EAST,Urban,69,0,0,0,Migori,NYANZA,7039
KURIA EAST,Urban,70,0,0,0,Migori,NYANZA,7040
KURIA EAST,Urban,71,0,0,0,Migori,NYANZA,7041
KURIA EAST,Urban,72,0,0,0,Migori,NYANZA,7042
KURIA EAST,Urban,73,0,0,0,Migori,NYANZA,7043
KURIA EAST,Urban,74,0,0,0,Migori,NYANZA,7044
KURIA EAST,Urban,75,0,0,0,Migori,NYANZA,7045
KURIA EAST,Urban,76,0,0,0,Migori,NYANZA,7046
KURIA EAST,Urban,77,0,0,0,Migori,NYANZA,7047
KURIA EAST,Urban,78,0,0,0,Migori,NYANZA,7048
KURIA EAST,Urban,79,0,0,0,Migori,NYANZA,7049
KURIA EAST,Urban,80+,0,0,0,Migori,NYANZA,7050
KURIA EAST,Urban,Age NS,0,0,0,Migori,NYANZA,7051
KISII CENTRAL,Urban,0,1307,1269,2576,Kisii,NYANZA,7052
KISII CENTRAL,Urban,1,1013,1031,2044,Kisii,NYANZA,7053
KISII CENTRAL,Urban,2,1176,1139,2315,Kisii,NYANZA,7054
KISII CENTRAL,Urban,3,1152,1132,2284,Kisii,NYANZA,7055
KISII CENTRAL,Urban,4,1119,1074,2193,Kisii,NYANZA,7056
KISII CENTRAL,Urban,5,1056,1004,2060,Kisii,NYANZA,7057
KISII CENTRAL,Urban,6,966,998,1964,Kisii,NYANZA,7058
KISII CENTRAL,Urban,7,906,926,1832,Kisii,NYANZA,7059
KISII CENTRAL,Urban,8,813,972,1785,Kisii,NYANZA,7060
KISII CENTRAL,Urban,9,913,959,1872,Kisii,NYANZA,7061
KISII CENTRAL,Urban,10,986,896,1882,Kisii,NYANZA,7062
KISII CENTRAL,Urban,11,759,802,1561,Kisii,NYANZA,7063
KISII CENTRAL,Urban,12,927,1065,1992,Kisii,NYANZA,7064
KISII CENTRAL,Urban,13,873,972,1845,Kisii,NYANZA,7065
KISII CENTRAL,Urban,14,810,890,1700,Kisii,NYANZA,7066
KISII CENTRAL,Urban,15,780,896,1676,Kisii,NYANZA,7067
KISII CENTRAL,Urban,16,838,967,1805,Kisii,NYANZA,7068
KISII CENTRAL,Urban,17,933,1040,1973,Kisii,NYANZA,7069
KISII CENTRAL,Urban,18,1019,1193,2212,Kisii,NYANZA,7070
KISII CENTRAL,Urban,19,826,1058,1884,Kisii,NYANZA,7071
KISII CENTRAL,Urban,20,1175,1665,2840,Kisii,NYANZA,7072
KISII CENTRAL,Urban,21,816,1071,1887,Kisii,NYANZA,7073
KISII CENTRAL,Urban,22,1100,1278,2378,Kisii,NYANZA,7074
KISII CENTRAL,Urban,23,1033,1228,2261,Kisii,NYANZA,7075
KISII CENTRAL,Urban,24,1026,1149,2175,Kisii,NYANZA,7076
KISII CENTRAL,Urban,25,1272,1384,2656,Kisii,NYANZA,7077
KISII CENTRAL,Urban,26,904,856,1760,Kisii,NYANZA,7078
KISII CENTRAL,Urban,27,1035,825,1860,Kisii,NYANZA,7079
KISII CENTRAL,Urban,28,923,925,1848,Kisii,NYANZA,7080
KISII CENTRAL,Urban,29,671,578,1249,Kisii,NYANZA,7081
KISII CENTRAL,Urban,30,1244,968,2212,Kisii,NYANZA,7082
KISII CENTRAL,Urban,31,544,353,897,Kisii,NYANZA,7083
KISII CENTRAL,Urban,32,759,605,1364,Kisii,NYANZA,7084
KISII CENTRAL,Urban,33,461,355,816,Kisii,NYANZA,7085
KISII CENTRAL,Urban,34,547,368,915,Kisii,NYANZA,7086
KISII CENTRAL,Urban,35,884,720,1604,Kisii,NYANZA,7087
KISII CENTRAL,Urban,36,412,373,785,Kisii,NYANZA,7088
KISII CENTRAL,Urban,37,432,324,756,Kisii,NYANZA,7089
KISII CENTRAL,Urban,38,444,405,849,Kisii,NYANZA,7090
KISII CENTRAL,Urban,39,345,282,627,Kisii,NYANZA,7091
KISII CENTRAL,Urban,40,694,563,1257,Kisii,NYANZA,7092
KISII CENTRAL,Urban,41,256,179,435,Kisii,NYANZA,7093
KISII CENTRAL,Urban,42,311,251,562,Kisii,NYANZA,7094
KISII CENTRAL,Urban,43,254,192,446,Kisii,NYANZA,7095
KISII CENTRAL,Urban,44,189,170,359,Kisii,NYANZA,7096
KISII CENTRAL,Urban,45,498,416,914,Kisii,NYANZA,7097
KISII CENTRAL,Urban,46,303,208,511,Kisii,NYANZA,7098
KISII CENTRAL,Urban,47,294,234,528,Kisii,NYANZA,7099
KISII CENTRAL,Urban,48,285,253,538,Kisii,NYANZA,7100
KISII CENTRAL,Urban,49,274,200,474,Kisii,NYANZA,7101
KISII CENTRAL,Urban,50,382,322,704,Kisii,NYANZA,7102
KISII CENTRAL,Urban,51,186,127,313,Kisii,NYANZA,7103
KISII CENTRAL,Urban,52,192,140,332,Kisii,NYANZA,7104
KISII CENTRAL,Urban,53,157,111,268,Kisii,NYANZA,7105
KISII CENTRAL,Urban,54,147,99,246,Kisii,NYANZA,7106
KISII CENTRAL,Urban,55,221,165,386,Kisii,NYANZA,7107
KISII CENTRAL,Urban,56,133,86,219,Kisii,NYANZA,7108
KISII CENTRAL,Urban,57,142,96,238,Kisii,NYANZA,7109
KISII CENTRAL,Urban,58,89,60,149,Kisii,NYANZA,7110
KISII CENTRAL,Urban,59,93,79,172,Kisii,NYANZA,7111
KISII CENTRAL,Urban,60,179,143,322,Kisii,NYANZA,7112
KISII CENTRAL,Urban,61,105,53,158,Kisii,NYANZA,7113
KISII CENTRAL,Urban,62,72,46,118,Kisii,NYANZA,7114
KISII CENTRAL,Urban,63,68,40,108,Kisii,NYANZA,7115
KISII CENTRAL,Urban,64,51,37,88,Kisii,NYANZA,7116
KISII CENTRAL,Urban,65,81,77,158,Kisii,NYANZA,7117
KISII CENTRAL,Urban,66,31,20,51,Kisii,NYANZA,7118
KISII CENTRAL,Urban,67,43,28,71,Kisii,NYANZA,7119
KISII CENTRAL,Urban,68,34,32,66,Kisii,NYANZA,7120
KISII CENTRAL,Urban,69,45,47,92,Kisii,NYANZA,7121
KISII CENTRAL,Urban,70,82,108,190,Kisii,NYANZA,7122
KISII CENTRAL,Urban,71,24,16,40,Kisii,NYANZA,7123
KISII CENTRAL,Urban,72,41,25,66,Kisii,NYANZA,7124
KISII CENTRAL,Urban,73,28,19,47,Kisii,NYANZA,7125
KISII CENTRAL,Urban,74,19,26,45,Kisii,NYANZA,7126
KISII CENTRAL,Urban,75,39,44,83,Kisii,NYANZA,7127
KISII CENTRAL,Urban,76,21,18,39,Kisii,NYANZA,7128
KISII CENTRAL,Urban,77,23,12,35,Kisii,NYANZA,7129
KISII CENTRAL,Urban,78,24,27,51,Kisii,NYANZA,7130
KISII CENTRAL,Urban,79,17,29,46,Kisii,NYANZA,7131
KISII CENTRAL,Urban,80+,157,292,449,Kisii,NYANZA,7132
KISII CENTRAL,Urban,Age NS,37,23,60,Kisii,NYANZA,7133
KISII SOUTH,Urban,0,1030,1020,2050,Kisii,NYANZA,7134
KISII SOUTH,Urban,1,947,870,1817,Kisii,NYANZA,7135
KISII SOUTH,Urban,2,1013,1051,2064,Kisii,NYANZA,7136
KISII SOUTH,Urban,3,1020,1003,2023,Kisii,NYANZA,7137
KISII SOUTH,Urban,4,974,955,1929,Kisii,NYANZA,7138
KISII SOUTH,Urban,5,899,858,1757,Kisii,NYANZA,7139
KISII SOUTH,Urban,6,941,864,1805,Kisii,NYANZA,7140
KISII SOUTH,Urban,7,851,872,1723,Kisii,NYANZA,7141
KISII SOUTH,Urban,8,839,887,1726,Kisii,NYANZA,7142
KISII SOUTH,Urban,9,811,772,1583,Kisii,NYANZA,7143
KISII SOUTH,Urban,10,852,974,1826,Kisii,NYANZA,7144
KISII SOUTH,Urban,11,624,587,1211,Kisii,NYANZA,7145
KISII SOUTH,Urban,12,858,826,1684,Kisii,NYANZA,7146
KISII SOUTH,Urban,13,754,785,1539,Kisii,NYANZA,7147
KISII SOUTH,Urban,14,735,766,1501,Kisii,NYANZA,7148
KISII SOUTH,Urban,15,735,779,1514,Kisii,NYANZA,7149
KISII SOUTH,Urban,16,737,732,1469,Kisii,NYANZA,7150
KISII SOUTH,Urban,17,812,698,1510,Kisii,NYANZA,7151
KISII SOUTH,Urban,18,773,859,1632,Kisii,NYANZA,7152
KISII SOUTH,Urban,19,531,581,1112,Kisii,NYANZA,7153
KISII SOUTH,Urban,20,629,962,1591,Kisii,NYANZA,7154
KISII SOUTH,Urban,21,430,552,982,Kisii,NYANZA,7155
KISII SOUTH,Urban,22,489,677,1166,Kisii,NYANZA,7156
KISII SOUTH,Urban,23,480,612,1092,Kisii,NYANZA,7157
KISII SOUTH,Urban,24,430,586,1016,Kisii,NYANZA,7158
KISII SOUTH,Urban,25,535,734,1269,Kisii,NYANZA,7159
KISII SOUTH,Urban,26,376,476,852,Kisii,NYANZA,7160
KISII SOUTH,Urban,27,426,451,877,Kisii,NYANZA,7161
KISII SOUTH,Urban,28,374,458,832,Kisii,NYANZA,7162
KISII SOUTH,Urban,29,317,346,663,Kisii,NYANZA,7163
KISII SOUTH,Urban,30,506,630,1136,Kisii,NYANZA,7164
KISII SOUTH,Urban,31,315,262,577,Kisii,NYANZA,7165
KISII SOUTH,Urban,32,299,383,682,Kisii,NYANZA,7166
KISII SOUTH,Urban,33,285,264,549,Kisii,NYANZA,7167
KISII SOUTH,Urban,34,228,307,535,Kisii,NYANZA,7168
KISII SOUTH,Urban,35,435,513,948,Kisii,NYANZA,7169
KISII SOUTH,Urban,36,237,243,480,Kisii,NYANZA,7170
KISII SOUTH,Urban,37,231,281,512,Kisii,NYANZA,7171
KISII SOUTH,Urban,38,222,274,496,Kisii,NYANZA,7172
KISII SOUTH,Urban,39,201,208,409,Kisii,NYANZA,7173
KISII SOUTH,Urban,40,330,461,791,Kisii,NYANZA,7174
KISII SOUTH,Urban,41,176,157,333,Kisii,NYANZA,7175
KISII SOUTH,Urban,42,193,157,350,Kisii,NYANZA,7176
KISII SOUTH,Urban,43,126,135,261,Kisii,NYANZA,7177
KISII SOUTH,Urban,44,110,123,233,Kisii,NYANZA,7178
KISII SOUTH,Urban,45,248,344,592,Kisii,NYANZA,7179
KISII SOUTH,Urban,46,221,231,452,Kisii,NYANZA,7180
KISII SOUTH,Urban,47,175,203,378,Kisii,NYANZA,7181
KISII SOUTH,Urban,48,169,202,371,Kisii,NYANZA,7182
KISII SOUTH,Urban,49,155,141,296,Kisii,NYANZA,7183
KISII SOUTH,Urban,50,219,335,554,Kisii,NYANZA,7184
KISII SOUTH,Urban,51,152,133,285,Kisii,NYANZA,7185
KISII SOUTH,Urban,52,138,140,278,Kisii,NYANZA,7186
KISII SOUTH,Urban,53,110,129,239,Kisii,NYANZA,7187
KISII SOUTH,Urban,54,122,116,238,Kisii,NYANZA,7188
KISII SOUTH,Urban,55,172,192,364,Kisii,NYANZA,7189
KISII SOUTH,Urban,56,108,92,200,Kisii,NYANZA,7190
KISII SOUTH,Urban,57,126,128,254,Kisii,NYANZA,7191
KISII SOUTH,Urban,58,82,74,156,Kisii,NYANZA,7192
KISII SOUTH,Urban,59,90,98,188,Kisii,NYANZA,7193
KISII SOUTH,Urban,60,150,225,375,Kisii,NYANZA,7194
KISII SOUTH,Urban,61,99,64,163,Kisii,NYANZA,7195
KISII SOUTH,Urban,62,68,39,107,Kisii,NYANZA,7196
KISII SOUTH,Urban,63,55,34,89,Kisii,NYANZA,7197
KISII SOUTH,Urban,64,56,61,117,Kisii,NYANZA,7198
KISII SOUTH,Urban,65,72,73,145,Kisii,NYANZA,7199
KISII SOUTH,Urban,66,26,42,68,Kisii,NYANZA,7200
KISII SOUTH,Urban,67,64,45,109,Kisii,NYANZA,7201
KISII SOUTH,Urban,68,31,38,69,Kisii,NYANZA,7202
KISII SOUTH,Urban,69,32,60,92,Kisii,NYANZA,7203
KISII SOUTH,Urban,70,99,135,234,Kisii,NYANZA,7204
KISII SOUTH,Urban,71,35,24,59,Kisii,NYANZA,7205
KISII SOUTH,Urban,72,45,30,75,Kisii,NYANZA,7206
KISII SOUTH,Urban,73,37,27,64,Kisii,NYANZA,7207
KISII SOUTH,Urban,74,29,36,65,Kisii,NYANZA,7208
KISII SOUTH,Urban,75,39,62,101,Kisii,NYANZA,7209
KISII SOUTH,Urban,76,29,33,62,Kisii,NYANZA,7210
KISII SOUTH,Urban,77,20,27,47,Kisii,NYANZA,7211
KISII SOUTH,Urban,78,17,25,42,Kisii,NYANZA,7212
KISII SOUTH,Urban,79,24,48,72,Kisii,NYANZA,7213
KISII SOUTH,Urban,80+,173,350,523,Kisii,NYANZA,7214
KISII SOUTH,Urban,Age NS,6,10,16,Kisii,NYANZA,7215
MASABA,Urban,0,1508,1436,2944,Kisii,NYANZA,7216
MASABA,Urban,1,1345,1259,2604,Kisii,NYANZA,7217
MASABA,Urban,2,1550,1539,3089,Kisii,NYANZA,7218
MASABA,Urban,3,1517,1444,2961,Kisii,NYANZA,7219
MASABA,Urban,4,1489,1502,2991,Kisii,NYANZA,7220
MASABA,Urban,5,1461,1360,2821,Kisii,NYANZA,7221
MASABA,Urban,6,1336,1363,2699,Kisii,NYANZA,7222
MASABA,Urban,7,1240,1241,2481,Kisii,NYANZA,7223
MASABA,Urban,8,1307,1420,2727,Kisii,NYANZA,7224
MASABA,Urban,9,1209,1208,2417,Kisii,NYANZA,7225
MASABA,Urban,10,1445,1402,2847,Kisii,NYANZA,7226
MASABA,Urban,11,873,934,1807,Kisii,NYANZA,7227
MASABA,Urban,12,1493,1507,3000,Kisii,NYANZA,7228
MASABA,Urban,13,1229,1206,2435,Kisii,NYANZA,7229
MASABA,Urban,14,1269,1278,2547,Kisii,NYANZA,7230
MASABA,Urban,15,1100,1187,2287,Kisii,NYANZA,7231
MASABA,Urban,16,1170,1210,2380,Kisii,NYANZA,7232
MASABA,Urban,17,1099,1004,2103,Kisii,NYANZA,7233
MASABA,Urban,18,1313,1271,2584,Kisii,NYANZA,7234
MASABA,Urban,19,733,812,1545,Kisii,NYANZA,7235
MASABA,Urban,20,1043,1461,2504,Kisii,NYANZA,7236
MASABA,Urban,21,520,699,1219,Kisii,NYANZA,7237
MASABA,Urban,22,736,1044,1780,Kisii,NYANZA,7238
MASABA,Urban,23,573,839,1412,Kisii,NYANZA,7239
MASABA,Urban,24,583,840,1423,Kisii,NYANZA,7240
MASABA,Urban,25,727,1254,1981,Kisii,NYANZA,7241
MASABA,Urban,26,482,677,1159,Kisii,NYANZA,7242
MASABA,Urban,27,546,653,1199,Kisii,NYANZA,7243
MASABA,Urban,28,502,895,1397,Kisii,NYANZA,7244
MASABA,Urban,29,366,453,819,Kisii,NYANZA,7245
MASABA,Urban,30,713,1186,1899,Kisii,NYANZA,7246
MASABA,Urban,31,369,364,733,Kisii,NYANZA,7247
MASABA,Urban,32,401,538,939,Kisii,NYANZA,7248
MASABA,Urban,33,304,322,626,Kisii,NYANZA,7249
MASABA,Urban,34,356,386,742,Kisii,NYANZA,7250
MASABA,Urban,35,653,943,1596,Kisii,NYANZA,7251
MASABA,Urban,36,280,351,631,Kisii,NYANZA,7252
MASABA,Urban,37,326,377,703,Kisii,NYANZA,7253
MASABA,Urban,38,355,505,860,Kisii,NYANZA,7254
MASABA,Urban,39,232,284,516,Kisii,NYANZA,7255
MASABA,Urban,40,618,852,1470,Kisii,NYANZA,7256
MASABA,Urban,41,241,201,442,Kisii,NYANZA,7257
MASABA,Urban,42,260,254,514,Kisii,NYANZA,7258
MASABA,Urban,43,174,167,341,Kisii,NYANZA,7259
MASABA,Urban,44,151,181,332,Kisii,NYANZA,7260
MASABA,Urban,45,454,598,1052,Kisii,NYANZA,7261
MASABA,Urban,46,274,285,559,Kisii,NYANZA,7262
MASABA,Urban,47,270,276,546,Kisii,NYANZA,7263
MASABA,Urban,48,241,312,553,Kisii,NYANZA,7264
MASABA,Urban,49,286,251,537,Kisii,NYANZA,7265
MASABA,Urban,50,443,601,1044,Kisii,NYANZA,7266
MASABA,Urban,51,186,161,347,Kisii,NYANZA,7267
MASABA,Urban,52,198,182,380,Kisii,NYANZA,7268
MASABA,Urban,53,151,142,293,Kisii,NYANZA,7269
MASABA,Urban,54,144,158,302,Kisii,NYANZA,7270
MASABA,Urban,55,255,304,559,Kisii,NYANZA,7271
MASABA,Urban,56,153,158,311,Kisii,NYANZA,7272
MASABA,Urban,57,169,132,301,Kisii,NYANZA,7273
MASABA,Urban,58,126,147,273,Kisii,NYANZA,7274
MASABA,Urban,59,132,121,253,Kisii,NYANZA,7275
MASABA,Urban,60,247,372,619,Kisii,NYANZA,7276
MASABA,Urban,61,123,91,214,Kisii,NYANZA,7277
MASABA,Urban,62,107,98,205,Kisii,NYANZA,7278
MASABA,Urban,63,105,62,167,Kisii,NYANZA,7279
MASABA,Urban,64,88,101,189,Kisii,NYANZA,7280
MASABA,Urban,65,140,217,357,Kisii,NYANZA,7281
MASABA,Urban,66,79,48,127,Kisii,NYANZA,7282
MASABA,Urban,67,89,70,159,Kisii,NYANZA,7283
MASABA,Urban,68,74,89,163,Kisii,NYANZA,7284
MASABA,Urban,69,68,108,176,Kisii,NYANZA,7285
MASABA,Urban,70,139,259,398,Kisii,NYANZA,7286
MASABA,Urban,71,76,55,131,Kisii,NYANZA,7287
MASABA,Urban,72,60,55,115,Kisii,NYANZA,7288
MASABA,Urban,73,48,35,83,Kisii,NYANZA,7289
MASABA,Urban,74,59,48,107,Kisii,NYANZA,7290
MASABA,Urban,75,83,103,186,Kisii,NYANZA,7291
MASABA,Urban,76,51,42,93,Kisii,NYANZA,7292
MASABA,Urban,77,43,36,79,Kisii,NYANZA,7293
MASABA,Urban,78,42,48,90,Kisii,NYANZA,7294
MASABA,Urban,79,41,57,98,Kisii,NYANZA,7295
MASABA,Urban,80+,286,479,765,Kisii,NYANZA,7296
MASABA,Urban,Age NS,10,13,23,Kisii,NYANZA,7297
GUCHA,Urban,0,445,481,926,Kisii,NYANZA,7298
GUCHA,Urban,1,358,339,697,Kisii,NYANZA,7299
GUCHA,Urban,2,454,459,913,Kisii,NYANZA,7300
GUCHA,Urban,3,411,423,834,Kisii,NYANZA,7301
GUCHA,Urban,4,437,383,820,Kisii,NYANZA,7302
GUCHA,Urban,5,470,407,877,Kisii,NYANZA,7303
GUCHA,Urban,6,415,401,816,Kisii,NYANZA,7304
GUCHA,Urban,7,374,354,728,Kisii,NYANZA,7305
GUCHA,Urban,8,366,350,716,Kisii,NYANZA,7306
GUCHA,Urban,9,338,372,710,Kisii,NYANZA,7307
GUCHA,Urban,10,411,443,854,Kisii,NYANZA,7308
GUCHA,Urban,11,262,250,512,Kisii,NYANZA,7309
GUCHA,Urban,12,412,383,795,Kisii,NYANZA,7310
GUCHA,Urban,13,325,325,650,Kisii,NYANZA,7311
GUCHA,Urban,14,316,306,622,Kisii,NYANZA,7312
GUCHA,Urban,15,281,313,594,Kisii,NYANZA,7313
GUCHA,Urban,16,277,310,587,Kisii,NYANZA,7314
GUCHA,Urban,17,283,294,577,Kisii,NYANZA,7315
GUCHA,Urban,18,340,382,722,Kisii,NYANZA,7316
GUCHA,Urban,19,222,258,480,Kisii,NYANZA,7317
GUCHA,Urban,20,327,481,808,Kisii,NYANZA,7318
GUCHA,Urban,21,232,255,487,Kisii,NYANZA,7319
GUCHA,Urban,22,238,349,587,Kisii,NYANZA,7320
GUCHA,Urban,23,201,308,509,Kisii,NYANZA,7321
GUCHA,Urban,24,210,313,523,Kisii,NYANZA,7322
GUCHA,Urban,25,268,375,643,Kisii,NYANZA,7323
GUCHA,Urban,26,161,267,428,Kisii,NYANZA,7324
GUCHA,Urban,27,223,236,459,Kisii,NYANZA,7325
GUCHA,Urban,28,166,252,418,Kisii,NYANZA,7326
GUCHA,Urban,29,163,176,339,Kisii,NYANZA,7327
GUCHA,Urban,30,257,280,537,Kisii,NYANZA,7328
GUCHA,Urban,31,168,126,294,Kisii,NYANZA,7329
GUCHA,Urban,32,174,179,353,Kisii,NYANZA,7330
GUCHA,Urban,33,111,140,251,Kisii,NYANZA,7331
GUCHA,Urban,34,146,131,277,Kisii,NYANZA,7332
GUCHA,Urban,35,225,245,470,Kisii,NYANZA,7333
GUCHA,Urban,36,99,119,218,Kisii,NYANZA,7334
GUCHA,Urban,37,131,107,238,Kisii,NYANZA,7335
GUCHA,Urban,38,94,125,219,Kisii,NYANZA,7336
GUCHA,Urban,39,100,88,188,Kisii,NYANZA,7337
GUCHA,Urban,40,161,191,352,Kisii,NYANZA,7338
GUCHA,Urban,41,71,67,138,Kisii,NYANZA,7339
GUCHA,Urban,42,89,66,155,Kisii,NYANZA,7340
GUCHA,Urban,43,63,40,103,Kisii,NYANZA,7341
GUCHA,Urban,44,62,45,107,Kisii,NYANZA,7342
GUCHA,Urban,45,137,132,269,Kisii,NYANZA,7343
GUCHA,Urban,46,87,86,173,Kisii,NYANZA,7344
GUCHA,Urban,47,103,88,191,Kisii,NYANZA,7345
GUCHA,Urban,48,69,84,153,Kisii,NYANZA,7346
GUCHA,Urban,49,81,62,143,Kisii,NYANZA,7347
GUCHA,Urban,50,99,123,222,Kisii,NYANZA,7348
GUCHA,Urban,51,54,48,102,Kisii,NYANZA,7349
GUCHA,Urban,52,59,38,97,Kisii,NYANZA,7350
GUCHA,Urban,53,43,30,73,Kisii,NYANZA,7351
GUCHA,Urban,54,42,38,80,Kisii,NYANZA,7352
GUCHA,Urban,55,76,57,133,Kisii,NYANZA,7353
GUCHA,Urban,56,34,26,60,Kisii,NYANZA,7354
GUCHA,Urban,57,35,31,66,Kisii,NYANZA,7355
GUCHA,Urban,58,31,23,54,Kisii,NYANZA,7356
GUCHA,Urban,59,45,24,69,Kisii,NYANZA,7357
GUCHA,Urban,60,65,63,128,Kisii,NYANZA,7358
GUCHA,Urban,61,34,19,53,Kisii,NYANZA,7359
GUCHA,Urban,62,25,18,43,Kisii,NYANZA,7360
GUCHA,Urban,63,18,11,29,Kisii,NYANZA,7361
GUCHA,Urban,64,27,13,40,Kisii,NYANZA,7362
GUCHA,Urban,65,44,36,80,Kisii,NYANZA,7363
GUCHA,Urban,66,18,10,28,Kisii,NYANZA,7364
GUCHA,Urban,67,24,11,35,Kisii,NYANZA,7365
GUCHA,Urban,68,11,17,28,Kisii,NYANZA,7366
GUCHA,Urban,69,20,18,38,Kisii,NYANZA,7367
GUCHA,Urban,70,29,49,78,Kisii,NYANZA,7368
GUCHA,Urban,71,11,16,27,Kisii,NYANZA,7369
GUCHA,Urban,72,4,5,9,Kisii,NYANZA,7370
GUCHA,Urban,73,16,12,28,Kisii,NYANZA,7371
GUCHA,Urban,74,6,11,17,Kisii,NYANZA,7372
GUCHA,Urban,75,13,21,34,Kisii,NYANZA,7373
GUCHA,Urban,76,8,2,10,Kisii,NYANZA,7374
GUCHA,Urban,77,15,4,19,Kisii,NYANZA,7375
GUCHA,Urban,78,6,9,15,Kisii,NYANZA,7376
GUCHA,Urban,79,6,8,14,Kisii,NYANZA,7377
GUCHA,Urban,80+,52,116,168,Kisii,NYANZA,7378
GUCHA,Urban,Age NS,4,2,6,Kisii,NYANZA,7379
GUCHA SOUTH,Urban,0,227,195,422,Kisii,NYANZA,7380
GUCHA SOUTH,Urban,1,178,181,359,Kisii,NYANZA,7381
GUCHA SOUTH,Urban,2,234,215,449,Kisii,NYANZA,7382
GUCHA SOUTH,Urban,3,212,199,411,Kisii,NYANZA,7383
GUCHA SOUTH,Urban,4,180,196,376,Kisii,NYANZA,7384
GUCHA SOUTH,Urban,5,194,191,385,Kisii,NYANZA,7385
GUCHA SOUTH,Urban,6,188,164,352,Kisii,NYANZA,7386
GUCHA SOUTH,Urban,7,149,179,328,Kisii,NYANZA,7387
GUCHA SOUTH,Urban,8,185,180,365,Kisii,NYANZA,7388
GUCHA SOUTH,Urban,9,180,171,351,Kisii,NYANZA,7389
GUCHA SOUTH,Urban,10,209,188,397,Kisii,NYANZA,7390
GUCHA SOUTH,Urban,11,121,133,254,Kisii,NYANZA,7391
GUCHA SOUTH,Urban,12,181,175,356,Kisii,NYANZA,7392
GUCHA SOUTH,Urban,13,176,172,348,Kisii,NYANZA,7393
GUCHA SOUTH,Urban,14,178,160,338,Kisii,NYANZA,7394
GUCHA SOUTH,Urban,15,167,171,338,Kisii,NYANZA,7395
GUCHA SOUTH,Urban,16,158,157,315,Kisii,NYANZA,7396
GUCHA SOUTH,Urban,17,125,136,261,Kisii,NYANZA,7397
GUCHA SOUTH,Urban,18,156,152,308,Kisii,NYANZA,7398
GUCHA SOUTH,Urban,19,98,120,218,Kisii,NYANZA,7399
GUCHA SOUTH,Urban,20,142,212,354,Kisii,NYANZA,7400
GUCHA SOUTH,Urban,21,95,128,223,Kisii,NYANZA,7401
GUCHA SOUTH,Urban,22,119,165,284,Kisii,NYANZA,7402
GUCHA SOUTH,Urban,23,80,151,231,Kisii,NYANZA,7403
GUCHA SOUTH,Urban,24,92,130,222,Kisii,NYANZA,7404
GUCHA SOUTH,Urban,25,127,142,269,Kisii,NYANZA,7405
GUCHA SOUTH,Urban,26,86,103,189,Kisii,NYANZA,7406
GUCHA SOUTH,Urban,27,85,128,213,Kisii,NYANZA,7407
GUCHA SOUTH,Urban,28,73,108,181,Kisii,NYANZA,7408
GUCHA SOUTH,Urban,29,69,77,146,Kisii,NYANZA,7409
GUCHA SOUTH,Urban,30,113,135,248,Kisii,NYANZA,7410
GUCHA SOUTH,Urban,31,71,58,129,Kisii,NYANZA,7411
GUCHA SOUTH,Urban,32,77,87,164,Kisii,NYANZA,7412
GUCHA SOUTH,Urban,33,56,61,117,Kisii,NYANZA,7413
GUCHA SOUTH,Urban,34,69,53,122,Kisii,NYANZA,7414
GUCHA SOUTH,Urban,35,104,129,233,Kisii,NYANZA,7415
GUCHA SOUTH,Urban,36,50,73,123,Kisii,NYANZA,7416
GUCHA SOUTH,Urban,37,68,62,130,Kisii,NYANZA,7417
GUCHA SOUTH,Urban,38,58,70,128,Kisii,NYANZA,7418
GUCHA SOUTH,Urban,39,37,40,77,Kisii,NYANZA,7419
GUCHA SOUTH,Urban,40,83,78,161,Kisii,NYANZA,7420
GUCHA SOUTH,Urban,41,37,47,84,Kisii,NYANZA,7421
GUCHA SOUTH,Urban,42,35,33,68,Kisii,NYANZA,7422
GUCHA SOUTH,Urban,43,36,24,60,Kisii,NYANZA,7423
GUCHA SOUTH,Urban,44,36,24,60,Kisii,NYANZA,7424
GUCHA SOUTH,Urban,45,79,64,143,Kisii,NYANZA,7425
GUCHA SOUTH,Urban,46,36,53,89,Kisii,NYANZA,7426
GUCHA SOUTH,Urban,47,42,44,86,Kisii,NYANZA,7427
GUCHA SOUTH,Urban,48,24,39,63,Kisii,NYANZA,7428
GUCHA SOUTH,Urban,49,30,46,76,Kisii,NYANZA,7429
GUCHA SOUTH,Urban,50,33,69,102,Kisii,NYANZA,7430
GUCHA SOUTH,Urban,51,27,33,60,Kisii,NYANZA,7431
GUCHA SOUTH,Urban,52,25,31,56,Kisii,NYANZA,7432
GUCHA SOUTH,Urban,53,34,21,55,Kisii,NYANZA,7433
GUCHA SOUTH,Urban,54,18,27,45,Kisii,NYANZA,7434
GUCHA SOUTH,Urban,55,34,33,67,Kisii,NYANZA,7435
GUCHA SOUTH,Urban,56,14,17,31,Kisii,NYANZA,7436
GUCHA SOUTH,Urban,57,30,23,53,Kisii,NYANZA,7437
GUCHA SOUTH,Urban,58,15,15,30,Kisii,NYANZA,7438
GUCHA SOUTH,Urban,59,16,30,46,Kisii,NYANZA,7439
GUCHA SOUTH,Urban,60,25,45,70,Kisii,NYANZA,7440
GUCHA SOUTH,Urban,61,17,14,31,Kisii,NYANZA,7441
GUCHA SOUTH,Urban,62,23,10,33,Kisii,NYANZA,7442
GUCHA SOUTH,Urban,63,8,10,18,Kisii,NYANZA,7443
GUCHA SOUTH,Urban,64,11,12,23,Kisii,NYANZA,7444
GUCHA SOUTH,Urban,65,16,22,38,Kisii,NYANZA,7445
GUCHA SOUTH,Urban,66,4,7,11,Kisii,NYANZA,7446
GUCHA SOUTH,Urban,67,19,11,30,Kisii,NYANZA,7447
GUCHA SOUTH,Urban,68,8,12,20,Kisii,NYANZA,7448
GUCHA SOUTH,Urban,69,6,10,16,Kisii,NYANZA,7449
GUCHA SOUTH,Urban,70,11,42,53,Kisii,NYANZA,7450
GUCHA SOUTH,Urban,71,8,2,10,Kisii,NYANZA,7451
GUCHA SOUTH,Urban,72,3,6,9,Kisii,NYANZA,7452
GUCHA SOUTH,Urban,73,6,7,13,Kisii,NYANZA,7453
GUCHA SOUTH,Urban,74,10,6,16,Kisii,NYANZA,7454
GUCHA SOUTH,Urban,75,13,13,26,Kisii,NYANZA,7455
GUCHA SOUTH,Urban,76,6,3,9,Kisii,NYANZA,7456
GUCHA SOUTH,Urban,77,2,8,10,Kisii,NYANZA,7457
GUCHA SOUTH,Urban,78,4,6,10,Kisii,NYANZA,7458
GUCHA SOUTH,Urban,79,4,7,11,Kisii,NYANZA,7459
GUCHA SOUTH,Urban,80+,53,82,135,Kisii,NYANZA,7460
GUCHA SOUTH,Urban,Age NS,0,1,1,Kisii,NYANZA,7461
NYAMIRA,Urban,0,1031,1035,2066,Nyamira,NYANZA,7462
NYAMIRA,Urban,1,879,875,1754,Nyamira,NYANZA,7463
NYAMIRA,Urban,2,1103,1011,2114,Nyamira,NYANZA,7464
NYAMIRA,Urban,3,994,984,1978,Nyamira,NYANZA,7465
NYAMIRA,Urban,4,1018,951,1969,Nyamira,NYANZA,7466
NYAMIRA,Urban,5,954,976,1930,Nyamira,NYANZA,7467
NYAMIRA,Urban,6,883,886,1769,Nyamira,NYANZA,7468
NYAMIRA,Urban,7,840,850,1690,Nyamira,NYANZA,7469
NYAMIRA,Urban,8,890,973,1863,Nyamira,NYANZA,7470
NYAMIRA,Urban,9,881,869,1750,Nyamira,NYANZA,7471
NYAMIRA,Urban,10,917,914,1831,Nyamira,NYANZA,7472
NYAMIRA,Urban,11,587,578,1165,Nyamira,NYANZA,7473
NYAMIRA,Urban,12,961,957,1918,Nyamira,NYANZA,7474
NYAMIRA,Urban,13,688,759,1447,Nyamira,NYANZA,7475
NYAMIRA,Urban,14,816,838,1654,Nyamira,NYANZA,7476
NYAMIRA,Urban,15,747,704,1451,Nyamira,NYANZA,7477
NYAMIRA,Urban,16,772,743,1515,Nyamira,NYANZA,7478
NYAMIRA,Urban,17,709,659,1368,Nyamira,NYANZA,7479
NYAMIRA,Urban,18,903,875,1778,Nyamira,NYANZA,7480
NYAMIRA,Urban,19,531,570,1101,Nyamira,NYANZA,7481
NYAMIRA,Urban,20,758,1076,1834,Nyamira,NYANZA,7482
NYAMIRA,Urban,21,408,541,949,Nyamira,NYANZA,7483
NYAMIRA,Urban,22,539,740,1279,Nyamira,NYANZA,7484
NYAMIRA,Urban,23,403,616,1019,Nyamira,NYANZA,7485
NYAMIRA,Urban,24,458,627,1085,Nyamira,NYANZA,7486
NYAMIRA,Urban,25,592,874,1466,Nyamira,NYANZA,7487
NYAMIRA,Urban,26,383,541,924,Nyamira,NYANZA,7488
NYAMIRA,Urban,27,388,489,877,Nyamira,NYANZA,7489
NYAMIRA,Urban,28,441,677,1118,Nyamira,NYANZA,7490
NYAMIRA,Urban,29,286,333,619,Nyamira,NYANZA,7491
NYAMIRA,Urban,30,645,814,1459,Nyamira,NYANZA,7492
NYAMIRA,Urban,31,271,237,508,Nyamira,NYANZA,7493
NYAMIRA,Urban,32,361,394,755,Nyamira,NYANZA,7494
NYAMIRA,Urban,33,241,225,466,Nyamira,NYANZA,7495
NYAMIRA,Urban,34,263,276,539,Nyamira,NYANZA,7496
NYAMIRA,Urban,35,546,669,1215,Nyamira,NYANZA,7497
NYAMIRA,Urban,36,216,259,475,Nyamira,NYANZA,7498
NYAMIRA,Urban,37,224,258,482,Nyamira,NYANZA,7499
NYAMIRA,Urban,38,263,335,598,Nyamira,NYANZA,7500
NYAMIRA,Urban,39,202,223,425,Nyamira,NYANZA,7501
NYAMIRA,Urban,40,471,578,1049,Nyamira,NYANZA,7502
NYAMIRA,Urban,41,148,140,288,Nyamira,NYANZA,7503
NYAMIRA,Urban,42,163,153,316,Nyamira,NYANZA,7504
NYAMIRA,Urban,43,131,116,247,Nyamira,NYANZA,7505
NYAMIRA,Urban,44,124,113,237,Nyamira,NYANZA,7506
NYAMIRA,Urban,45,346,408,754,Nyamira,NYANZA,7507
NYAMIRA,Urban,46,211,181,392,Nyamira,NYANZA,7508
NYAMIRA,Urban,47,203,189,392,Nyamira,NYANZA,7509
NYAMIRA,Urban,48,187,250,437,Nyamira,NYANZA,7510
NYAMIRA,Urban,49,194,157,351,Nyamira,NYANZA,7511
NYAMIRA,Urban,50,352,399,751,Nyamira,NYANZA,7512
NYAMIRA,Urban,51,164,123,287,Nyamira,NYANZA,7513
NYAMIRA,Urban,52,137,120,257,Nyamira,NYANZA,7514
NYAMIRA,Urban,53,103,91,194,Nyamira,NYANZA,7515
NYAMIRA,Urban,54,119,106,225,Nyamira,NYANZA,7516
NYAMIRA,Urban,55,188,188,376,Nyamira,NYANZA,7517
NYAMIRA,Urban,56,107,89,196,Nyamira,NYANZA,7518
NYAMIRA,Urban,57,123,109,232,Nyamira,NYANZA,7519
NYAMIRA,Urban,58,90,96,186,Nyamira,NYANZA,7520
NYAMIRA,Urban,59,82,86,168,Nyamira,NYANZA,7521
NYAMIRA,Urban,60,212,217,429,Nyamira,NYANZA,7522
NYAMIRA,Urban,61,108,66,174,Nyamira,NYANZA,7523
NYAMIRA,Urban,62,77,55,132,Nyamira,NYANZA,7524
NYAMIRA,Urban,63,62,38,100,Nyamira,NYANZA,7525
NYAMIRA,Urban,64,62,57,119,Nyamira,NYANZA,7526
NYAMIRA,Urban,65,92,109,201,Nyamira,NYANZA,7527
NYAMIRA,Urban,66,38,24,62,Nyamira,NYANZA,7528
NYAMIRA,Urban,67,58,42,100,Nyamira,NYANZA,7529
NYAMIRA,Urban,68,46,47,93,Nyamira,NYANZA,7530
NYAMIRA,Urban,69,64,58,122,Nyamira,NYANZA,7531
NYAMIRA,Urban,70,92,198,290,Nyamira,NYANZA,7532
NYAMIRA,Urban,71,37,22,59,Nyamira,NYANZA,7533
NYAMIRA,Urban,72,35,32,67,Nyamira,NYANZA,7534
NYAMIRA,Urban,73,42,17,59,Nyamira,NYANZA,7535
NYAMIRA,Urban,74,34,25,59,Nyamira,NYANZA,7536
NYAMIRA,Urban,75,40,65,105,Nyamira,NYANZA,7537
NYAMIRA,Urban,76,27,18,45,Nyamira,NYANZA,7538
NYAMIRA,Urban,77,22,20,42,Nyamira,NYANZA,7539
NYAMIRA,Urban,78,31,31,62,Nyamira,NYANZA,7540
NYAMIRA,Urban,79,23,31,54,Nyamira,NYANZA,7541
NYAMIRA,Urban,80+,206,332,538,Nyamira,NYANZA,7542
NYAMIRA,Urban,Age NS,21,18,39,Nyamira,NYANZA,7543
MANGA,Urban,0,0,0,0,Nyamira,NYANZA,7544
MANGA,Urban,1,0,0,0,Nyamira,NYANZA,7545
MANGA,Urban,2,0,0,0,Nyamira,NYANZA,7546
MANGA,Urban,3,0,0,0,Nyamira,NYANZA,7547
MANGA,Urban,4,0,0,0,Nyamira,NYANZA,7548
MANGA,Urban,5,0,0,0,Nyamira,NYANZA,7549
MANGA,Urban,6,0,0,0,Nyamira,NYANZA,7550
MANGA,Urban,7,0,0,0,Nyamira,NYANZA,7551
MANGA,Urban,8,0,0,0,Nyamira,NYANZA,7552
MANGA,Urban,9,0,0,0,Nyamira,NYANZA,7553
MANGA,Urban,10,0,0,0,Nyamira,NYANZA,7554
MANGA,Urban,11,0,0,0,Nyamira,NYANZA,7555
MANGA,Urban,12,0,0,0,Nyamira,NYANZA,7556
MANGA,Urban,13,0,0,0,Nyamira,NYANZA,7557
MANGA,Urban,14,0,0,0,Nyamira,NYANZA,7558
MANGA,Urban,15,0,0,0,Nyamira,NYANZA,7559
MANGA,Urban,16,0,0,0,Nyamira,NYANZA,7560
MANGA,Urban,17,0,0,0,Nyamira,NYANZA,7561
MANGA,Urban,18,0,0,0,Nyamira,NYANZA,7562
MANGA,Urban,19,0,0,0,Nyamira,NYANZA,7563
MANGA,Urban,20,0,0,0,Nyamira,NYANZA,7564
MANGA,Urban,21,0,0,0,Nyamira,NYANZA,7565
MANGA,Urban,22,0,0,0,Nyamira,NYANZA,7566
MANGA,Urban,23,0,0,0,Nyamira,NYANZA,7567
MANGA,Urban,24,0,0,0,Nyamira,NYANZA,7568
MANGA,Urban,25,0,0,0,Nyamira,NYANZA,7569
MANGA,Urban,26,0,0,0,Nyamira,NYANZA,7570
MANGA,Urban,27,0,0,0,Nyamira,NYANZA,7571
MANGA,Urban,28,0,0,0,Nyamira,NYANZA,7572
MANGA,Urban,29,0,0,0,Nyamira,NYANZA,7573
MANGA,Urban,30,0,0,0,Nyamira,NYANZA,7574
MANGA,Urban,31,0,0,0,Nyamira,NYANZA,7575
MANGA,Urban,32,0,0,0,Nyamira,NYANZA,7576
MANGA,Urban,33,0,0,0,Nyamira,NYANZA,7577
MANGA,Urban,34,0,0,0,Nyamira,NYANZA,7578
MANGA,Urban,35,0,0,0,Nyamira,NYANZA,7579
MANGA,Urban,36,0,0,0,Nyamira,NYANZA,7580
MANGA,Urban,37,0,0,0,Nyamira,NYANZA,7581
MANGA,Urban,38,0,0,0,Nyamira,NYANZA,7582
MANGA,Urban,39,0,0,0,Nyamira,NYANZA,7583
MANGA,Urban,40,0,0,0,Nyamira,NYANZA,7584
MANGA,Urban,41,0,0,0,Nyamira,NYANZA,7585
MANGA,Urban,42,0,0,0,Nyamira,NYANZA,7586
MANGA,Urban,43,0,0,0,Nyamira,NYANZA,7587
MANGA,Urban,44,0,0,0,Nyamira,NYANZA,7588
MANGA,Urban,45,0,0,0,Nyamira,NYANZA,7589
MANGA,Urban,46,0,0,0,Nyamira,NYANZA,7590
MANGA,Urban,47,0,0,0,Nyamira,NYANZA,7591
MANGA,Urban,48,0,0,0,Nyamira,NYANZA,7592
MANGA,Urban,49,0,0,0,Nyamira,NYANZA,7593
MANGA,Urban,50,0,0,0,Nyamira,NYANZA,7594
MANGA,Urban,51,0,0,0,Nyamira,NYANZA,7595
MANGA,Urban,52,0,0,0,Nyamira,NYANZA,7596
MANGA,Urban,53,0,0,0,Nyamira,NYANZA,7597
MANGA,Urban,54,0,0,0,Nyamira,NYANZA,7598
MANGA,Urban,55,0,0,0,Nyamira,NYANZA,7599
MANGA,Urban,56,0,0,0,Nyamira,NYANZA,7600
MANGA,Urban,57,0,0,0,Nyamira,NYANZA,7601
MANGA,Urban,58,0,0,0,Nyamira,NYANZA,7602
MANGA,Urban,59,0,0,0,Nyamira,NYANZA,7603
MANGA,Urban,60,0,0,0,Nyamira,NYANZA,7604
MANGA,Urban,61,0,0,0,Nyamira,NYANZA,7605
MANGA,Urban,62,0,0,0,Nyamira,NYANZA,7606
MANGA,Urban,63,0,0,0,Nyamira,NYANZA,7607
MANGA,Urban,64,0,0,0,Nyamira,NYANZA,7608
MANGA,Urban,65,0,0,0,Nyamira,NYANZA,7609
MANGA,Urban,66,0,0,0,Nyamira,NYANZA,7610
MANGA,Urban,67,0,0,0,Nyamira,NYANZA,7611
MANGA,Urban,68,0,0,0,Nyamira,NYANZA,7612
MANGA,Urban,69,0,0,0,Nyamira,NYANZA,7613
MANGA,Urban,70,0,0,0,Nyamira,NYANZA,7614
MANGA,Urban,71,0,0,0,Nyamira,NYANZA,7615
MANGA,Urban,72,0,0,0,Nyamira,NYANZA,7616
MANGA,Urban,73,0,0,0,Nyamira,NYANZA,7617
MANGA,Urban,74,0,0,0,Nyamira,NYANZA,7618
MANGA,Urban,75,0,0,0,Nyamira,NYANZA,7619
MANGA,Urban,76,0,0,0,Nyamira,NYANZA,7620
MANGA,Urban,77,0,0,0,Nyamira,NYANZA,7621
MANGA,Urban,78,0,0,0,Nyamira,NYANZA,7622
MANGA,Urban,79,0,0,0,Nyamira,NYANZA,7623
MANGA,Urban,80+,0,0,0,Nyamira,NYANZA,7624
MANGA,Urban,Age NS,0,0,0,Nyamira,NYANZA,7625
BORABU,Urban,0,80,88,168,Nyamira,NYANZA,7626
BORABU,Urban,1,82,97,179,Nyamira,NYANZA,7627
BORABU,Urban,2,80,70,150,Nyamira,NYANZA,7628
BORABU,Urban,3,90,96,186,Nyamira,NYANZA,7629
BORABU,Urban,4,93,107,200,Nyamira,NYANZA,7630
BORABU,Urban,5,100,72,172,Nyamira,NYANZA,7631
BORABU,Urban,6,78,78,156,Nyamira,NYANZA,7632
BORABU,Urban,7,82,73,155,Nyamira,NYANZA,7633
BORABU,Urban,8,73,80,153,Nyamira,NYANZA,7634
BORABU,Urban,9,91,81,172,Nyamira,NYANZA,7635
BORABU,Urban,10,65,60,125,Nyamira,NYANZA,7636
BORABU,Urban,11,39,56,95,Nyamira,NYANZA,7637
BORABU,Urban,12,74,56,130,Nyamira,NYANZA,7638
BORABU,Urban,13,51,58,109,Nyamira,NYANZA,7639
BORABU,Urban,14,71,66,137,Nyamira,NYANZA,7640
BORABU,Urban,15,62,55,117,Nyamira,NYANZA,7641
BORABU,Urban,16,57,95,152,Nyamira,NYANZA,7642
BORABU,Urban,17,122,110,232,Nyamira,NYANZA,7643
BORABU,Urban,18,115,92,207,Nyamira,NYANZA,7644
BORABU,Urban,19,48,63,111,Nyamira,NYANZA,7645
BORABU,Urban,20,68,84,152,Nyamira,NYANZA,7646
BORABU,Urban,21,30,51,81,Nyamira,NYANZA,7647
BORABU,Urban,22,47,81,128,Nyamira,NYANZA,7648
BORABU,Urban,23,56,61,117,Nyamira,NYANZA,7649
BORABU,Urban,24,61,60,121,Nyamira,NYANZA,7650
BORABU,Urban,25,73,88,161,Nyamira,NYANZA,7651
BORABU,Urban,26,47,64,111,Nyamira,NYANZA,7652
BORABU,Urban,27,57,52,109,Nyamira,NYANZA,7653
BORABU,Urban,28,49,87,136,Nyamira,NYANZA,7654
BORABU,Urban,29,42,45,87,Nyamira,NYANZA,7655
BORABU,Urban,30,84,70,154,Nyamira,NYANZA,7656
BORABU,Urban,31,34,14,48,Nyamira,NYANZA,7657
BORABU,Urban,32,47,32,79,Nyamira,NYANZA,7658
BORABU,Urban,33,40,28,68,Nyamira,NYANZA,7659
BORABU,Urban,34,33,33,66,Nyamira,NYANZA,7660
BORABU,Urban,35,69,61,130,Nyamira,NYANZA,7661
BORABU,Urban,36,32,18,50,Nyamira,NYANZA,7662
BORABU,Urban,37,27,23,50,Nyamira,NYANZA,7663
BORABU,Urban,38,29,33,62,Nyamira,NYANZA,7664
BORABU,Urban,39,24,25,49,Nyamira,NYANZA,7665
BORABU,Urban,40,51,37,88,Nyamira,NYANZA,7666
BORABU,Urban,41,13,17,30,Nyamira,NYANZA,7667
BORABU,Urban,42,20,9,29,Nyamira,NYANZA,7668
BORABU,Urban,43,20,12,32,Nyamira,NYANZA,7669
BORABU,Urban,44,18,12,30,Nyamira,NYANZA,7670
BORABU,Urban,45,39,31,70,Nyamira,NYANZA,7671
BORABU,Urban,46,24,27,51,Nyamira,NYANZA,7672
BORABU,Urban,47,22,19,41,Nyamira,NYANZA,7673
BORABU,Urban,48,18,17,35,Nyamira,NYANZA,7674
BORABU,Urban,49,21,19,40,Nyamira,NYANZA,7675
BORABU,Urban,50,26,26,52,Nyamira,NYANZA,7676
BORABU,Urban,51,9,4,13,Nyamira,NYANZA,7677
BORABU,Urban,52,15,6,21,Nyamira,NYANZA,7678
BORABU,Urban,53,16,4,20,Nyamira,NYANZA,7679
BORABU,Urban,54,12,5,17,Nyamira,NYANZA,7680
BORABU,Urban,55,16,11,27,Nyamira,NYANZA,7681
BORABU,Urban,56,9,7,16,Nyamira,NYANZA,7682
BORABU,Urban,57,8,5,13,Nyamira,NYANZA,7683
BORABU,Urban,58,8,1,9,Nyamira,NYANZA,7684
BORABU,Urban,59,4,3,7,Nyamira,NYANZA,7685
BORABU,Urban,60,8,5,13,Nyamira,NYANZA,7686
BORABU,Urban,61,4,5,9,Nyamira,NYANZA,7687
BORABU,Urban,62,3,4,7,Nyamira,NYANZA,7688
BORABU,Urban,63,2,0,2,Nyamira,NYANZA,7689
BORABU,Urban,64,6,2,8,Nyamira,NYANZA,7690
BORABU,Urban,65,5,2,7,Nyamira,NYANZA,7691
BORABU,Urban,66,2,0,2,Nyamira,NYANZA,7692
BORABU,Urban,67,1,0,1,Nyamira,NYANZA,7693
BORABU,Urban,68,4,2,6,Nyamira,NYANZA,7694
BORABU,Urban,69,1,4,5,Nyamira,NYANZA,7695
BORABU,Urban,70,3,6,9,Nyamira,NYANZA,7696
BORABU,Urban,71,2,1,3,Nyamira,NYANZA,7697
BORABU,Urban,72,0,1,1,Nyamira,NYANZA,7698
BORABU,Urban,73,1,0,1,Nyamira,NYANZA,7699
BORABU,Urban,74,1,0,1,Nyamira,NYANZA,7700
BORABU,Urban,75,2,2,4,Nyamira,NYANZA,7701
BORABU,Urban,76,0,1,1,Nyamira,NYANZA,7702
BORABU,Urban,77,1,0,1,Nyamira,NYANZA,7703
BORABU,Urban,78,0,1,1,Nyamira,NYANZA,7704
BORABU,Urban,79,1,3,4,Nyamira,NYANZA,7705
BORABU,Urban,80+,9,11,20,Nyamira,NYANZA,7706
BORABU,Urban,Age NS,1,1,2,Nyamira,NYANZA,7707
TURKANA CENTRAL,Urban,0,974,851,1825,Turkana,RIFT VALLEY,7708
TURKANA CENTRAL,Urban,1,684,696,1380,Turkana,RIFT VALLEY,7709
TURKANA CENTRAL,Urban,2,868,861,1729,Turkana,RIFT VALLEY,7710
TURKANA CENTRAL,Urban,3,882,852,1734,Turkana,RIFT VALLEY,7711
TURKANA CENTRAL,Urban,4,824,776,1600,Turkana,RIFT VALLEY,7712
TURKANA CENTRAL,Urban,5,807,778,1585,Turkana,RIFT VALLEY,7713
TURKANA CENTRAL,Urban,6,788,717,1505,Turkana,RIFT VALLEY,7714
TURKANA CENTRAL,Urban,7,725,748,1473,Turkana,RIFT VALLEY,7715
TURKANA CENTRAL,Urban,8,679,724,1403,Turkana,RIFT VALLEY,7716
TURKANA CENTRAL,Urban,9,667,656,1323,Turkana,RIFT VALLEY,7717
TURKANA CENTRAL,Urban,10,835,790,1625,Turkana,RIFT VALLEY,7718
TURKANA CENTRAL,Urban,11,537,554,1091,Turkana,RIFT VALLEY,7719
TURKANA CENTRAL,Urban,12,714,711,1425,Turkana,RIFT VALLEY,7720
TURKANA CENTRAL,Urban,13,689,660,1349,Turkana,RIFT VALLEY,7721
TURKANA CENTRAL,Urban,14,642,686,1328,Turkana,RIFT VALLEY,7722
TURKANA CENTRAL,Urban,15,762,746,1508,Turkana,RIFT VALLEY,7723
TURKANA CENTRAL,Urban,16,734,705,1439,Turkana,RIFT VALLEY,7724
TURKANA CENTRAL,Urban,17,686,628,1314,Turkana,RIFT VALLEY,7725
TURKANA CENTRAL,Urban,18,676,668,1344,Turkana,RIFT VALLEY,7726
TURKANA CENTRAL,Urban,19,520,518,1038,Turkana,RIFT VALLEY,7727
TURKANA CENTRAL,Urban,20,623,781,1404,Turkana,RIFT VALLEY,7728
TURKANA CENTRAL,Urban,21,383,434,817,Turkana,RIFT VALLEY,7729
TURKANA CENTRAL,Urban,22,440,547,987,Turkana,RIFT VALLEY,7730
TURKANA CENTRAL,Urban,23,368,483,851,Turkana,RIFT VALLEY,7731
TURKANA CENTRAL,Urban,24,434,495,929,Turkana,RIFT VALLEY,7732
TURKANA CENTRAL,Urban,25,499,653,1152,Turkana,RIFT VALLEY,7733
TURKANA CENTRAL,Urban,26,344,416,760,Turkana,RIFT VALLEY,7734
TURKANA CENTRAL,Urban,27,313,334,647,Turkana,RIFT VALLEY,7735
TURKANA CENTRAL,Urban,28,412,377,789,Turkana,RIFT VALLEY,7736
TURKANA CENTRAL,Urban,29,327,326,653,Turkana,RIFT VALLEY,7737
TURKANA CENTRAL,Urban,30,505,562,1067,Turkana,RIFT VALLEY,7738
TURKANA CENTRAL,Urban,31,260,270,530,Turkana,RIFT VALLEY,7739
TURKANA CENTRAL,Urban,32,299,329,628,Turkana,RIFT VALLEY,7740
TURKANA CENTRAL,Urban,33,207,180,387,Turkana,RIFT VALLEY,7741
TURKANA CENTRAL,Urban,34,213,177,390,Turkana,RIFT VALLEY,7742
TURKANA CENTRAL,Urban,35,384,337,721,Turkana,RIFT VALLEY,7743
TURKANA CENTRAL,Urban,36,211,282,493,Turkana,RIFT VALLEY,7744
TURKANA CENTRAL,Urban,37,183,166,349,Turkana,RIFT VALLEY,7745
TURKANA CENTRAL,Urban,38,202,177,379,Turkana,RIFT VALLEY,7746
TURKANA CENTRAL,Urban,39,161,156,317,Turkana,RIFT VALLEY,7747
TURKANA CENTRAL,Urban,40,292,269,561,Turkana,RIFT VALLEY,7748
TURKANA CENTRAL,Urban,41,96,86,182,Turkana,RIFT VALLEY,7749
TURKANA CENTRAL,Urban,42,154,142,296,Turkana,RIFT VALLEY,7750
TURKANA CENTRAL,Urban,43,125,126,251,Turkana,RIFT VALLEY,7751
TURKANA CENTRAL,Urban,44,95,85,180,Turkana,RIFT VALLEY,7752
TURKANA CENTRAL,Urban,45,211,217,428,Turkana,RIFT VALLEY,7753
TURKANA CENTRAL,Urban,46,132,126,258,Turkana,RIFT VALLEY,7754
TURKANA CENTRAL,Urban,47,111,86,197,Turkana,RIFT VALLEY,7755
TURKANA CENTRAL,Urban,48,111,128,239,Turkana,RIFT VALLEY,7756
TURKANA CENTRAL,Urban,49,114,131,245,Turkana,RIFT VALLEY,7757
TURKANA CENTRAL,Urban,50,216,233,449,Turkana,RIFT VALLEY,7758
TURKANA CENTRAL,Urban,51,85,122,207,Turkana,RIFT VALLEY,7759
TURKANA CENTRAL,Urban,52,98,90,188,Turkana,RIFT VALLEY,7760
TURKANA CENTRAL,Urban,53,74,98,172,Turkana,RIFT VALLEY,7761
TURKANA CENTRAL,Urban,54,76,88,164,Turkana,RIFT VALLEY,7762
TURKANA CENTRAL,Urban,55,113,118,231,Turkana,RIFT VALLEY,7763
TURKANA CENTRAL,Urban,56,76,94,170,Turkana,RIFT VALLEY,7764
TURKANA CENTRAL,Urban,57,71,84,155,Turkana,RIFT VALLEY,7765
TURKANA CENTRAL,Urban,58,48,71,119,Turkana,RIFT VALLEY,7766
TURKANA CENTRAL,Urban,59,78,97,175,Turkana,RIFT VALLEY,7767
TURKANA CENTRAL,Urban,60,111,150,261,Turkana,RIFT VALLEY,7768
TURKANA CENTRAL,Urban,61,45,69,114,Turkana,RIFT VALLEY,7769
TURKANA CENTRAL,Urban,62,45,57,102,Turkana,RIFT VALLEY,7770
TURKANA CENTRAL,Urban,63,34,58,92,Turkana,RIFT VALLEY,7771
TURKANA CENTRAL,Urban,64,33,71,104,Turkana,RIFT VALLEY,7772
TURKANA CENTRAL,Urban,65,43,55,98,Turkana,RIFT VALLEY,7773
TURKANA CENTRAL,Urban,66,22,23,45,Turkana,RIFT VALLEY,7774
TURKANA CENTRAL,Urban,67,26,41,67,Turkana,RIFT VALLEY,7775
TURKANA CENTRAL,Urban,68,29,46,75,Turkana,RIFT VALLEY,7776
TURKANA CENTRAL,Urban,69,33,85,118,Turkana,RIFT VALLEY,7777
TURKANA CENTRAL,Urban,70,71,66,137,Turkana,RIFT VALLEY,7778
TURKANA CENTRAL,Urban,71,25,31,56,Turkana,RIFT VALLEY,7779
TURKANA CENTRAL,Urban,72,24,32,56,Turkana,RIFT VALLEY,7780
TURKANA CENTRAL,Urban,73,17,23,40,Turkana,RIFT VALLEY,7781
TURKANA CENTRAL,Urban,74,14,24,38,Turkana,RIFT VALLEY,7782
TURKANA CENTRAL,Urban,75,16,26,42,Turkana,RIFT VALLEY,7783
TURKANA CENTRAL,Urban,76,10,9,19,Turkana,RIFT VALLEY,7784
TURKANA CENTRAL,Urban,77,7,18,25,Turkana,RIFT VALLEY,7785
TURKANA CENTRAL,Urban,78,22,21,43,Turkana,RIFT VALLEY,7786
TURKANA CENTRAL,Urban,79,14,45,59,Turkana,RIFT VALLEY,7787
TURKANA CENTRAL,Urban,80+,159,231,390,Turkana,RIFT VALLEY,7788
TURKANA CENTRAL,Urban,Age NS,56,52,108,Turkana,RIFT VALLEY,7789
TURKANA NORTH,Urban,0,1349,1244,2593,Turkana,RIFT VALLEY,7790
TURKANA NORTH,Urban,1,800,766,1566,Turkana,RIFT VALLEY,7791
TURKANA NORTH,Urban,2,1186,1156,2342,Turkana,RIFT VALLEY,7792
TURKANA NORTH,Urban,3,1166,1105,2271,Turkana,RIFT VALLEY,7793
TURKANA NORTH,Urban,4,1140,1029,2169,Turkana,RIFT VALLEY,7794
TURKANA NORTH,Urban,5,1132,1053,2185,Turkana,RIFT VALLEY,7795
TURKANA NORTH,Urban,6,1050,1063,2113,Turkana,RIFT VALLEY,7796
TURKANA NORTH,Urban,7,1064,1029,2093,Turkana,RIFT VALLEY,7797
TURKANA NORTH,Urban,8,1093,978,2071,Turkana,RIFT VALLEY,7798
TURKANA NORTH,Urban,9,966,949,1915,Turkana,RIFT VALLEY,7799
TURKANA NORTH,Urban,10,1394,1251,2645,Turkana,RIFT VALLEY,7800
TURKANA NORTH,Urban,11,717,634,1351,Turkana,RIFT VALLEY,7801
TURKANA NORTH,Urban,12,1268,1084,2352,Turkana,RIFT VALLEY,7802
TURKANA NORTH,Urban,13,920,760,1680,Turkana,RIFT VALLEY,7803
TURKANA NORTH,Urban,14,1024,840,1864,Turkana,RIFT VALLEY,7804
TURKANA NORTH,Urban,15,1121,949,2070,Turkana,RIFT VALLEY,7805
TURKANA NORTH,Urban,16,1070,850,1920,Turkana,RIFT VALLEY,7806
TURKANA NORTH,Urban,17,1023,747,1770,Turkana,RIFT VALLEY,7807
TURKANA NORTH,Urban,18,1345,962,2307,Turkana,RIFT VALLEY,7808
TURKANA NORTH,Urban,19,917,744,1661,Turkana,RIFT VALLEY,7809
TURKANA NORTH,Urban,20,1329,1302,2631,Turkana,RIFT VALLEY,7810
TURKANA NORTH,Urban,21,677,530,1207,Turkana,RIFT VALLEY,7811
TURKANA NORTH,Urban,22,826,714,1540,Turkana,RIFT VALLEY,7812
TURKANA NORTH,Urban,23,713,628,1341,Turkana,RIFT VALLEY,7813
TURKANA NORTH,Urban,24,697,616,1313,Turkana,RIFT VALLEY,7814
TURKANA NORTH,Urban,25,1013,912,1925,Turkana,RIFT VALLEY,7815
TURKANA NORTH,Urban,26,617,515,1132,Turkana,RIFT VALLEY,7816
TURKANA NORTH,Urban,27,606,520,1126,Turkana,RIFT VALLEY,7817
TURKANA NORTH,Urban,28,711,687,1398,Turkana,RIFT VALLEY,7818
TURKANA NORTH,Urban,29,593,552,1145,Turkana,RIFT VALLEY,7819
TURKANA NORTH,Urban,30,961,875,1836,Turkana,RIFT VALLEY,7820
TURKANA NORTH,Urban,31,292,253,545,Turkana,RIFT VALLEY,7821
TURKANA NORTH,Urban,32,492,400,892,Turkana,RIFT VALLEY,7822
TURKANA NORTH,Urban,33,270,250,520,Turkana,RIFT VALLEY,7823
TURKANA NORTH,Urban,34,346,280,626,Turkana,RIFT VALLEY,7824
TURKANA NORTH,Urban,35,570,584,1154,Turkana,RIFT VALLEY,7825
TURKANA NORTH,Urban,36,352,340,692,Turkana,RIFT VALLEY,7826
TURKANA NORTH,Urban,37,266,235,501,Turkana,RIFT VALLEY,7827
TURKANA NORTH,Urban,38,308,339,647,Turkana,RIFT VALLEY,7828
TURKANA NORTH,Urban,39,240,237,477,Turkana,RIFT VALLEY,7829
TURKANA NORTH,Urban,40,627,554,1181,Turkana,RIFT VALLEY,7830
TURKANA NORTH,Urban,41,116,112,228,Turkana,RIFT VALLEY,7831
TURKANA NORTH,Urban,42,248,179,427,Turkana,RIFT VALLEY,7832
TURKANA NORTH,Urban,43,148,141,289,Turkana,RIFT VALLEY,7833
TURKANA NORTH,Urban,44,103,88,191,Turkana,RIFT VALLEY,7834
TURKANA NORTH,Urban,45,337,285,622,Turkana,RIFT VALLEY,7835
TURKANA NORTH,Urban,46,122,99,221,Turkana,RIFT VALLEY,7836
TURKANA NORTH,Urban,47,128,91,219,Turkana,RIFT VALLEY,7837
TURKANA NORTH,Urban,48,159,121,280,Turkana,RIFT VALLEY,7838
TURKANA NORTH,Urban,49,146,142,288,Turkana,RIFT VALLEY,7839
TURKANA NORTH,Urban,50,281,309,590,Turkana,RIFT VALLEY,7840
TURKANA NORTH,Urban,51,94,88,182,Turkana,RIFT VALLEY,7841
TURKANA NORTH,Urban,52,101,99,200,Turkana,RIFT VALLEY,7842
TURKANA NORTH,Urban,53,63,81,144,Turkana,RIFT VALLEY,7843
TURKANA NORTH,Urban,54,80,84,164,Turkana,RIFT VALLEY,7844
TURKANA NORTH,Urban,55,98,126,224,Turkana,RIFT VALLEY,7845
TURKANA NORTH,Urban,56,70,76,146,Turkana,RIFT VALLEY,7846
TURKANA NORTH,Urban,57,72,109,181,Turkana,RIFT VALLEY,7847
TURKANA NORTH,Urban,58,54,60,114,Turkana,RIFT VALLEY,7848
TURKANA NORTH,Urban,59,60,81,141,Turkana,RIFT VALLEY,7849
TURKANA NORTH,Urban,60,142,162,304,Turkana,RIFT VALLEY,7850
TURKANA NORTH,Urban,61,40,33,73,Turkana,RIFT VALLEY,7851
TURKANA NORTH,Urban,62,34,55,89,Turkana,RIFT VALLEY,7852
TURKANA NORTH,Urban,63,26,40,66,Turkana,RIFT VALLEY,7853
TURKANA NORTH,Urban,64,29,57,86,Turkana,RIFT VALLEY,7854
TURKANA NORTH,Urban,65,60,80,140,Turkana,RIFT VALLEY,7855
TURKANA NORTH,Urban,66,17,20,37,Turkana,RIFT VALLEY,7856
TURKANA NORTH,Urban,67,27,25,52,Turkana,RIFT VALLEY,7857
TURKANA NORTH,Urban,68,21,41,62,Turkana,RIFT VALLEY,7858
TURKANA NORTH,Urban,69,30,49,79,Turkana,RIFT VALLEY,7859
TURKANA NORTH,Urban,70,70,86,156,Turkana,RIFT VALLEY,7860
TURKANA NORTH,Urban,71,9,20,29,Turkana,RIFT VALLEY,7861
TURKANA NORTH,Urban,72,17,25,42,Turkana,RIFT VALLEY,7862
TURKANA NORTH,Urban,73,13,14,27,Turkana,RIFT VALLEY,7863
TURKANA NORTH,Urban,74,10,19,29,Turkana,RIFT VALLEY,7864
TURKANA NORTH,Urban,75,33,37,70,Turkana,RIFT VALLEY,7865
TURKANA NORTH,Urban,76,11,5,16,Turkana,RIFT VALLEY,7866
TURKANA NORTH,Urban,77,5,10,15,Turkana,RIFT VALLEY,7867
TURKANA NORTH,Urban,78,10,8,18,Turkana,RIFT VALLEY,7868
TURKANA NORTH,Urban,79,13,17,30,Turkana,RIFT VALLEY,7869
TURKANA NORTH,Urban,80+,196,223,419,Turkana,RIFT VALLEY,7870
TURKANA NORTH,Urban,Age NS,23,15,38,Turkana,RIFT VALLEY,7871
TURKANA SOUTH,Urban,0,0,0,0,Turkana,RIFT VALLEY,7872
TURKANA SOUTH,Urban,1,0,0,0,Turkana,RIFT VALLEY,7873
TURKANA SOUTH,Urban,2,0,0,0,Turkana,RIFT VALLEY,7874
TURKANA SOUTH,Urban,3,0,0,0,Turkana,RIFT VALLEY,7875
TURKANA SOUTH,Urban,4,0,0,0,Turkana,RIFT VALLEY,7876
TURKANA SOUTH,Urban,5,0,0,0,Turkana,RIFT VALLEY,7877
TURKANA SOUTH,Urban,6,0,0,0,Turkana,RIFT VALLEY,7878
TURKANA SOUTH,Urban,7,0,0,0,Turkana,RIFT VALLEY,7879
TURKANA SOUTH,Urban,8,0,0,0,Turkana,RIFT VALLEY,7880
TURKANA SOUTH,Urban,9,0,0,0,Turkana,RIFT VALLEY,7881
TURKANA SOUTH,Urban,10,0,0,0,Turkana,RIFT VALLEY,7882
TURKANA SOUTH,Urban,11,0,0,0,Turkana,RIFT VALLEY,7883
TURKANA SOUTH,Urban,12,0,0,0,Turkana,RIFT VALLEY,7884
TURKANA SOUTH,Urban,13,0,0,0,Turkana,RIFT VALLEY,7885
TURKANA SOUTH,Urban,14,0,0,0,Turkana,RIFT VALLEY,7886
TURKANA SOUTH,Urban,15,0,0,0,Turkana,RIFT VALLEY,7887
TURKANA SOUTH,Urban,16,0,0,0,Turkana,RIFT VALLEY,7888
TURKANA SOUTH,Urban,17,0,0,0,Turkana,RIFT VALLEY,7889
TURKANA SOUTH,Urban,18,0,0,0,Turkana,RIFT VALLEY,7890
TURKANA SOUTH,Urban,19,0,0,0,Turkana,RIFT VALLEY,7891
TURKANA SOUTH,Urban,20,0,0,0,Turkana,RIFT VALLEY,7892
TURKANA SOUTH,Urban,21,0,0,0,Turkana,RIFT VALLEY,7893
TURKANA SOUTH,Urban,22,0,0,0,Turkana,RIFT VALLEY,7894
TURKANA SOUTH,Urban,23,0,0,0,Turkana,RIFT VALLEY,7895
TURKANA SOUTH,Urban,24,0,0,0,Turkana,RIFT VALLEY,7896
TURKANA SOUTH,Urban,25,0,0,0,Turkana,RIFT VALLEY,7897
TURKANA SOUTH,Urban,26,0,0,0,Turkana,RIFT VALLEY,7898
TURKANA SOUTH,Urban,27,0,0,0,Turkana,RIFT VALLEY,7899
TURKANA SOUTH,Urban,28,0,0,0,Turkana,RIFT VALLEY,7900
TURKANA SOUTH,Urban,29,0,0,0,Turkana,RIFT VALLEY,7901
TURKANA SOUTH,Urban,30,0,0,0,Turkana,RIFT VALLEY,7902
TURKANA SOUTH,Urban,31,0,0,0,Turkana,RIFT VALLEY,7903
TURKANA SOUTH,Urban,32,0,0,0,Turkana,RIFT VALLEY,7904
TURKANA SOUTH,Urban,33,0,0,0,Turkana,RIFT VALLEY,7905
TURKANA SOUTH,Urban,34,0,0,0,Turkana,RIFT VALLEY,7906
TURKANA SOUTH,Urban,35,0,0,0,Turkana,RIFT VALLEY,7907
TURKANA SOUTH,Urban,36,0,0,0,Turkana,RIFT VALLEY,7908
TURKANA SOUTH,Urban,37,0,0,0,Turkana,RIFT VALLEY,7909
TURKANA SOUTH,Urban,38,0,0,0,Turkana,RIFT VALLEY,7910
TURKANA SOUTH,Urban,39,0,0,0,Turkana,RIFT VALLEY,7911
TURKANA SOUTH,Urban,40,0,0,0,Turkana,RIFT VALLEY,7912
TURKANA SOUTH,Urban,41,0,0,0,Turkana,RIFT VALLEY,7913
TURKANA SOUTH,Urban,42,0,0,0,Turkana,RIFT VALLEY,7914
TURKANA SOUTH,Urban,43,0,0,0,Turkana,RIFT VALLEY,7915
TURKANA SOUTH,Urban,44,0,0,0,Turkana,RIFT VALLEY,7916
TURKANA SOUTH,Urban,45,0,0,0,Turkana,RIFT VALLEY,7917
TURKANA SOUTH,Urban,46,0,0,0,Turkana,RIFT VALLEY,7918
TURKANA SOUTH,Urban,47,0,0,0,Turkana,RIFT VALLEY,7919
TURKANA SOUTH,Urban,48,0,0,0,Turkana,RIFT VALLEY,7920
TURKANA SOUTH,Urban,49,0,0,0,Turkana,RIFT VALLEY,7921
TURKANA SOUTH,Urban,50,0,0,0,Turkana,RIFT VALLEY,7922
TURKANA SOUTH,Urban,51,0,0,0,Turkana,RIFT VALLEY,7923
TURKANA SOUTH,Urban,52,0,0,0,Turkana,RIFT VALLEY,7924
TURKANA SOUTH,Urban,53,0,0,0,Turkana,RIFT VALLEY,7925
TURKANA SOUTH,Urban,54,0,0,0,Turkana,RIFT VALLEY,7926
TURKANA SOUTH,Urban,55,0,0,0,Turkana,RIFT VALLEY,7927
TURKANA SOUTH,Urban,56,0,0,0,Turkana,RIFT VALLEY,7928
TURKANA SOUTH,Urban,57,0,0,0,Turkana,RIFT VALLEY,7929
TURKANA SOUTH,Urban,58,0,0,0,Turkana,RIFT VALLEY,7930
TURKANA SOUTH,Urban,59,0,0,0,Turkana,RIFT VALLEY,7931
TURKANA SOUTH,Urban,60,0,0,0,Turkana,RIFT VALLEY,7932
TURKANA SOUTH,Urban,61,0,0,0,Turkana,RIFT VALLEY,7933
TURKANA SOUTH,Urban,62,0,0,0,Turkana,RIFT VALLEY,7934
TURKANA SOUTH,Urban,63,0,0,0,Turkana,RIFT VALLEY,7935
TURKANA SOUTH,Urban,64,0,0,0,Turkana,RIFT VALLEY,7936
TURKANA SOUTH,Urban,65,0,0,0,Turkana,RIFT VALLEY,7937
TURKANA SOUTH,Urban,66,0,0,0,Turkana,RIFT VALLEY,7938
TURKANA SOUTH,Urban,67,0,0,0,Turkana,RIFT VALLEY,7939
TURKANA SOUTH,Urban,68,0,0,0,Turkana,RIFT VALLEY,7940
TURKANA SOUTH,Urban,69,0,0,0,Turkana,RIFT VALLEY,7941
TURKANA SOUTH,Urban,70,0,0,0,Turkana,RIFT VALLEY,7942
TURKANA SOUTH,Urban,71,0,0,0,Turkana,RIFT VALLEY,7943
TURKANA SOUTH,Urban,72,0,0,0,Turkana,RIFT VALLEY,7944
TURKANA SOUTH,Urban,73,0,0,0,Turkana,RIFT VALLEY,7945
TURKANA SOUTH,Urban,74,0,0,0,Turkana,RIFT VALLEY,7946
TURKANA SOUTH,Urban,75,0,0,0,Turkana,RIFT VALLEY,7947
TURKANA SOUTH,Urban,76,0,0,0,Turkana,RIFT VALLEY,7948
TURKANA SOUTH,Urban,77,0,0,0,Turkana,RIFT VALLEY,7949
TURKANA SOUTH,Urban,78,0,0,0,Turkana,RIFT VALLEY,7950
TURKANA SOUTH,Urban,79,0,0,0,Turkana,RIFT VALLEY,7951
TURKANA SOUTH,Urban,80+,0,0,0,Turkana,RIFT VALLEY,7952
TURKANA SOUTH,Urban,Age NS,0,0,0,Turkana,RIFT VALLEY,7953
WEST POKOT,Urban,0,820,753,1573,West Pokot,RIFT VALLEY,7954
WEST POKOT,Urban,1,723,681,1404,West Pokot,RIFT VALLEY,7955
WEST POKOT,Urban,2,750,797,1547,West Pokot,RIFT VALLEY,7956
WEST POKOT,Urban,3,737,758,1495,West Pokot,RIFT VALLEY,7957
WEST POKOT,Urban,4,726,708,1434,West Pokot,RIFT VALLEY,7958
WEST POKOT,Urban,5,720,711,1431,West Pokot,RIFT VALLEY,7959
WEST POKOT,Urban,6,679,708,1387,West Pokot,RIFT VALLEY,7960
WEST POKOT,Urban,7,633,668,1301,West Pokot,RIFT VALLEY,7961
WEST POKOT,Urban,8,583,665,1248,West Pokot,RIFT VALLEY,7962
WEST POKOT,Urban,9,608,567,1175,West Pokot,RIFT VALLEY,7963
WEST POKOT,Urban,10,712,709,1421,West Pokot,RIFT VALLEY,7964
WEST POKOT,Urban,11,415,510,925,West Pokot,RIFT VALLEY,7965
WEST POKOT,Urban,12,629,645,1274,West Pokot,RIFT VALLEY,7966
WEST POKOT,Urban,13,505,553,1058,West Pokot,RIFT VALLEY,7967
WEST POKOT,Urban,14,556,534,1090,West Pokot,RIFT VALLEY,7968
WEST POKOT,Urban,15,535,539,1074,West Pokot,RIFT VALLEY,7969
WEST POKOT,Urban,16,491,532,1023,West Pokot,RIFT VALLEY,7970
WEST POKOT,Urban,17,455,461,916,West Pokot,RIFT VALLEY,7971
WEST POKOT,Urban,18,519,489,1008,West Pokot,RIFT VALLEY,7972
WEST POKOT,Urban,19,390,390,780,West Pokot,RIFT VALLEY,7973
WEST POKOT,Urban,20,527,710,1237,West Pokot,RIFT VALLEY,7974
WEST POKOT,Urban,21,342,394,736,West Pokot,RIFT VALLEY,7975
WEST POKOT,Urban,22,455,492,947,West Pokot,RIFT VALLEY,7976
WEST POKOT,Urban,23,374,451,825,West Pokot,RIFT VALLEY,7977
WEST POKOT,Urban,24,371,426,797,West Pokot,RIFT VALLEY,7978
WEST POKOT,Urban,25,519,570,1089,West Pokot,RIFT VALLEY,7979
WEST POKOT,Urban,26,312,302,614,West Pokot,RIFT VALLEY,7980
WEST POKOT,Urban,27,325,353,678,West Pokot,RIFT VALLEY,7981
WEST POKOT,Urban,28,310,370,680,West Pokot,RIFT VALLEY,7982
WEST POKOT,Urban,29,251,233,484,West Pokot,RIFT VALLEY,7983
WEST POKOT,Urban,30,510,481,991,West Pokot,RIFT VALLEY,7984
WEST POKOT,Urban,31,220,175,395,West Pokot,RIFT VALLEY,7985
WEST POKOT,Urban,32,299,275,574,West Pokot,RIFT VALLEY,7986
WEST POKOT,Urban,33,175,164,339,West Pokot,RIFT VALLEY,7987
WEST POKOT,Urban,34,200,203,403,West Pokot,RIFT VALLEY,7988
WEST POKOT,Urban,35,365,320,685,West Pokot,RIFT VALLEY,7989
WEST POKOT,Urban,36,185,183,368,West Pokot,RIFT VALLEY,7990
WEST POKOT,Urban,37,182,179,361,West Pokot,RIFT VALLEY,7991
WEST POKOT,Urban,38,163,180,343,West Pokot,RIFT VALLEY,7992
WEST POKOT,Urban,39,180,147,327,West Pokot,RIFT VALLEY,7993
WEST POKOT,Urban,40,330,255,585,West Pokot,RIFT VALLEY,7994
WEST POKOT,Urban,41,106,90,196,West Pokot,RIFT VALLEY,7995
WEST POKOT,Urban,42,142,106,248,West Pokot,RIFT VALLEY,7996
WEST POKOT,Urban,43,88,80,168,West Pokot,RIFT VALLEY,7997
WEST POKOT,Urban,44,104,91,195,West Pokot,RIFT VALLEY,7998
WEST POKOT,Urban,45,191,185,376,West Pokot,RIFT VALLEY,7999
WEST POKOT,Urban,46,105,89,194,West Pokot,RIFT VALLEY,8000
WEST POKOT,Urban,47,91,83,174,West Pokot,RIFT VALLEY,8001
WEST POKOT,Urban,48,96,107,203,West Pokot,RIFT VALLEY,8002
WEST POKOT,Urban,49,98,61,159,West Pokot,RIFT VALLEY,8003
WEST POKOT,Urban,50,186,162,348,West Pokot,RIFT VALLEY,8004
WEST POKOT,Urban,51,72,52,124,West Pokot,RIFT VALLEY,8005
WEST POKOT,Urban,52,62,67,129,West Pokot,RIFT VALLEY,8006
WEST POKOT,Urban,53,66,62,128,West Pokot,RIFT VALLEY,8007
WEST POKOT,Urban,54,62,58,120,West Pokot,RIFT VALLEY,8008
WEST POKOT,Urban,55,86,83,169,West Pokot,RIFT VALLEY,8009
WEST POKOT,Urban,56,63,50,113,West Pokot,RIFT VALLEY,8010
WEST POKOT,Urban,57,80,51,131,West Pokot,RIFT VALLEY,8011
WEST POKOT,Urban,58,38,34,72,West Pokot,RIFT VALLEY,8012
WEST POKOT,Urban,59,54,41,95,West Pokot,RIFT VALLEY,8013
WEST POKOT,Urban,60,91,118,209,West Pokot,RIFT VALLEY,8014
WEST POKOT,Urban,61,40,34,74,West Pokot,RIFT VALLEY,8015
WEST POKOT,Urban,62,28,20,48,West Pokot,RIFT VALLEY,8016
WEST POKOT,Urban,63,18,24,42,West Pokot,RIFT VALLEY,8017
WEST POKOT,Urban,64,29,31,60,West Pokot,RIFT VALLEY,8018
WEST POKOT,Urban,65,41,56,97,West Pokot,RIFT VALLEY,8019
WEST POKOT,Urban,66,17,18,35,West Pokot,RIFT VALLEY,8020
WEST POKOT,Urban,67,14,19,33,West Pokot,RIFT VALLEY,8021
WEST POKOT,Urban,68,14,18,32,West Pokot,RIFT VALLEY,8022
WEST POKOT,Urban,69,29,35,64,West Pokot,RIFT VALLEY,8023
WEST POKOT,Urban,70,50,68,118,West Pokot,RIFT VALLEY,8024
WEST POKOT,Urban,71,21,19,40,West Pokot,RIFT VALLEY,8025
WEST POKOT,Urban,72,15,14,29,West Pokot,RIFT VALLEY,8026
WEST POKOT,Urban,73,12,13,25,West Pokot,RIFT VALLEY,8027
WEST POKOT,Urban,74,11,15,26,West Pokot,RIFT VALLEY,8028
WEST POKOT,Urban,75,22,18,40,West Pokot,RIFT VALLEY,8029
WEST POKOT,Urban,76,14,3,17,West Pokot,RIFT VALLEY,8030
WEST POKOT,Urban,77,10,4,14,West Pokot,RIFT VALLEY,8031
WEST POKOT,Urban,78,11,3,14,West Pokot,RIFT VALLEY,8032
WEST POKOT,Urban,79,13,9,22,West Pokot,RIFT VALLEY,8033
WEST POKOT,Urban,80+,103,173,276,West Pokot,RIFT VALLEY,8034
WEST POKOT,Urban,Age NS,7,10,17,West Pokot,RIFT VALLEY,8035
POKOT NORTH,Urban,0,0,0,0,West Pokot,RIFT VALLEY,8036
POKOT NORTH,Urban,1,0,0,0,West Pokot,RIFT VALLEY,8037
POKOT NORTH,Urban,2,0,0,0,West Pokot,RIFT VALLEY,8038
POKOT NORTH,Urban,3,0,0,0,West Pokot,RIFT VALLEY,8039
POKOT NORTH,Urban,4,0,0,0,West Pokot,RIFT VALLEY,8040
POKOT NORTH,Urban,5,0,0,0,West Pokot,RIFT VALLEY,8041
POKOT NORTH,Urban,6,0,0,0,West Pokot,RIFT VALLEY,8042
POKOT NORTH,Urban,7,0,0,0,West Pokot,RIFT VALLEY,8043
POKOT NORTH,Urban,8,0,0,0,West Pokot,RIFT VALLEY,8044
POKOT NORTH,Urban,9,0,0,0,West Pokot,RIFT VALLEY,8045
POKOT NORTH,Urban,10,0,0,0,West Pokot,RIFT VALLEY,8046
POKOT NORTH,Urban,11,0,0,0,West Pokot,RIFT VALLEY,8047
POKOT NORTH,Urban,12,0,0,0,West Pokot,RIFT VALLEY,8048
POKOT NORTH,Urban,13,0,0,0,West Pokot,RIFT VALLEY,8049
POKOT NORTH,Urban,14,0,0,0,West Pokot,RIFT VALLEY,8050
POKOT NORTH,Urban,15,0,0,0,West Pokot,RIFT VALLEY,8051
POKOT NORTH,Urban,16,0,0,0,West Pokot,RIFT VALLEY,8052
POKOT NORTH,Urban,17,0,0,0,West Pokot,RIFT VALLEY,8053
POKOT NORTH,Urban,18,0,0,0,West Pokot,RIFT VALLEY,8054
POKOT NORTH,Urban,19,0,0,0,West Pokot,RIFT VALLEY,8055
POKOT NORTH,Urban,20,0,0,0,West Pokot,RIFT VALLEY,8056
POKOT NORTH,Urban,21,0,0,0,West Pokot,RIFT VALLEY,8057
POKOT NORTH,Urban,22,0,0,0,West Pokot,RIFT VALLEY,8058
POKOT NORTH,Urban,23,0,0,0,West Pokot,RIFT VALLEY,8059
POKOT NORTH,Urban,24,0,0,0,West Pokot,RIFT VALLEY,8060
POKOT NORTH,Urban,25,0,0,0,West Pokot,RIFT VALLEY,8061
POKOT NORTH,Urban,26,0,0,0,West Pokot,RIFT VALLEY,8062
POKOT NORTH,Urban,27,0,0,0,West Pokot,RIFT VALLEY,8063
POKOT NORTH,Urban,28,0,0,0,West Pokot,RIFT VALLEY,8064
POKOT NORTH,Urban,29,0,0,0,West Pokot,RIFT VALLEY,8065
POKOT NORTH,Urban,30,0,0,0,West Pokot,RIFT VALLEY,8066
POKOT NORTH,Urban,31,0,0,0,West Pokot,RIFT VALLEY,8067
POKOT NORTH,Urban,32,0,0,0,West Pokot,RIFT VALLEY,8068
POKOT NORTH,Urban,33,0,0,0,West Pokot,RIFT VALLEY,8069
POKOT NORTH,Urban,34,0,0,0,West Pokot,RIFT VALLEY,8070
POKOT NORTH,Urban,35,0,0,0,West Pokot,RIFT VALLEY,8071
POKOT NORTH,Urban,36,0,0,0,West Pokot,RIFT VALLEY,8072
POKOT NORTH,Urban,37,0,0,0,West Pokot,RIFT VALLEY,8073
POKOT NORTH,Urban,38,0,0,0,West Pokot,RIFT VALLEY,8074
POKOT NORTH,Urban,39,0,0,0,West Pokot,RIFT VALLEY,8075
POKOT NORTH,Urban,40,0,0,0,West Pokot,RIFT VALLEY,8076
POKOT NORTH,Urban,41,0,0,0,West Pokot,RIFT VALLEY,8077
POKOT NORTH,Urban,42,0,0,0,West Pokot,RIFT VALLEY,8078
POKOT NORTH,Urban,43,0,0,0,West Pokot,RIFT VALLEY,8079
POKOT NORTH,Urban,44,0,0,0,West Pokot,RIFT VALLEY,8080
POKOT NORTH,Urban,45,0,0,0,West Pokot,RIFT VALLEY,8081
POKOT NORTH,Urban,46,0,0,0,West Pokot,RIFT VALLEY,8082
POKOT NORTH,Urban,47,0,0,0,West Pokot,RIFT VALLEY,8083
POKOT NORTH,Urban,48,0,0,0,West Pokot,RIFT VALLEY,8084
POKOT NORTH,Urban,49,0,0,0,West Pokot,RIFT VALLEY,8085
POKOT NORTH,Urban,50,0,0,0,West Pokot,RIFT VALLEY,8086
POKOT NORTH,Urban,51,0,0,0,West Pokot,RIFT VALLEY,8087
POKOT NORTH,Urban,52,0,0,0,West Pokot,RIFT VALLEY,8088
POKOT NORTH,Urban,53,0,0,0,West Pokot,RIFT VALLEY,8089
POKOT NORTH,Urban,54,0,0,0,West Pokot,RIFT VALLEY,8090
POKOT NORTH,Urban,55,0,0,0,West Pokot,RIFT VALLEY,8091
POKOT NORTH,Urban,56,0,0,0,West Pokot,RIFT VALLEY,8092
POKOT NORTH,Urban,57,0,0,0,West Pokot,RIFT VALLEY,8093
POKOT NORTH,Urban,58,0,0,0,West Pokot,RIFT VALLEY,8094
POKOT NORTH,Urban,59,0,0,0,West Pokot,RIFT VALLEY,8095
POKOT NORTH,Urban,60,0,0,0,West Pokot,RIFT VALLEY,8096
POKOT NORTH,Urban,61,0,0,0,West Pokot,RIFT VALLEY,8097
POKOT NORTH,Urban,62,0,0,0,West Pokot,RIFT VALLEY,8098
POKOT NORTH,Urban,63,0,0,0,West Pokot,RIFT VALLEY,8099
POKOT NORTH,Urban,64,0,0,0,West Pokot,RIFT VALLEY,8100
POKOT NORTH,Urban,65,0,0,0,West Pokot,RIFT VALLEY,8101
POKOT NORTH,Urban,66,0,0,0,West Pokot,RIFT VALLEY,8102
POKOT NORTH,Urban,67,0,0,0,West Pokot,RIFT VALLEY,8103
POKOT NORTH,Urban,68,0,0,0,West Pokot,RIFT VALLEY,8104
POKOT NORTH,Urban,69,0,0,0,West Pokot,RIFT VALLEY,8105
POKOT NORTH,Urban,70,0,0,0,West Pokot,RIFT VALLEY,8106
POKOT NORTH,Urban,71,0,0,0,West Pokot,RIFT VALLEY,8107
POKOT NORTH,Urban,72,0,0,0,West Pokot,RIFT VALLEY,8108
POKOT NORTH,Urban,73,0,0,0,West Pokot,RIFT VALLEY,8109
POKOT NORTH,Urban,74,0,0,0,West Pokot,RIFT VALLEY,8110
POKOT NORTH,Urban,75,0,0,0,West Pokot,RIFT VALLEY,8111
POKOT NORTH,Urban,76,0,0,0,West Pokot,RIFT VALLEY,8112
POKOT NORTH,Urban,77,0,0,0,West Pokot,RIFT VALLEY,8113
POKOT NORTH,Urban,78,0,0,0,West Pokot,RIFT VALLEY,8114
POKOT NORTH,Urban,79,0,0,0,West Pokot,RIFT VALLEY,8115
POKOT NORTH,Urban,80+,0,0,0,West Pokot,RIFT VALLEY,8116
POKOT NORTH,Urban,Age NS,0,0,0,West Pokot,RIFT VALLEY,8117
POKOT CENTRAL,Urban,0,0,0,0,West Pokot,RIFT VALLEY,8118
POKOT CENTRAL,Urban,1,0,0,0,West Pokot,RIFT VALLEY,8119
POKOT CENTRAL,Urban,2,0,0,0,West Pokot,RIFT VALLEY,8120
POKOT CENTRAL,Urban,3,0,0,0,West Pokot,RIFT VALLEY,8121
POKOT CENTRAL,Urban,4,0,0,0,West Pokot,RIFT VALLEY,8122
POKOT CENTRAL,Urban,5,0,0,0,West Pokot,RIFT VALLEY,8123
POKOT CENTRAL,Urban,6,0,0,0,West Pokot,RIFT VALLEY,8124
POKOT CENTRAL,Urban,7,0,0,0,West Pokot,RIFT VALLEY,8125
POKOT CENTRAL,Urban,8,0,0,0,West Pokot,RIFT VALLEY,8126
POKOT CENTRAL,Urban,9,0,0,0,West Pokot,RIFT VALLEY,8127
POKOT CENTRAL,Urban,10,0,0,0,West Pokot,RIFT VALLEY,8128
POKOT CENTRAL,Urban,11,0,0,0,West Pokot,RIFT VALLEY,8129
POKOT CENTRAL,Urban,12,0,0,0,West Pokot,RIFT VALLEY,8130
POKOT CENTRAL,Urban,13,0,0,0,West Pokot,RIFT VALLEY,8131
POKOT CENTRAL,Urban,14,0,0,0,West Pokot,RIFT VALLEY,8132
POKOT CENTRAL,Urban,15,0,0,0,West Pokot,RIFT VALLEY,8133
POKOT CENTRAL,Urban,16,0,0,0,West Pokot,RIFT VALLEY,8134
POKOT CENTRAL,Urban,17,0,0,0,West Pokot,RIFT VALLEY,8135
POKOT CENTRAL,Urban,18,0,0,0,West Pokot,RIFT VALLEY,8136
POKOT CENTRAL,Urban,19,0,0,0,West Pokot,RIFT VALLEY,8137
POKOT CENTRAL,Urban,20,0,0,0,West Pokot,RIFT VALLEY,8138
POKOT CENTRAL,Urban,21,0,0,0,West Pokot,RIFT VALLEY,8139
POKOT CENTRAL,Urban,22,0,0,0,West Pokot,RIFT VALLEY,8140
POKOT CENTRAL,Urban,23,0,0,0,West Pokot,RIFT VALLEY,8141
POKOT CENTRAL,Urban,24,0,0,0,West Pokot,RIFT VALLEY,8142
POKOT CENTRAL,Urban,25,0,0,0,West Pokot,RIFT VALLEY,8143
POKOT CENTRAL,Urban,26,0,0,0,West Pokot,RIFT VALLEY,8144
POKOT CENTRAL,Urban,27,0,0,0,West Pokot,RIFT VALLEY,8145
POKOT CENTRAL,Urban,28,0,0,0,West Pokot,RIFT VALLEY,8146
POKOT CENTRAL,Urban,29,0,0,0,West Pokot,RIFT VALLEY,8147
POKOT CENTRAL,Urban,30,0,0,0,West Pokot,RIFT VALLEY,8148
POKOT CENTRAL,Urban,31,0,0,0,West Pokot,RIFT VALLEY,8149
POKOT CENTRAL,Urban,32,0,0,0,West Pokot,RIFT VALLEY,8150
POKOT CENTRAL,Urban,33,0,0,0,West Pokot,RIFT VALLEY,8151
POKOT CENTRAL,Urban,34,0,0,0,West Pokot,RIFT VALLEY,8152
POKOT CENTRAL,Urban,35,0,0,0,West Pokot,RIFT VALLEY,8153
POKOT CENTRAL,Urban,36,0,0,0,West Pokot,RIFT VALLEY,8154
POKOT CENTRAL,Urban,37,0,0,0,West Pokot,RIFT VALLEY,8155
POKOT CENTRAL,Urban,38,0,0,0,West Pokot,RIFT VALLEY,8156
POKOT CENTRAL,Urban,39,0,0,0,West Pokot,RIFT VALLEY,8157
POKOT CENTRAL,Urban,40,0,0,0,West Pokot,RIFT VALLEY,8158
POKOT CENTRAL,Urban,41,0,0,0,West Pokot,RIFT VALLEY,8159
POKOT CENTRAL,Urban,42,0,0,0,West Pokot,RIFT VALLEY,8160
POKOT CENTRAL,Urban,43,0,0,0,West Pokot,RIFT VALLEY,8161
POKOT CENTRAL,Urban,44,0,0,0,West Pokot,RIFT VALLEY,8162
POKOT CENTRAL,Urban,45,0,0,0,West Pokot,RIFT VALLEY,8163
POKOT CENTRAL,Urban,46,0,0,0,West Pokot,RIFT VALLEY,8164
POKOT CENTRAL,Urban,47,0,0,0,West Pokot,RIFT VALLEY,8165
POKOT CENTRAL,Urban,48,0,0,0,West Pokot,RIFT VALLEY,8166
POKOT CENTRAL,Urban,49,0,0,0,West Pokot,RIFT VALLEY,8167
POKOT CENTRAL,Urban,50,0,0,0,West Pokot,RIFT VALLEY,8168
POKOT CENTRAL,Urban,51,0,0,0,West Pokot,RIFT VALLEY,8169
POKOT CENTRAL,Urban,52,0,0,0,West Pokot,RIFT VALLEY,8170
POKOT CENTRAL,Urban,53,0,0,0,West Pokot,RIFT VALLEY,8171
POKOT CENTRAL,Urban,54,0,0,0,West Pokot,RIFT VALLEY,8172
POKOT CENTRAL,Urban,55,0,0,0,West Pokot,RIFT VALLEY,8173
POKOT CENTRAL,Urban,56,0,0,0,West Pokot,RIFT VALLEY,8174
POKOT CENTRAL,Urban,57,0,0,0,West Pokot,RIFT VALLEY,8175
POKOT CENTRAL,Urban,58,0,0,0,West Pokot,RIFT VALLEY,8176
POKOT CENTRAL,Urban,59,0,0,0,West Pokot,RIFT VALLEY,8177
POKOT CENTRAL,Urban,60,0,0,0,West Pokot,RIFT VALLEY,8178
POKOT CENTRAL,Urban,61,0,0,0,West Pokot,RIFT VALLEY,8179
POKOT CENTRAL,Urban,62,0,0,0,West Pokot,RIFT VALLEY,8180
POKOT CENTRAL,Urban,63,0,0,0,West Pokot,RIFT VALLEY,8181
POKOT CENTRAL,Urban,64,0,0,0,West Pokot,RIFT VALLEY,8182
POKOT CENTRAL,Urban,65,0,0,0,West Pokot,RIFT VALLEY,8183
POKOT CENTRAL,Urban,66,0,0,0,West Pokot,RIFT VALLEY,8184
POKOT CENTRAL,Urban,67,0,0,0,West Pokot,RIFT VALLEY,8185
POKOT CENTRAL,Urban,68,0,0,0,West Pokot,RIFT VALLEY,8186
POKOT CENTRAL,Urban,69,0,0,0,West Pokot,RIFT VALLEY,8187
POKOT CENTRAL,Urban,70,0,0,0,West Pokot,RIFT VALLEY,8188
POKOT CENTRAL,Urban,71,0,0,0,West Pokot,RIFT VALLEY,8189
POKOT CENTRAL,Urban,72,0,0,0,West Pokot,RIFT VALLEY,8190
POKOT CENTRAL,Urban,73,0,0,0,West Pokot,RIFT VALLEY,8191
POKOT CENTRAL,Urban,74,0,0,0,West Pokot,RIFT VALLEY,8192
POKOT CENTRAL,Urban,75,0,0,0,West Pokot,RIFT VALLEY,8193
POKOT CENTRAL,Urban,76,0,0,0,West Pokot,RIFT VALLEY,8194
POKOT CENTRAL,Urban,77,0,0,0,West Pokot,RIFT VALLEY,8195
POKOT CENTRAL,Urban,78,0,0,0,West Pokot,RIFT VALLEY,8196
POKOT CENTRAL,Urban,79,0,0,0,West Pokot,RIFT VALLEY,8197
POKOT CENTRAL,Urban,80+,0,0,0,West Pokot,RIFT VALLEY,8198
POKOT CENTRAL,Urban,Age NS,0,0,0,West Pokot,RIFT VALLEY,8199
SAMBURU CENTRAL,Urban,0,297,303,600,Samburu,RIFT VALLEY,8200
SAMBURU CENTRAL,Urban,1,273,275,548,Samburu,RIFT VALLEY,8201
SAMBURU CENTRAL,Urban,2,267,272,539,Samburu,RIFT VALLEY,8202
SAMBURU CENTRAL,Urban,3,297,299,596,Samburu,RIFT VALLEY,8203
SAMBURU CENTRAL,Urban,4,275,281,556,Samburu,RIFT VALLEY,8204
SAMBURU CENTRAL,Urban,5,277,273,550,Samburu,RIFT VALLEY,8205
SAMBURU CENTRAL,Urban,6,268,289,557,Samburu,RIFT VALLEY,8206
SAMBURU CENTRAL,Urban,7,262,281,543,Samburu,RIFT VALLEY,8207
SAMBURU CENTRAL,Urban,8,198,224,422,Samburu,RIFT VALLEY,8208
SAMBURU CENTRAL,Urban,9,250,249,499,Samburu,RIFT VALLEY,8209
SAMBURU CENTRAL,Urban,10,238,253,491,Samburu,RIFT VALLEY,8210
SAMBURU CENTRAL,Urban,11,184,187,371,Samburu,RIFT VALLEY,8211
SAMBURU CENTRAL,Urban,12,265,249,514,Samburu,RIFT VALLEY,8212
SAMBURU CENTRAL,Urban,13,241,257,498,Samburu,RIFT VALLEY,8213
SAMBURU CENTRAL,Urban,14,244,249,493,Samburu,RIFT VALLEY,8214
SAMBURU CENTRAL,Urban,15,219,247,466,Samburu,RIFT VALLEY,8215
SAMBURU CENTRAL,Urban,16,203,222,425,Samburu,RIFT VALLEY,8216
SAMBURU CENTRAL,Urban,17,216,211,427,Samburu,RIFT VALLEY,8217
SAMBURU CENTRAL,Urban,18,213,212,425,Samburu,RIFT VALLEY,8218
SAMBURU CENTRAL,Urban,19,190,207,397,Samburu,RIFT VALLEY,8219
SAMBURU CENTRAL,Urban,20,214,304,518,Samburu,RIFT VALLEY,8220
SAMBURU CENTRAL,Urban,21,155,191,346,Samburu,RIFT VALLEY,8221
SAMBURU CENTRAL,Urban,22,179,225,404,Samburu,RIFT VALLEY,8222
SAMBURU CENTRAL,Urban,23,176,203,379,Samburu,RIFT VALLEY,8223
SAMBURU CENTRAL,Urban,24,180,176,356,Samburu,RIFT VALLEY,8224
SAMBURU CENTRAL,Urban,25,226,281,507,Samburu,RIFT VALLEY,8225
SAMBURU CENTRAL,Urban,26,160,183,343,Samburu,RIFT VALLEY,8226
SAMBURU CENTRAL,Urban,27,182,160,342,Samburu,RIFT VALLEY,8227
SAMBURU CENTRAL,Urban,28,159,185,344,Samburu,RIFT VALLEY,8228
SAMBURU CENTRAL,Urban,29,125,106,231,Samburu,RIFT VALLEY,8229
SAMBURU CENTRAL,Urban,30,269,230,499,Samburu,RIFT VALLEY,8230
SAMBURU CENTRAL,Urban,31,100,83,183,Samburu,RIFT VALLEY,8231
SAMBURU CENTRAL,Urban,32,173,125,298,Samburu,RIFT VALLEY,8232
SAMBURU CENTRAL,Urban,33,71,81,152,Samburu,RIFT VALLEY,8233
SAMBURU CENTRAL,Urban,34,99,86,185,Samburu,RIFT VALLEY,8234
SAMBURU CENTRAL,Urban,35,196,164,360,Samburu,RIFT VALLEY,8235
SAMBURU CENTRAL,Urban,36,98,89,187,Samburu,RIFT VALLEY,8236
SAMBURU CENTRAL,Urban,37,70,60,130,Samburu,RIFT VALLEY,8237
SAMBURU CENTRAL,Urban,38,90,93,183,Samburu,RIFT VALLEY,8238
SAMBURU CENTRAL,Urban,39,59,50,109,Samburu,RIFT VALLEY,8239
SAMBURU CENTRAL,Urban,40,133,126,259,Samburu,RIFT VALLEY,8240
SAMBURU CENTRAL,Urban,41,32,16,48,Samburu,RIFT VALLEY,8241
SAMBURU CENTRAL,Urban,42,66,50,116,Samburu,RIFT VALLEY,8242
SAMBURU CENTRAL,Urban,43,42,44,86,Samburu,RIFT VALLEY,8243
SAMBURU CENTRAL,Urban,44,38,24,62,Samburu,RIFT VALLEY,8244
SAMBURU CENTRAL,Urban,45,85,95,180,Samburu,RIFT VALLEY,8245
SAMBURU CENTRAL,Urban,46,44,30,74,Samburu,RIFT VALLEY,8246
SAMBURU CENTRAL,Urban,47,45,21,66,Samburu,RIFT VALLEY,8247
SAMBURU CENTRAL,Urban,48,60,28,88,Samburu,RIFT VALLEY,8248
SAMBURU CENTRAL,Urban,49,43,34,77,Samburu,RIFT VALLEY,8249
SAMBURU CENTRAL,Urban,50,70,79,149,Samburu,RIFT VALLEY,8250
SAMBURU CENTRAL,Urban,51,31,18,49,Samburu,RIFT VALLEY,8251
SAMBURU CENTRAL,Urban,52,40,20,60,Samburu,RIFT VALLEY,8252
SAMBURU CENTRAL,Urban,53,14,15,29,Samburu,RIFT VALLEY,8253
SAMBURU CENTRAL,Urban,54,27,18,45,Samburu,RIFT VALLEY,8254
SAMBURU CENTRAL,Urban,55,40,29,69,Samburu,RIFT VALLEY,8255
SAMBURU CENTRAL,Urban,56,16,8,24,Samburu,RIFT VALLEY,8256
SAMBURU CENTRAL,Urban,57,21,13,34,Samburu,RIFT VALLEY,8257
SAMBURU CENTRAL,Urban,58,17,18,35,Samburu,RIFT VALLEY,8258
SAMBURU CENTRAL,Urban,59,12,9,21,Samburu,RIFT VALLEY,8259
SAMBURU CENTRAL,Urban,60,36,54,90,Samburu,RIFT VALLEY,8260
SAMBURU CENTRAL,Urban,61,18,24,42,Samburu,RIFT VALLEY,8261
SAMBURU CENTRAL,Urban,62,16,10,26,Samburu,RIFT VALLEY,8262
SAMBURU CENTRAL,Urban,63,14,9,23,Samburu,RIFT VALLEY,8263
SAMBURU CENTRAL,Urban,64,12,13,25,Samburu,RIFT VALLEY,8264
SAMBURU CENTRAL,Urban,65,25,31,56,Samburu,RIFT VALLEY,8265
SAMBURU CENTRAL,Urban,66,5,4,9,Samburu,RIFT VALLEY,8266
SAMBURU CENTRAL,Urban,67,3,13,16,Samburu,RIFT VALLEY,8267
SAMBURU CENTRAL,Urban,68,5,5,10,Samburu,RIFT VALLEY,8268
SAMBURU CENTRAL,Urban,69,10,5,15,Samburu,RIFT VALLEY,8269
SAMBURU CENTRAL,Urban,70,31,39,70,Samburu,RIFT VALLEY,8270
SAMBURU CENTRAL,Urban,71,2,5,7,Samburu,RIFT VALLEY,8271
SAMBURU CENTRAL,Urban,72,4,6,10,Samburu,RIFT VALLEY,8272
SAMBURU CENTRAL,Urban,73,8,9,17,Samburu,RIFT VALLEY,8273
SAMBURU CENTRAL,Urban,74,8,8,16,Samburu,RIFT VALLEY,8274
SAMBURU CENTRAL,Urban,75,12,9,21,Samburu,RIFT VALLEY,8275
SAMBURU CENTRAL,Urban,76,1,7,8,Samburu,RIFT VALLEY,8276
SAMBURU CENTRAL,Urban,77,2,7,9,Samburu,RIFT VALLEY,8277
SAMBURU CENTRAL,Urban,78,3,5,8,Samburu,RIFT VALLEY,8278
SAMBURU CENTRAL,Urban,79,3,6,9,Samburu,RIFT VALLEY,8279
SAMBURU CENTRAL,Urban,80+,47,70,117,Samburu,RIFT VALLEY,8280
SAMBURU CENTRAL,Urban,Age NS,2,0,2,Samburu,RIFT VALLEY,8281
SAMBURU EAST,Urban,0,280,241,521,Samburu,RIFT VALLEY,8282
SAMBURU EAST,Urban,1,171,143,314,Samburu,RIFT VALLEY,8283
SAMBURU EAST,Urban,2,228,240,468,Samburu,RIFT VALLEY,8284
SAMBURU EAST,Urban,3,244,229,473,Samburu,RIFT VALLEY,8285
SAMBURU EAST,Urban,4,186,237,423,Samburu,RIFT VALLEY,8286
SAMBURU EAST,Urban,5,221,208,429,Samburu,RIFT VALLEY,8287
SAMBURU EAST,Urban,6,205,179,384,Samburu,RIFT VALLEY,8288
SAMBURU EAST,Urban,7,194,198,392,Samburu,RIFT VALLEY,8289
SAMBURU EAST,Urban,8,182,171,353,Samburu,RIFT VALLEY,8290
SAMBURU EAST,Urban,9,172,155,327,Samburu,RIFT VALLEY,8291
SAMBURU EAST,Urban,10,176,214,390,Samburu,RIFT VALLEY,8292
SAMBURU EAST,Urban,11,118,121,239,Samburu,RIFT VALLEY,8293
SAMBURU EAST,Urban,12,180,172,352,Samburu,RIFT VALLEY,8294
SAMBURU EAST,Urban,13,163,165,328,Samburu,RIFT VALLEY,8295
SAMBURU EAST,Urban,14,154,151,305,Samburu,RIFT VALLEY,8296
SAMBURU EAST,Urban,15,156,134,290,Samburu,RIFT VALLEY,8297
SAMBURU EAST,Urban,16,132,119,251,Samburu,RIFT VALLEY,8298
SAMBURU EAST,Urban,17,155,120,275,Samburu,RIFT VALLEY,8299
SAMBURU EAST,Urban,18,135,130,265,Samburu,RIFT VALLEY,8300
SAMBURU EAST,Urban,19,99,118,217,Samburu,RIFT VALLEY,8301
SAMBURU EAST,Urban,20,173,184,357,Samburu,RIFT VALLEY,8302
SAMBURU EAST,Urban,21,126,117,243,Samburu,RIFT VALLEY,8303
SAMBURU EAST,Urban,22,117,171,288,Samburu,RIFT VALLEY,8304
SAMBURU EAST,Urban,23,118,129,247,Samburu,RIFT VALLEY,8305
SAMBURU EAST,Urban,24,108,114,222,Samburu,RIFT VALLEY,8306
SAMBURU EAST,Urban,25,149,156,305,Samburu,RIFT VALLEY,8307
SAMBURU EAST,Urban,26,97,86,183,Samburu,RIFT VALLEY,8308
SAMBURU EAST,Urban,27,119,93,212,Samburu,RIFT VALLEY,8309
SAMBURU EAST,Urban,28,70,90,160,Samburu,RIFT VALLEY,8310
SAMBURU EAST,Urban,29,81,68,149,Samburu,RIFT VALLEY,8311
SAMBURU EAST,Urban,30,151,138,289,Samburu,RIFT VALLEY,8312
SAMBURU EAST,Urban,31,77,65,142,Samburu,RIFT VALLEY,8313
SAMBURU EAST,Urban,32,86,91,177,Samburu,RIFT VALLEY,8314
SAMBURU EAST,Urban,33,66,56,122,Samburu,RIFT VALLEY,8315
SAMBURU EAST,Urban,34,52,49,101,Samburu,RIFT VALLEY,8316
SAMBURU EAST,Urban,35,115,91,206,Samburu,RIFT VALLEY,8317
SAMBURU EAST,Urban,36,66,42,108,Samburu,RIFT VALLEY,8318
SAMBURU EAST,Urban,37,56,51,107,Samburu,RIFT VALLEY,8319
SAMBURU EAST,Urban,38,59,60,119,Samburu,RIFT VALLEY,8320
SAMBURU EAST,Urban,39,50,38,88,Samburu,RIFT VALLEY,8321
SAMBURU EAST,Urban,40,90,70,160,Samburu,RIFT VALLEY,8322
SAMBURU EAST,Urban,41,25,21,46,Samburu,RIFT VALLEY,8323
SAMBURU EAST,Urban,42,54,28,82,Samburu,RIFT VALLEY,8324
SAMBURU EAST,Urban,43,32,19,51,Samburu,RIFT VALLEY,8325
SAMBURU EAST,Urban,44,31,32,63,Samburu,RIFT VALLEY,8326
SAMBURU EAST,Urban,45,60,37,97,Samburu,RIFT VALLEY,8327
SAMBURU EAST,Urban,46,33,32,65,Samburu,RIFT VALLEY,8328
SAMBURU EAST,Urban,47,39,19,58,Samburu,RIFT VALLEY,8329
SAMBURU EAST,Urban,48,34,24,58,Samburu,RIFT VALLEY,8330
SAMBURU EAST,Urban,49,27,42,69,Samburu,RIFT VALLEY,8331
SAMBURU EAST,Urban,50,50,42,92,Samburu,RIFT VALLEY,8332
SAMBURU EAST,Urban,51,25,16,41,Samburu,RIFT VALLEY,8333
SAMBURU EAST,Urban,52,24,19,43,Samburu,RIFT VALLEY,8334
SAMBURU EAST,Urban,53,16,10,26,Samburu,RIFT VALLEY,8335
SAMBURU EAST,Urban,54,23,23,46,Samburu,RIFT VALLEY,8336
SAMBURU EAST,Urban,55,16,22,38,Samburu,RIFT VALLEY,8337
SAMBURU EAST,Urban,56,13,16,29,Samburu,RIFT VALLEY,8338
SAMBURU EAST,Urban,57,15,21,36,Samburu,RIFT VALLEY,8339
SAMBURU EAST,Urban,58,10,13,23,Samburu,RIFT VALLEY,8340
SAMBURU EAST,Urban,59,15,14,29,Samburu,RIFT VALLEY,8341
SAMBURU EAST,Urban,60,33,43,76,Samburu,RIFT VALLEY,8342
SAMBURU EAST,Urban,61,14,18,32,Samburu,RIFT VALLEY,8343
SAMBURU EAST,Urban,62,9,11,20,Samburu,RIFT VALLEY,8344
SAMBURU EAST,Urban,63,19,16,35,Samburu,RIFT VALLEY,8345
SAMBURU EAST,Urban,64,14,11,25,Samburu,RIFT VALLEY,8346
SAMBURU EAST,Urban,65,20,24,44,Samburu,RIFT VALLEY,8347
SAMBURU EAST,Urban,66,6,7,13,Samburu,RIFT VALLEY,8348
SAMBURU EAST,Urban,67,5,7,12,Samburu,RIFT VALLEY,8349
SAMBURU EAST,Urban,68,4,10,14,Samburu,RIFT VALLEY,8350
SAMBURU EAST,Urban,69,11,12,23,Samburu,RIFT VALLEY,8351
SAMBURU EAST,Urban,70,11,22,33,Samburu,RIFT VALLEY,8352
SAMBURU EAST,Urban,71,6,7,13,Samburu,RIFT VALLEY,8353
SAMBURU EAST,Urban,72,6,4,10,Samburu,RIFT VALLEY,8354
SAMBURU EAST,Urban,73,4,14,18,Samburu,RIFT VALLEY,8355
SAMBURU EAST,Urban,74,8,6,14,Samburu,RIFT VALLEY,8356
SAMBURU EAST,Urban,75,7,11,18,Samburu,RIFT VALLEY,8357
SAMBURU EAST,Urban,76,4,5,9,Samburu,RIFT VALLEY,8358
SAMBURU EAST,Urban,77,5,4,9,Samburu,RIFT VALLEY,8359
SAMBURU EAST,Urban,78,3,3,6,Samburu,RIFT VALLEY,8360
SAMBURU EAST,Urban,79,6,10,16,Samburu,RIFT VALLEY,8361
SAMBURU EAST,Urban,80+,54,53,107,Samburu,RIFT VALLEY,8362
SAMBURU EAST,Urban,Age NS,2,0,2,Samburu,RIFT VALLEY,8363
SAMBURU NORTH,Urban,0,141,117,258,Samburu,RIFT VALLEY,8364
SAMBURU NORTH,Urban,1,141,145,286,Samburu,RIFT VALLEY,8365
SAMBURU NORTH,Urban,2,173,164,337,Samburu,RIFT VALLEY,8366
SAMBURU NORTH,Urban,3,171,140,311,Samburu,RIFT VALLEY,8367
SAMBURU NORTH,Urban,4,163,164,327,Samburu,RIFT VALLEY,8368
SAMBURU NORTH,Urban,5,151,146,297,Samburu,RIFT VALLEY,8369
SAMBURU NORTH,Urban,6,133,136,269,Samburu,RIFT VALLEY,8370
SAMBURU NORTH,Urban,7,105,130,235,Samburu,RIFT VALLEY,8371
SAMBURU NORTH,Urban,8,148,121,269,Samburu,RIFT VALLEY,8372
SAMBURU NORTH,Urban,9,100,114,214,Samburu,RIFT VALLEY,8373
SAMBURU NORTH,Urban,10,163,141,304,Samburu,RIFT VALLEY,8374
SAMBURU NORTH,Urban,11,79,104,183,Samburu,RIFT VALLEY,8375
SAMBURU NORTH,Urban,12,111,132,243,Samburu,RIFT VALLEY,8376
SAMBURU NORTH,Urban,13,126,132,258,Samburu,RIFT VALLEY,8377
SAMBURU NORTH,Urban,14,94,121,215,Samburu,RIFT VALLEY,8378
SAMBURU NORTH,Urban,15,164,145,309,Samburu,RIFT VALLEY,8379
SAMBURU NORTH,Urban,16,94,96,190,Samburu,RIFT VALLEY,8380
SAMBURU NORTH,Urban,17,93,88,181,Samburu,RIFT VALLEY,8381
SAMBURU NORTH,Urban,18,72,62,134,Samburu,RIFT VALLEY,8382
SAMBURU NORTH,Urban,19,60,48,108,Samburu,RIFT VALLEY,8383
SAMBURU NORTH,Urban,20,93,108,201,Samburu,RIFT VALLEY,8384
SAMBURU NORTH,Urban,21,34,42,76,Samburu,RIFT VALLEY,8385
SAMBURU NORTH,Urban,22,64,70,134,Samburu,RIFT VALLEY,8386
SAMBURU NORTH,Urban,23,60,72,132,Samburu,RIFT VALLEY,8387
SAMBURU NORTH,Urban,24,46,55,101,Samburu,RIFT VALLEY,8388
SAMBURU NORTH,Urban,25,61,96,157,Samburu,RIFT VALLEY,8389
SAMBURU NORTH,Urban,26,33,43,76,Samburu,RIFT VALLEY,8390
SAMBURU NORTH,Urban,27,40,42,82,Samburu,RIFT VALLEY,8391
SAMBURU NORTH,Urban,28,31,32,63,Samburu,RIFT VALLEY,8392
SAMBURU NORTH,Urban,29,26,38,64,Samburu,RIFT VALLEY,8393
SAMBURU NORTH,Urban,30,64,80,144,Samburu,RIFT VALLEY,8394
SAMBURU NORTH,Urban,31,32,53,85,Samburu,RIFT VALLEY,8395
SAMBURU NORTH,Urban,32,41,53,94,Samburu,RIFT VALLEY,8396
SAMBURU NORTH,Urban,33,28,32,60,Samburu,RIFT VALLEY,8397
SAMBURU NORTH,Urban,34,14,23,37,Samburu,RIFT VALLEY,8398
SAMBURU NORTH,Urban,35,62,62,124,Samburu,RIFT VALLEY,8399
SAMBURU NORTH,Urban,36,29,45,74,Samburu,RIFT VALLEY,8400
SAMBURU NORTH,Urban,37,19,31,50,Samburu,RIFT VALLEY,8401
SAMBURU NORTH,Urban,38,17,25,42,Samburu,RIFT VALLEY,8402
SAMBURU NORTH,Urban,39,20,24,44,Samburu,RIFT VALLEY,8403
SAMBURU NORTH,Urban,40,54,63,117,Samburu,RIFT VALLEY,8404
SAMBURU NORTH,Urban,41,16,21,37,Samburu,RIFT VALLEY,8405
SAMBURU NORTH,Urban,42,20,35,55,Samburu,RIFT VALLEY,8406
SAMBURU NORTH,Urban,43,10,18,28,Samburu,RIFT VALLEY,8407
SAMBURU NORTH,Urban,44,11,24,35,Samburu,RIFT VALLEY,8408
SAMBURU NORTH,Urban,45,26,26,52,Samburu,RIFT VALLEY,8409
SAMBURU NORTH,Urban,46,10,12,22,Samburu,RIFT VALLEY,8410
SAMBURU NORTH,Urban,47,15,22,37,Samburu,RIFT VALLEY,8411
SAMBURU NORTH,Urban,48,18,17,35,Samburu,RIFT VALLEY,8412
SAMBURU NORTH,Urban,49,12,25,37,Samburu,RIFT VALLEY,8413
SAMBURU NORTH,Urban,50,42,52,94,Samburu,RIFT VALLEY,8414
SAMBURU NORTH,Urban,51,10,15,25,Samburu,RIFT VALLEY,8415
SAMBURU NORTH,Urban,52,14,26,40,Samburu,RIFT VALLEY,8416
SAMBURU NORTH,Urban,53,13,14,27,Samburu,RIFT VALLEY,8417
SAMBURU NORTH,Urban,54,6,13,19,Samburu,RIFT VALLEY,8418
SAMBURU NORTH,Urban,55,21,17,38,Samburu,RIFT VALLEY,8419
SAMBURU NORTH,Urban,56,6,14,20,Samburu,RIFT VALLEY,8420
SAMBURU NORTH,Urban,57,6,9,15,Samburu,RIFT VALLEY,8421
SAMBURU NORTH,Urban,58,9,8,17,Samburu,RIFT VALLEY,8422
SAMBURU NORTH,Urban,59,8,19,27,Samburu,RIFT VALLEY,8423
SAMBURU NORTH,Urban,60,26,35,61,Samburu,RIFT VALLEY,8424
SAMBURU NORTH,Urban,61,7,17,24,Samburu,RIFT VALLEY,8425
SAMBURU NORTH,Urban,62,8,11,19,Samburu,RIFT VALLEY,8426
SAMBURU NORTH,Urban,63,4,6,10,Samburu,RIFT VALLEY,8427
SAMBURU NORTH,Urban,64,7,7,14,Samburu,RIFT VALLEY,8428
SAMBURU NORTH,Urban,65,16,12,28,Samburu,RIFT VALLEY,8429
SAMBURU NORTH,Urban,66,2,3,5,Samburu,RIFT VALLEY,8430
SAMBURU NORTH,Urban,67,8,5,13,Samburu,RIFT VALLEY,8431
SAMBURU NORTH,Urban,68,7,10,17,Samburu,RIFT VALLEY,8432
SAMBURU NORTH,Urban,69,7,16,23,Samburu,RIFT VALLEY,8433
SAMBURU NORTH,Urban,70,16,28,44,Samburu,RIFT VALLEY,8434
SAMBURU NORTH,Urban,71,6,7,13,Samburu,RIFT VALLEY,8435
SAMBURU NORTH,Urban,72,2,5,7,Samburu,RIFT VALLEY,8436
SAMBURU NORTH,Urban,73,8,5,13,Samburu,RIFT VALLEY,8437
SAMBURU NORTH,Urban,74,7,3,10,Samburu,RIFT VALLEY,8438
SAMBURU NORTH,Urban,75,6,7,13,Samburu,RIFT VALLEY,8439
SAMBURU NORTH,Urban,76,4,3,7,Samburu,RIFT VALLEY,8440
SAMBURU NORTH,Urban,77,4,3,7,Samburu,RIFT VALLEY,8441
SAMBURU NORTH,Urban,78,2,6,8,Samburu,RIFT VALLEY,8442
SAMBURU NORTH,Urban,79,12,12,24,Samburu,RIFT VALLEY,8443
SAMBURU NORTH,Urban,80+,43,44,87,Samburu,RIFT VALLEY,8444
SAMBURU NORTH,Urban,Age NS,0,0,0,Samburu,RIFT VALLEY,8445
TRANS NZOIA WEST,Urban,0,2670,2543,5213,Trans Nzoia,RIFT VALLEY,8446
TRANS NZOIA WEST,Urban,1,2086,2001,4087,Trans Nzoia,RIFT VALLEY,8447
TRANS NZOIA WEST,Urban,2,2335,2292,4627,Trans Nzoia,RIFT VALLEY,8448
TRANS NZOIA WEST,Urban,3,2324,2336,4660,Trans Nzoia,RIFT VALLEY,8449
TRANS NZOIA WEST,Urban,4,2261,2198,4459,Trans Nzoia,RIFT VALLEY,8450
TRANS NZOIA WEST,Urban,5,2286,2193,4479,Trans Nzoia,RIFT VALLEY,8451
TRANS NZOIA WEST,Urban,6,1972,2001,3973,Trans Nzoia,RIFT VALLEY,8452
TRANS NZOIA WEST,Urban,7,1927,1986,3913,Trans Nzoia,RIFT VALLEY,8453
TRANS NZOIA WEST,Urban,8,1819,1858,3677,Trans Nzoia,RIFT VALLEY,8454
TRANS NZOIA WEST,Urban,9,1925,1998,3923,Trans Nzoia,RIFT VALLEY,8455
TRANS NZOIA WEST,Urban,10,1877,1947,3824,Trans Nzoia,RIFT VALLEY,8456
TRANS NZOIA WEST,Urban,11,1432,1490,2922,Trans Nzoia,RIFT VALLEY,8457
TRANS NZOIA WEST,Urban,12,1754,1910,3664,Trans Nzoia,RIFT VALLEY,8458
TRANS NZOIA WEST,Urban,13,1667,1809,3476,Trans Nzoia,RIFT VALLEY,8459
TRANS NZOIA WEST,Urban,14,1599,1749,3348,Trans Nzoia,RIFT VALLEY,8460
TRANS NZOIA WEST,Urban,15,1458,1681,3139,Trans Nzoia,RIFT VALLEY,8461
TRANS NZOIA WEST,Urban,16,1519,1728,3247,Trans Nzoia,RIFT VALLEY,8462
TRANS NZOIA WEST,Urban,17,1804,1913,3717,Trans Nzoia,RIFT VALLEY,8463
TRANS NZOIA WEST,Urban,18,1750,1869,3619,Trans Nzoia,RIFT VALLEY,8464
TRANS NZOIA WEST,Urban,19,1447,1626,3073,Trans Nzoia,RIFT VALLEY,8465
TRANS NZOIA WEST,Urban,20,1782,2247,4029,Trans Nzoia,RIFT VALLEY,8466
TRANS NZOIA WEST,Urban,21,1237,1572,2809,Trans Nzoia,RIFT VALLEY,8467
TRANS NZOIA WEST,Urban,22,1782,2084,3866,Trans Nzoia,RIFT VALLEY,8468
TRANS NZOIA WEST,Urban,23,1598,1863,3461,Trans Nzoia,RIFT VALLEY,8469
TRANS NZOIA WEST,Urban,24,1636,1750,3386,Trans Nzoia,RIFT VALLEY,8470
TRANS NZOIA WEST,Urban,25,1982,2097,4079,Trans Nzoia,RIFT VALLEY,8471
TRANS NZOIA WEST,Urban,26,1541,1500,3041,Trans Nzoia,RIFT VALLEY,8472
TRANS NZOIA WEST,Urban,27,1604,1442,3046,Trans Nzoia,RIFT VALLEY,8473
TRANS NZOIA WEST,Urban,28,1504,1466,2970,Trans Nzoia,RIFT VALLEY,8474
TRANS NZOIA WEST,Urban,29,1299,1169,2468,Trans Nzoia,RIFT VALLEY,8475
TRANS NZOIA WEST,Urban,30,1905,1751,3656,Trans Nzoia,RIFT VALLEY,8476
TRANS NZOIA WEST,Urban,31,960,770,1730,Trans Nzoia,RIFT VALLEY,8477
TRANS NZOIA WEST,Urban,32,1401,1219,2620,Trans Nzoia,RIFT VALLEY,8478
TRANS NZOIA WEST,Urban,33,898,757,1655,Trans Nzoia,RIFT VALLEY,8479
TRANS NZOIA WEST,Urban,34,973,766,1739,Trans Nzoia,RIFT VALLEY,8480
TRANS NZOIA WEST,Urban,35,1567,1220,2787,Trans Nzoia,RIFT VALLEY,8481
TRANS NZOIA WEST,Urban,36,794,654,1448,Trans Nzoia,RIFT VALLEY,8482
TRANS NZOIA WEST,Urban,37,759,643,1402,Trans Nzoia,RIFT VALLEY,8483
TRANS NZOIA WEST,Urban,38,859,760,1619,Trans Nzoia,RIFT VALLEY,8484
TRANS NZOIA WEST,Urban,39,720,613,1333,Trans Nzoia,RIFT VALLEY,8485
TRANS NZOIA WEST,Urban,40,1121,942,2063,Trans Nzoia,RIFT VALLEY,8486
TRANS NZOIA WEST,Urban,41,512,395,907,Trans Nzoia,RIFT VALLEY,8487
TRANS NZOIA WEST,Urban,42,670,516,1186,Trans Nzoia,RIFT VALLEY,8488
TRANS NZOIA WEST,Urban,43,422,371,793,Trans Nzoia,RIFT VALLEY,8489
TRANS NZOIA WEST,Urban,44,414,322,736,Trans Nzoia,RIFT VALLEY,8490
TRANS NZOIA WEST,Urban,45,753,608,1361,Trans Nzoia,RIFT VALLEY,8491
TRANS NZOIA WEST,Urban,46,452,371,823,Trans Nzoia,RIFT VALLEY,8492
TRANS NZOIA WEST,Urban,47,421,370,791,Trans Nzoia,RIFT VALLEY,8493
TRANS NZOIA WEST,Urban,48,454,361,815,Trans Nzoia,RIFT VALLEY,8494
TRANS NZOIA WEST,Urban,49,416,306,722,Trans Nzoia,RIFT VALLEY,8495
TRANS NZOIA WEST,Urban,50,551,447,998,Trans Nzoia,RIFT VALLEY,8496
TRANS NZOIA WEST,Urban,51,287,212,499,Trans Nzoia,RIFT VALLEY,8497
TRANS NZOIA WEST,Urban,52,320,231,551,Trans Nzoia,RIFT VALLEY,8498
TRANS NZOIA WEST,Urban,53,259,175,434,Trans Nzoia,RIFT VALLEY,8499
TRANS NZOIA WEST,Urban,54,266,182,448,Trans Nzoia,RIFT VALLEY,8500
TRANS NZOIA WEST,Urban,55,275,231,506,Trans Nzoia,RIFT VALLEY,8501
TRANS NZOIA WEST,Urban,56,202,147,349,Trans Nzoia,RIFT VALLEY,8502
TRANS NZOIA WEST,Urban,57,207,189,396,Trans Nzoia,RIFT VALLEY,8503
TRANS NZOIA WEST,Urban,58,137,120,257,Trans Nzoia,RIFT VALLEY,8504
TRANS NZOIA WEST,Urban,59,161,107,268,Trans Nzoia,RIFT VALLEY,8505
TRANS NZOIA WEST,Urban,60,245,195,440,Trans Nzoia,RIFT VALLEY,8506
TRANS NZOIA WEST,Urban,61,136,89,225,Trans Nzoia,RIFT VALLEY,8507
TRANS NZOIA WEST,Urban,62,130,88,218,Trans Nzoia,RIFT VALLEY,8508
TRANS NZOIA WEST,Urban,63,103,81,184,Trans Nzoia,RIFT VALLEY,8509
TRANS NZOIA WEST,Urban,64,67,94,161,Trans Nzoia,RIFT VALLEY,8510
TRANS NZOIA WEST,Urban,65,125,109,234,Trans Nzoia,RIFT VALLEY,8511
TRANS NZOIA WEST,Urban,66,64,58,122,Trans Nzoia,RIFT VALLEY,8512
TRANS NZOIA WEST,Urban,67,80,63,143,Trans Nzoia,RIFT VALLEY,8513
TRANS NZOIA WEST,Urban,68,57,47,104,Trans Nzoia,RIFT VALLEY,8514
TRANS NZOIA WEST,Urban,69,50,51,101,Trans Nzoia,RIFT VALLEY,8515
TRANS NZOIA WEST,Urban,70,107,102,209,Trans Nzoia,RIFT VALLEY,8516
TRANS NZOIA WEST,Urban,71,44,41,85,Trans Nzoia,RIFT VALLEY,8517
TRANS NZOIA WEST,Urban,72,42,34,76,Trans Nzoia,RIFT VALLEY,8518
TRANS NZOIA WEST,Urban,73,44,49,93,Trans Nzoia,RIFT VALLEY,8519
TRANS NZOIA WEST,Urban,74,31,50,81,Trans Nzoia,RIFT VALLEY,8520
TRANS NZOIA WEST,Urban,75,56,52,108,Trans Nzoia,RIFT VALLEY,8521
TRANS NZOIA WEST,Urban,76,30,29,59,Trans Nzoia,RIFT VALLEY,8522
TRANS NZOIA WEST,Urban,77,28,36,64,Trans Nzoia,RIFT VALLEY,8523
TRANS NZOIA WEST,Urban,78,23,22,45,Trans Nzoia,RIFT VALLEY,8524
TRANS NZOIA WEST,Urban,79,28,41,69,Trans Nzoia,RIFT VALLEY,8525
TRANS NZOIA WEST,Urban,80+,251,306,557,Trans Nzoia,RIFT VALLEY,8526
TRANS NZOIA WEST,Urban,Age NS,30,17,47,Trans Nzoia,RIFT VALLEY,8527
TRANS NZOIA EAST,Urban,0,0,0,0,Trans Nzoia,RIFT VALLEY,8528
TRANS NZOIA EAST,Urban,1,0,0,0,Trans Nzoia,RIFT VALLEY,8529
TRANS NZOIA EAST,Urban,2,0,0,0,Trans Nzoia,RIFT VALLEY,8530
TRANS NZOIA EAST,Urban,3,0,0,0,Trans Nzoia,RIFT VALLEY,8531
TRANS NZOIA EAST,Urban,4,0,0,0,Trans Nzoia,RIFT VALLEY,8532
TRANS NZOIA EAST,Urban,5,0,0,0,Trans Nzoia,RIFT VALLEY,8533
TRANS NZOIA EAST,Urban,6,0,0,0,Trans Nzoia,RIFT VALLEY,8534
TRANS NZOIA EAST,Urban,7,0,0,0,Trans Nzoia,RIFT VALLEY,8535
TRANS NZOIA EAST,Urban,8,0,0,0,Trans Nzoia,RIFT VALLEY,8536
TRANS NZOIA EAST,Urban,9,0,0,0,Trans Nzoia,RIFT VALLEY,8537
TRANS NZOIA EAST,Urban,10,0,0,0,Trans Nzoia,RIFT VALLEY,8538
TRANS NZOIA EAST,Urban,11,0,0,0,Trans Nzoia,RIFT VALLEY,8539
BARINGO,Urban,38,133,146,279,Baringo,RIFT VALLEY,8540
TRANS NZOIA EAST,Urban,12,0,0,0,Trans Nzoia,RIFT VALLEY,8541
TRANS NZOIA EAST,Urban,13,0,0,0,Trans Nzoia,RIFT VALLEY,8542
TRANS NZOIA EAST,Urban,14,0,0,0,Trans Nzoia,RIFT VALLEY,8543
TRANS NZOIA EAST,Urban,15,0,0,0,Trans Nzoia,RIFT VALLEY,8544
TRANS NZOIA EAST,Urban,16,0,0,0,Trans Nzoia,RIFT VALLEY,8545
TRANS NZOIA EAST,Urban,17,0,0,0,Trans Nzoia,RIFT VALLEY,8546
TRANS NZOIA EAST,Urban,18,0,0,0,Trans Nzoia,RIFT VALLEY,8547
TRANS NZOIA EAST,Urban,19,0,0,0,Trans Nzoia,RIFT VALLEY,8548
TRANS NZOIA EAST,Urban,20,0,0,0,Trans Nzoia,RIFT VALLEY,8549
TRANS NZOIA EAST,Urban,21,0,0,0,Trans Nzoia,RIFT VALLEY,8550
TRANS NZOIA EAST,Urban,22,0,0,0,Trans Nzoia,RIFT VALLEY,8551
TRANS NZOIA EAST,Urban,23,0,0,0,Trans Nzoia,RIFT VALLEY,8552
TRANS NZOIA EAST,Urban,24,0,0,0,Trans Nzoia,RIFT VALLEY,8553
TRANS NZOIA EAST,Urban,25,0,0,0,Trans Nzoia,RIFT VALLEY,8554
TRANS NZOIA EAST,Urban,26,0,0,0,Trans Nzoia,RIFT VALLEY,8555
TRANS NZOIA EAST,Urban,27,0,0,0,Trans Nzoia,RIFT VALLEY,8556
TRANS NZOIA EAST,Urban,28,0,0,0,Trans Nzoia,RIFT VALLEY,8557
TRANS NZOIA EAST,Urban,29,0,0,0,Trans Nzoia,RIFT VALLEY,8558
TRANS NZOIA EAST,Urban,30,0,0,0,Trans Nzoia,RIFT VALLEY,8559
TRANS NZOIA EAST,Urban,31,0,0,0,Trans Nzoia,RIFT VALLEY,8560
TRANS NZOIA EAST,Urban,32,0,0,0,Trans Nzoia,RIFT VALLEY,8561
TRANS NZOIA EAST,Urban,33,0,0,0,Trans Nzoia,RIFT VALLEY,8562
TRANS NZOIA EAST,Urban,34,0,0,0,Trans Nzoia,RIFT VALLEY,8563
TRANS NZOIA EAST,Urban,35,0,0,0,Trans Nzoia,RIFT VALLEY,8564
TRANS NZOIA EAST,Urban,36,0,0,0,Trans Nzoia,RIFT VALLEY,8565
TRANS NZOIA EAST,Urban,37,0,0,0,Trans Nzoia,RIFT VALLEY,8566
TRANS NZOIA EAST,Urban,38,0,0,0,Trans Nzoia,RIFT VALLEY,8567
TRANS NZOIA EAST,Urban,39,0,0,0,Trans Nzoia,RIFT VALLEY,8568
TRANS NZOIA EAST,Urban,40,0,0,0,Trans Nzoia,RIFT VALLEY,8569
TRANS NZOIA EAST,Urban,41,0,0,0,Trans Nzoia,RIFT VALLEY,8570
TRANS NZOIA EAST,Urban,42,0,0,0,Trans Nzoia,RIFT VALLEY,8571
TRANS NZOIA EAST,Urban,43,0,0,0,Trans Nzoia,RIFT VALLEY,8572
TRANS NZOIA EAST,Urban,44,0,0,0,Trans Nzoia,RIFT VALLEY,8573
TRANS NZOIA EAST,Urban,45,0,0,0,Trans Nzoia,RIFT VALLEY,8574
TRANS NZOIA EAST,Urban,46,0,0,0,Trans Nzoia,RIFT VALLEY,8575
TRANS NZOIA EAST,Urban,47,0,0,0,Trans Nzoia,RIFT VALLEY,8576
TRANS NZOIA EAST,Urban,48,0,0,0,Trans Nzoia,RIFT VALLEY,8577
TRANS NZOIA EAST,Urban,49,0,0,0,Trans Nzoia,RIFT VALLEY,8578
TRANS NZOIA EAST,Urban,50,0,0,0,Trans Nzoia,RIFT VALLEY,8579
TRANS NZOIA EAST,Urban,51,0,0,0,Trans Nzoia,RIFT VALLEY,8580
TRANS NZOIA EAST,Urban,52,0,0,0,Trans Nzoia,RIFT VALLEY,8581
TRANS NZOIA EAST,Urban,53,0,0,0,Trans Nzoia,RIFT VALLEY,8582
TRANS NZOIA EAST,Urban,54,0,0,0,Trans Nzoia,RIFT VALLEY,8583
TRANS NZOIA EAST,Urban,55,0,0,0,Trans Nzoia,RIFT VALLEY,8584
TRANS NZOIA EAST,Urban,56,0,0,0,Trans Nzoia,RIFT VALLEY,8585
TRANS NZOIA EAST,Urban,57,0,0,0,Trans Nzoia,RIFT VALLEY,8586
TRANS NZOIA EAST,Urban,58,0,0,0,Trans Nzoia,RIFT VALLEY,8587
TRANS NZOIA EAST,Urban,59,0,0,0,Trans Nzoia,RIFT VALLEY,8588
TRANS NZOIA EAST,Urban,60,0,0,0,Trans Nzoia,RIFT VALLEY,8589
TRANS NZOIA EAST,Urban,61,0,0,0,Trans Nzoia,RIFT VALLEY,8590
TRANS NZOIA EAST,Urban,62,0,0,0,Trans Nzoia,RIFT VALLEY,8591
TRANS NZOIA EAST,Urban,63,0,0,0,Trans Nzoia,RIFT VALLEY,8592
TRANS NZOIA EAST,Urban,64,0,0,0,Trans Nzoia,RIFT VALLEY,8593
TRANS NZOIA EAST,Urban,65,0,0,0,Trans Nzoia,RIFT VALLEY,8594
TRANS NZOIA EAST,Urban,66,0,0,0,Trans Nzoia,RIFT VALLEY,8595
TRANS NZOIA EAST,Urban,67,0,0,0,Trans Nzoia,RIFT VALLEY,8596
TRANS NZOIA EAST,Urban,68,0,0,0,Trans Nzoia,RIFT VALLEY,8597
TRANS NZOIA EAST,Urban,69,0,0,0,Trans Nzoia,RIFT VALLEY,8598
TRANS NZOIA EAST,Urban,70,0,0,0,Trans Nzoia,RIFT VALLEY,8599
TRANS NZOIA EAST,Urban,71,0,0,0,Trans Nzoia,RIFT VALLEY,8600
TRANS NZOIA EAST,Urban,72,0,0,0,Trans Nzoia,RIFT VALLEY,8601
TRANS NZOIA EAST,Urban,73,0,0,0,Trans Nzoia,RIFT VALLEY,8602
TRANS NZOIA EAST,Urban,74,0,0,0,Trans Nzoia,RIFT VALLEY,8603
TRANS NZOIA EAST,Urban,75,0,0,0,Trans Nzoia,RIFT VALLEY,8604
TRANS NZOIA EAST,Urban,76,0,0,0,Trans Nzoia,RIFT VALLEY,8605
TRANS NZOIA EAST,Urban,77,0,0,0,Trans Nzoia,RIFT VALLEY,8606
TRANS NZOIA EAST,Urban,78,0,0,0,Trans Nzoia,RIFT VALLEY,8607
TRANS NZOIA EAST,Urban,79,0,0,0,Trans Nzoia,RIFT VALLEY,8608
TRANS NZOIA EAST,Urban,80+,0,0,0,Trans Nzoia,RIFT VALLEY,8609
TRANS NZOIA EAST,Urban,Age NS,0,0,0,Trans Nzoia,RIFT VALLEY,8610
KWANZA,Urban,0,412,408,820,Trans Nzoia,RIFT VALLEY,8611
KWANZA,Urban,1,284,298,582,Trans Nzoia,RIFT VALLEY,8612
KWANZA,Urban,2,372,359,731,Trans Nzoia,RIFT VALLEY,8613
KWANZA,Urban,3,344,327,671,Trans Nzoia,RIFT VALLEY,8614
KWANZA,Urban,4,387,363,750,Trans Nzoia,RIFT VALLEY,8615
KWANZA,Urban,5,359,338,697,Trans Nzoia,RIFT VALLEY,8616
KWANZA,Urban,6,333,294,627,Trans Nzoia,RIFT VALLEY,8617
KWANZA,Urban,7,308,287,595,Trans Nzoia,RIFT VALLEY,8618
KWANZA,Urban,8,280,280,560,Trans Nzoia,RIFT VALLEY,8619
KWANZA,Urban,9,311,292,603,Trans Nzoia,RIFT VALLEY,8620
KWANZA,Urban,10,315,268,583,Trans Nzoia,RIFT VALLEY,8621
KWANZA,Urban,11,230,203,433,Trans Nzoia,RIFT VALLEY,8622
KWANZA,Urban,12,274,240,514,Trans Nzoia,RIFT VALLEY,8623
KWANZA,Urban,13,230,245,475,Trans Nzoia,RIFT VALLEY,8624
KWANZA,Urban,14,212,169,381,Trans Nzoia,RIFT VALLEY,8625
KWANZA,Urban,15,213,181,394,Trans Nzoia,RIFT VALLEY,8626
KWANZA,Urban,16,205,177,382,Trans Nzoia,RIFT VALLEY,8627
KWANZA,Urban,17,203,187,390,Trans Nzoia,RIFT VALLEY,8628
KWANZA,Urban,18,222,207,429,Trans Nzoia,RIFT VALLEY,8629
KWANZA,Urban,19,157,205,362,Trans Nzoia,RIFT VALLEY,8630
KWANZA,Urban,20,192,251,443,Trans Nzoia,RIFT VALLEY,8631
KWANZA,Urban,21,153,171,324,Trans Nzoia,RIFT VALLEY,8632
KWANZA,Urban,22,174,202,376,Trans Nzoia,RIFT VALLEY,8633
KWANZA,Urban,23,190,173,363,Trans Nzoia,RIFT VALLEY,8634
KWANZA,Urban,24,148,169,317,Trans Nzoia,RIFT VALLEY,8635
KWANZA,Urban,25,173,206,379,Trans Nzoia,RIFT VALLEY,8636
KWANZA,Urban,26,126,150,276,Trans Nzoia,RIFT VALLEY,8637
KWANZA,Urban,27,120,122,242,Trans Nzoia,RIFT VALLEY,8638
KWANZA,Urban,28,122,160,282,Trans Nzoia,RIFT VALLEY,8639
KWANZA,Urban,29,137,101,238,Trans Nzoia,RIFT VALLEY,8640
KWANZA,Urban,30,170,150,320,Trans Nzoia,RIFT VALLEY,8641
KWANZA,Urban,31,107,89,196,Trans Nzoia,RIFT VALLEY,8642
KWANZA,Urban,32,135,126,261,Trans Nzoia,RIFT VALLEY,8643
KWANZA,Urban,33,101,77,178,Trans Nzoia,RIFT VALLEY,8644
KWANZA,Urban,34,92,87,179,Trans Nzoia,RIFT VALLEY,8645
KWANZA,Urban,35,138,117,255,Trans Nzoia,RIFT VALLEY,8646
KWANZA,Urban,36,83,88,171,Trans Nzoia,RIFT VALLEY,8647
KWANZA,Urban,37,87,93,180,Trans Nzoia,RIFT VALLEY,8648
KWANZA,Urban,38,91,70,161,Trans Nzoia,RIFT VALLEY,8649
KWANZA,Urban,39,67,56,123,Trans Nzoia,RIFT VALLEY,8650
KWANZA,Urban,40,107,102,209,Trans Nzoia,RIFT VALLEY,8651
KWANZA,Urban,41,49,46,95,Trans Nzoia,RIFT VALLEY,8652
KWANZA,Urban,42,60,84,144,Trans Nzoia,RIFT VALLEY,8653
KWANZA,Urban,43,46,52,98,Trans Nzoia,RIFT VALLEY,8654
KWANZA,Urban,44,51,57,108,Trans Nzoia,RIFT VALLEY,8655
KWANZA,Urban,45,58,72,130,Trans Nzoia,RIFT VALLEY,8656
KWANZA,Urban,46,52,64,116,Trans Nzoia,RIFT VALLEY,8657
KWANZA,Urban,47,44,51,95,Trans Nzoia,RIFT VALLEY,8658
KWANZA,Urban,48,47,55,102,Trans Nzoia,RIFT VALLEY,8659
KWANZA,Urban,49,55,45,100,Trans Nzoia,RIFT VALLEY,8660
KWANZA,Urban,50,60,47,107,Trans Nzoia,RIFT VALLEY,8661
KWANZA,Urban,51,44,36,80,Trans Nzoia,RIFT VALLEY,8662
KWANZA,Urban,52,46,43,89,Trans Nzoia,RIFT VALLEY,8663
KWANZA,Urban,53,39,36,75,Trans Nzoia,RIFT VALLEY,8664
KWANZA,Urban,54,34,45,79,Trans Nzoia,RIFT VALLEY,8665
KWANZA,Urban,55,36,39,75,Trans Nzoia,RIFT VALLEY,8666
KWANZA,Urban,56,30,36,66,Trans Nzoia,RIFT VALLEY,8667
KWANZA,Urban,57,29,40,69,Trans Nzoia,RIFT VALLEY,8668
KWANZA,Urban,58,16,20,36,Trans Nzoia,RIFT VALLEY,8669
KWANZA,Urban,59,29,24,53,Trans Nzoia,RIFT VALLEY,8670
KWANZA,Urban,60,51,42,93,Trans Nzoia,RIFT VALLEY,8671
KWANZA,Urban,61,17,22,39,Trans Nzoia,RIFT VALLEY,8672
KWANZA,Urban,62,23,23,46,Trans Nzoia,RIFT VALLEY,8673
KWANZA,Urban,63,16,19,35,Trans Nzoia,RIFT VALLEY,8674
KWANZA,Urban,64,18,15,33,Trans Nzoia,RIFT VALLEY,8675
KWANZA,Urban,65,20,20,40,Trans Nzoia,RIFT VALLEY,8676
KWANZA,Urban,66,14,22,36,Trans Nzoia,RIFT VALLEY,8677
KWANZA,Urban,67,27,23,50,Trans Nzoia,RIFT VALLEY,8678
KWANZA,Urban,68,14,13,27,Trans Nzoia,RIFT VALLEY,8679
KWANZA,Urban,69,9,15,24,Trans Nzoia,RIFT VALLEY,8680
KWANZA,Urban,70,13,26,39,Trans Nzoia,RIFT VALLEY,8681
KWANZA,Urban,71,6,10,16,Trans Nzoia,RIFT VALLEY,8682
KWANZA,Urban,72,14,13,27,Trans Nzoia,RIFT VALLEY,8683
KWANZA,Urban,73,9,12,21,Trans Nzoia,RIFT VALLEY,8684
KWANZA,Urban,74,10,8,18,Trans Nzoia,RIFT VALLEY,8685
KWANZA,Urban,75,11,13,24,Trans Nzoia,RIFT VALLEY,8686
KWANZA,Urban,76,7,8,15,Trans Nzoia,RIFT VALLEY,8687
KWANZA,Urban,77,12,10,22,Trans Nzoia,RIFT VALLEY,8688
KWANZA,Urban,78,1,12,13,Trans Nzoia,RIFT VALLEY,8689
KWANZA,Urban,79,5,10,15,Trans Nzoia,RIFT VALLEY,8690
KWANZA,Urban,80+,50,53,103,Trans Nzoia,RIFT VALLEY,8691
KWANZA,Urban,Age NS,1,2,3,Trans Nzoia,RIFT VALLEY,8692
BARINGO,Urban,0,512,517,1029,Baringo,RIFT VALLEY,8693
BARINGO,Urban,1,402,402,804,Baringo,RIFT VALLEY,8694
BARINGO,Urban,2,424,457,881,Baringo,RIFT VALLEY,8695
BARINGO,Urban,3,445,438,883,Baringo,RIFT VALLEY,8696
BARINGO,Urban,4,460,421,881,Baringo,RIFT VALLEY,8697
BARINGO,Urban,5,456,414,870,Baringo,RIFT VALLEY,8698
BARINGO,Urban,6,389,416,805,Baringo,RIFT VALLEY,8699
BARINGO,Urban,7,414,389,803,Baringo,RIFT VALLEY,8700
BARINGO,Urban,8,393,405,798,Baringo,RIFT VALLEY,8701
BARINGO,Urban,9,384,371,755,Baringo,RIFT VALLEY,8702
BARINGO,Urban,10,468,444,912,Baringo,RIFT VALLEY,8703
BARINGO,Urban,11,320,319,639,Baringo,RIFT VALLEY,8704
BARINGO,Urban,12,419,400,819,Baringo,RIFT VALLEY,8705
BARINGO,Urban,13,338,394,732,Baringo,RIFT VALLEY,8706
BARINGO,Urban,14,319,415,734,Baringo,RIFT VALLEY,8707
BARINGO,Urban,15,327,378,705,Baringo,RIFT VALLEY,8708
BARINGO,Urban,16,259,414,673,Baringo,RIFT VALLEY,8709
BARINGO,Urban,17,315,414,729,Baringo,RIFT VALLEY,8710
BARINGO,Urban,18,353,421,774,Baringo,RIFT VALLEY,8711
BARINGO,Urban,19,280,334,614,Baringo,RIFT VALLEY,8712
BARINGO,Urban,20,371,541,912,Baringo,RIFT VALLEY,8713
BARINGO,Urban,21,239,312,551,Baringo,RIFT VALLEY,8714
BARINGO,Urban,22,338,443,781,Baringo,RIFT VALLEY,8715
BARINGO,Urban,23,313,401,714,Baringo,RIFT VALLEY,8716
BARINGO,Urban,24,301,453,754,Baringo,RIFT VALLEY,8717
BARINGO,Urban,25,362,544,906,Baringo,RIFT VALLEY,8718
BARINGO,Urban,26,320,391,711,Baringo,RIFT VALLEY,8719
BARINGO,Urban,27,289,334,623,Baringo,RIFT VALLEY,8720
BARINGO,Urban,28,287,382,669,Baringo,RIFT VALLEY,8721
BARINGO,Urban,29,226,275,501,Baringo,RIFT VALLEY,8722
BARINGO,Urban,30,381,414,795,Baringo,RIFT VALLEY,8723
BARINGO,Urban,31,174,159,333,Baringo,RIFT VALLEY,8724
BARINGO,Urban,32,251,304,555,Baringo,RIFT VALLEY,8725
BARINGO,Urban,33,140,149,289,Baringo,RIFT VALLEY,8726
BARINGO,Urban,34,158,175,333,Baringo,RIFT VALLEY,8727
BARINGO,Urban,35,281,290,571,Baringo,RIFT VALLEY,8728
BARINGO,Urban,36,174,155,329,Baringo,RIFT VALLEY,8729
BARINGO,Urban,37,142,139,281,Baringo,RIFT VALLEY,8730
BARINGO,Urban,39,131,119,250,Baringo,RIFT VALLEY,8731
BARINGO,Urban,40,219,201,420,Baringo,RIFT VALLEY,8732
BARINGO,Urban,41,88,80,168,Baringo,RIFT VALLEY,8733
BARINGO,Urban,42,97,128,225,Baringo,RIFT VALLEY,8734
BARINGO,Urban,43,107,82,189,Baringo,RIFT VALLEY,8735
BARINGO,Urban,44,80,62,142,Baringo,RIFT VALLEY,8736
BARINGO,Urban,45,137,134,271,Baringo,RIFT VALLEY,8737
BARINGO,Urban,46,78,75,153,Baringo,RIFT VALLEY,8738
BARINGO,Urban,47,92,92,184,Baringo,RIFT VALLEY,8739
BARINGO,Urban,48,109,89,198,Baringo,RIFT VALLEY,8740
BARINGO,Urban,49,110,67,177,Baringo,RIFT VALLEY,8741
BARINGO,Urban,50,119,112,231,Baringo,RIFT VALLEY,8742
BARINGO,Urban,51,60,30,90,Baringo,RIFT VALLEY,8743
BARINGO,Urban,52,60,47,107,Baringo,RIFT VALLEY,8744
BARINGO,Urban,53,45,47,92,Baringo,RIFT VALLEY,8745
BARINGO,Urban,54,42,44,86,Baringo,RIFT VALLEY,8746
BARINGO,Urban,55,60,48,108,Baringo,RIFT VALLEY,8747
BARINGO,Urban,56,50,46,96,Baringo,RIFT VALLEY,8748
BARINGO,Urban,57,59,27,86,Baringo,RIFT VALLEY,8749
BARINGO,Urban,58,35,16,51,Baringo,RIFT VALLEY,8750
BARINGO,Urban,59,38,24,62,Baringo,RIFT VALLEY,8751
BARINGO,Urban,60,67,61,128,Baringo,RIFT VALLEY,8752
BARINGO,Urban,61,26,18,44,Baringo,RIFT VALLEY,8753
BARINGO,Urban,62,16,18,34,Baringo,RIFT VALLEY,8754
BARINGO,Urban,63,16,13,29,Baringo,RIFT VALLEY,8755
BARINGO,Urban,64,19,14,33,Baringo,RIFT VALLEY,8756
BARINGO,Urban,65,36,36,72,Baringo,RIFT VALLEY,8757
BARINGO,Urban,66,12,10,22,Baringo,RIFT VALLEY,8758
BARINGO,Urban,67,17,14,31,Baringo,RIFT VALLEY,8759
BARINGO,Urban,68,17,16,33,Baringo,RIFT VALLEY,8760
BARINGO,Urban,69,16,15,31,Baringo,RIFT VALLEY,8761
BARINGO,Urban,70,26,33,59,Baringo,RIFT VALLEY,8762
BARINGO,Urban,71,4,11,15,Baringo,RIFT VALLEY,8763
BARINGO,Urban,72,7,15,22,Baringo,RIFT VALLEY,8764
BARINGO,Urban,73,8,6,14,Baringo,RIFT VALLEY,8765
BARINGO,Urban,74,5,8,13,Baringo,RIFT VALLEY,8766
BARINGO,Urban,75,13,18,31,Baringo,RIFT VALLEY,8767
BARINGO,Urban,76,6,8,14,Baringo,RIFT VALLEY,8768
BARINGO,Urban,77,5,7,12,Baringo,RIFT VALLEY,8769
BARINGO,Urban,78,5,14,19,Baringo,RIFT VALLEY,8770
BARINGO,Urban,79,9,10,19,Baringo,RIFT VALLEY,8771
BARINGO,Urban,80+,65,110,175,Baringo,RIFT VALLEY,8772
BARINGO,Urban,Age NS,8,2,10,Baringo,RIFT VALLEY,8773
BARINGO NORTH,Urban,0,0,0,0,Baringo,RIFT VALLEY,8774
BARINGO NORTH,Urban,1,0,0,0,Baringo,RIFT VALLEY,8775
BARINGO NORTH,Urban,2,0,0,0,Baringo,RIFT VALLEY,8776
BARINGO NORTH,Urban,3,0,0,0,Baringo,RIFT VALLEY,8777
BARINGO NORTH,Urban,4,0,0,0,Baringo,RIFT VALLEY,8778
BARINGO NORTH,Urban,5,0,0,0,Baringo,RIFT VALLEY,8779
BARINGO NORTH,Urban,6,0,0,0,Baringo,RIFT VALLEY,8780
BARINGO NORTH,Urban,7,0,0,0,Baringo,RIFT VALLEY,8781
BARINGO NORTH,Urban,8,0,0,0,Baringo,RIFT VALLEY,8782
BARINGO NORTH,Urban,9,0,0,0,Baringo,RIFT VALLEY,8783
BARINGO NORTH,Urban,10,0,0,0,Baringo,RIFT VALLEY,8784
BARINGO NORTH,Urban,11,0,0,0,Baringo,RIFT VALLEY,8785
BARINGO NORTH,Urban,12,0,0,0,Baringo,RIFT VALLEY,8786
BARINGO NORTH,Urban,13,0,0,0,Baringo,RIFT VALLEY,8787
BARINGO NORTH,Urban,14,0,0,0,Baringo,RIFT VALLEY,8788
BARINGO NORTH,Urban,15,0,0,0,Baringo,RIFT VALLEY,8789
BARINGO NORTH,Urban,16,0,0,0,Baringo,RIFT VALLEY,8790
BARINGO NORTH,Urban,17,0,0,0,Baringo,RIFT VALLEY,8791
BARINGO NORTH,Urban,18,0,0,0,Baringo,RIFT VALLEY,8792
BARINGO NORTH,Urban,19,0,0,0,Baringo,RIFT VALLEY,8793
BARINGO NORTH,Urban,20,0,0,0,Baringo,RIFT VALLEY,8794
BARINGO NORTH,Urban,21,0,0,0,Baringo,RIFT VALLEY,8795
BARINGO NORTH,Urban,22,0,0,0,Baringo,RIFT VALLEY,8796
BARINGO NORTH,Urban,23,0,0,0,Baringo,RIFT VALLEY,8797
BARINGO NORTH,Urban,24,0,0,0,Baringo,RIFT VALLEY,8798
BARINGO NORTH,Urban,25,0,0,0,Baringo,RIFT VALLEY,8799
BARINGO NORTH,Urban,26,0,0,0,Baringo,RIFT VALLEY,8800
BARINGO NORTH,Urban,27,0,0,0,Baringo,RIFT VALLEY,8801
BARINGO NORTH,Urban,28,0,0,0,Baringo,RIFT VALLEY,8802
BARINGO NORTH,Urban,29,0,0,0,Baringo,RIFT VALLEY,8803
BARINGO NORTH,Urban,30,0,0,0,Baringo,RIFT VALLEY,8804
BARINGO NORTH,Urban,31,0,0,0,Baringo,RIFT VALLEY,8805
BARINGO NORTH,Urban,32,0,0,0,Baringo,RIFT VALLEY,8806
BARINGO NORTH,Urban,33,0,0,0,Baringo,RIFT VALLEY,8807
BARINGO NORTH,Urban,34,0,0,0,Baringo,RIFT VALLEY,8808
BARINGO NORTH,Urban,35,0,0,0,Baringo,RIFT VALLEY,8809
BARINGO NORTH,Urban,36,0,0,0,Baringo,RIFT VALLEY,8810
BARINGO NORTH,Urban,37,0,0,0,Baringo,RIFT VALLEY,8811
BARINGO NORTH,Urban,38,0,0,0,Baringo,RIFT VALLEY,8812
BARINGO NORTH,Urban,39,0,0,0,Baringo,RIFT VALLEY,8813
BARINGO NORTH,Urban,40,0,0,0,Baringo,RIFT VALLEY,8814
BARINGO NORTH,Urban,41,0,0,0,Baringo,RIFT VALLEY,8815
BARINGO NORTH,Urban,42,0,0,0,Baringo,RIFT VALLEY,8816
BARINGO NORTH,Urban,43,0,0,0,Baringo,RIFT VALLEY,8817
BARINGO NORTH,Urban,44,0,0,0,Baringo,RIFT VALLEY,8818
BARINGO NORTH,Urban,45,0,0,0,Baringo,RIFT VALLEY,8819
BARINGO NORTH,Urban,46,0,0,0,Baringo,RIFT VALLEY,8820
BARINGO NORTH,Urban,47,0,0,0,Baringo,RIFT VALLEY,8821
BARINGO NORTH,Urban,48,0,0,0,Baringo,RIFT VALLEY,8822
BARINGO NORTH,Urban,49,0,0,0,Baringo,RIFT VALLEY,8823
BARINGO NORTH,Urban,50,0,0,0,Baringo,RIFT VALLEY,8824
BARINGO NORTH,Urban,51,0,0,0,Baringo,RIFT VALLEY,8825
BARINGO NORTH,Urban,52,0,0,0,Baringo,RIFT VALLEY,8826
BARINGO NORTH,Urban,53,0,0,0,Baringo,RIFT VALLEY,8827
BARINGO NORTH,Urban,54,0,0,0,Baringo,RIFT VALLEY,8828
BARINGO NORTH,Urban,55,0,0,0,Baringo,RIFT VALLEY,8829
BARINGO NORTH,Urban,56,0,0,0,Baringo,RIFT VALLEY,8830
BARINGO NORTH,Urban,57,0,0,0,Baringo,RIFT VALLEY,8831
BARINGO NORTH,Urban,58,0,0,0,Baringo,RIFT VALLEY,8832
BARINGO NORTH,Urban,59,0,0,0,Baringo,RIFT VALLEY,8833
BARINGO NORTH,Urban,60,0,0,0,Baringo,RIFT VALLEY,8834
BARINGO NORTH,Urban,61,0,0,0,Baringo,RIFT VALLEY,8835
BARINGO NORTH,Urban,62,0,0,0,Baringo,RIFT VALLEY,8836
BARINGO NORTH,Urban,63,0,0,0,Baringo,RIFT VALLEY,8837
BARINGO NORTH,Urban,64,0,0,0,Baringo,RIFT VALLEY,8838
BARINGO NORTH,Urban,65,0,0,0,Baringo,RIFT VALLEY,8839
BARINGO NORTH,Urban,66,0,0,0,Baringo,RIFT VALLEY,8840
BARINGO NORTH,Urban,67,0,0,0,Baringo,RIFT VALLEY,8841
BARINGO NORTH,Urban,68,0,0,0,Baringo,RIFT VALLEY,8842
BARINGO NORTH,Urban,69,0,0,0,Baringo,RIFT VALLEY,8843
BARINGO NORTH,Urban,70,0,0,0,Baringo,RIFT VALLEY,8844
BARINGO NORTH,Urban,71,0,0,0,Baringo,RIFT VALLEY,8845
BARINGO NORTH,Urban,72,0,0,0,Baringo,RIFT VALLEY,8846
BARINGO NORTH,Urban,73,0,0,0,Baringo,RIFT VALLEY,8847
BARINGO NORTH,Urban,74,0,0,0,Baringo,RIFT VALLEY,8848
BARINGO NORTH,Urban,75,0,0,0,Baringo,RIFT VALLEY,8849
BARINGO NORTH,Urban,76,0,0,0,Baringo,RIFT VALLEY,8850
BARINGO NORTH,Urban,77,0,0,0,Baringo,RIFT VALLEY,8851
BARINGO NORTH,Urban,78,0,0,0,Baringo,RIFT VALLEY,8852
BARINGO NORTH,Urban,79,0,0,0,Baringo,RIFT VALLEY,8853
BARINGO NORTH,Urban,80+,0,0,0,Baringo,RIFT VALLEY,8854
BARINGO NORTH,Urban,Age NS,0,0,0,Baringo,RIFT VALLEY,8855
EAST POKOT,Urban,0,0,0,0,Baringo,RIFT VALLEY,8856
EAST POKOT,Urban,1,0,0,0,Baringo,RIFT VALLEY,8857
EAST POKOT,Urban,2,0,0,0,Baringo,RIFT VALLEY,8858
EAST POKOT,Urban,3,0,0,0,Baringo,RIFT VALLEY,8859
EAST POKOT,Urban,4,0,0,0,Baringo,RIFT VALLEY,8860
EAST POKOT,Urban,5,0,0,0,Baringo,RIFT VALLEY,8861
EAST POKOT,Urban,6,0,0,0,Baringo,RIFT VALLEY,8862
EAST POKOT,Urban,7,0,0,0,Baringo,RIFT VALLEY,8863
EAST POKOT,Urban,8,0,0,0,Baringo,RIFT VALLEY,8864
EAST POKOT,Urban,9,0,0,0,Baringo,RIFT VALLEY,8865
EAST POKOT,Urban,10,0,0,0,Baringo,RIFT VALLEY,8866
EAST POKOT,Urban,11,0,0,0,Baringo,RIFT VALLEY,8867
EAST POKOT,Urban,12,0,0,0,Baringo,RIFT VALLEY,8868
EAST POKOT,Urban,13,0,0,0,Baringo,RIFT VALLEY,8869
EAST POKOT,Urban,14,0,0,0,Baringo,RIFT VALLEY,8870
EAST POKOT,Urban,15,0,0,0,Baringo,RIFT VALLEY,8871
EAST POKOT,Urban,16,0,0,0,Baringo,RIFT VALLEY,8872
EAST POKOT,Urban,17,0,0,0,Baringo,RIFT VALLEY,8873
EAST POKOT,Urban,18,0,0,0,Baringo,RIFT VALLEY,8874
EAST POKOT,Urban,19,0,0,0,Baringo,RIFT VALLEY,8875
EAST POKOT,Urban,20,0,0,0,Baringo,RIFT VALLEY,8876
EAST POKOT,Urban,21,0,0,0,Baringo,RIFT VALLEY,8877
EAST POKOT,Urban,22,0,0,0,Baringo,RIFT VALLEY,8878
EAST POKOT,Urban,23,0,0,0,Baringo,RIFT VALLEY,8879
EAST POKOT,Urban,24,0,0,0,Baringo,RIFT VALLEY,8880
EAST POKOT,Urban,25,0,0,0,Baringo,RIFT VALLEY,8881
EAST POKOT,Urban,26,0,0,0,Baringo,RIFT VALLEY,8882
EAST POKOT,Urban,27,0,0,0,Baringo,RIFT VALLEY,8883
EAST POKOT,Urban,28,0,0,0,Baringo,RIFT VALLEY,8884
EAST POKOT,Urban,29,0,0,0,Baringo,RIFT VALLEY,8885
EAST POKOT,Urban,30,0,0,0,Baringo,RIFT VALLEY,8886
EAST POKOT,Urban,31,0,0,0,Baringo,RIFT VALLEY,8887
EAST POKOT,Urban,32,0,0,0,Baringo,RIFT VALLEY,8888
EAST POKOT,Urban,33,0,0,0,Baringo,RIFT VALLEY,8889
EAST POKOT,Urban,34,0,0,0,Baringo,RIFT VALLEY,8890
EAST POKOT,Urban,35,0,0,0,Baringo,RIFT VALLEY,8891
EAST POKOT,Urban,36,0,0,0,Baringo,RIFT VALLEY,8892
EAST POKOT,Urban,37,0,0,0,Baringo,RIFT VALLEY,8893
EAST POKOT,Urban,38,0,0,0,Baringo,RIFT VALLEY,8894
EAST POKOT,Urban,39,0,0,0,Baringo,RIFT VALLEY,8895
EAST POKOT,Urban,40,0,0,0,Baringo,RIFT VALLEY,8896
EAST POKOT,Urban,41,0,0,0,Baringo,RIFT VALLEY,8897
EAST POKOT,Urban,42,0,0,0,Baringo,RIFT VALLEY,8898
EAST POKOT,Urban,43,0,0,0,Baringo,RIFT VALLEY,8899
EAST POKOT,Urban,44,0,0,0,Baringo,RIFT VALLEY,8900
EAST POKOT,Urban,45,0,0,0,Baringo,RIFT VALLEY,8901
EAST POKOT,Urban,46,0,0,0,Baringo,RIFT VALLEY,8902
EAST POKOT,Urban,47,0,0,0,Baringo,RIFT VALLEY,8903
EAST POKOT,Urban,48,0,0,0,Baringo,RIFT VALLEY,8904
EAST POKOT,Urban,49,0,0,0,Baringo,RIFT VALLEY,8905
EAST POKOT,Urban,50,0,0,0,Baringo,RIFT VALLEY,8906
EAST POKOT,Urban,51,0,0,0,Baringo,RIFT VALLEY,8907
EAST POKOT,Urban,52,0,0,0,Baringo,RIFT VALLEY,8908
EAST POKOT,Urban,53,0,0,0,Baringo,RIFT VALLEY,8909
EAST POKOT,Urban,54,0,0,0,Baringo,RIFT VALLEY,8910
EAST POKOT,Urban,55,0,0,0,Baringo,RIFT VALLEY,8911
EAST POKOT,Urban,56,0,0,0,Baringo,RIFT VALLEY,8912
EAST POKOT,Urban,57,0,0,0,Baringo,RIFT VALLEY,8913
EAST POKOT,Urban,58,0,0,0,Baringo,RIFT VALLEY,8914
EAST POKOT,Urban,59,0,0,0,Baringo,RIFT VALLEY,8915
EAST POKOT,Urban,60,0,0,0,Baringo,RIFT VALLEY,8916
EAST POKOT,Urban,61,0,0,0,Baringo,RIFT VALLEY,8917
EAST POKOT,Urban,62,0,0,0,Baringo,RIFT VALLEY,8918
EAST POKOT,Urban,63,0,0,0,Baringo,RIFT VALLEY,8919
EAST POKOT,Urban,64,0,0,0,Baringo,RIFT VALLEY,8920
EAST POKOT,Urban,65,0,0,0,Baringo,RIFT VALLEY,8921
EAST POKOT,Urban,66,0,0,0,Baringo,RIFT VALLEY,8922
EAST POKOT,Urban,67,0,0,0,Baringo,RIFT VALLEY,8923
EAST POKOT,Urban,68,0,0,0,Baringo,RIFT VALLEY,8924
EAST POKOT,Urban,69,0,0,0,Baringo,RIFT VALLEY,8925
EAST POKOT,Urban,70,0,0,0,Baringo,RIFT VALLEY,8926
EAST POKOT,Urban,71,0,0,0,Baringo,RIFT VALLEY,8927
EAST POKOT,Urban,72,0,0,0,Baringo,RIFT VALLEY,8928
EAST POKOT,Urban,73,0,0,0,Baringo,RIFT VALLEY,8929
EAST POKOT,Urban,74,0,0,0,Baringo,RIFT VALLEY,8930
EAST POKOT,Urban,75,0,0,0,Baringo,RIFT VALLEY,8931
EAST POKOT,Urban,76,0,0,0,Baringo,RIFT VALLEY,8932
EAST POKOT,Urban,77,0,0,0,Baringo,RIFT VALLEY,8933
EAST POKOT,Urban,78,0,0,0,Baringo,RIFT VALLEY,8934
EAST POKOT,Urban,79,0,0,0,Baringo,RIFT VALLEY,8935
EAST POKOT,Urban,80+,0,0,0,Baringo,RIFT VALLEY,8936
EAST POKOT,Urban,Age NS,0,0,0,Baringo,RIFT VALLEY,8937
KOIBATEK,Urban,0,543,487,1030,Baringo,RIFT VALLEY,8938
KOIBATEK,Urban,1,422,418,840,Baringo,RIFT VALLEY,8939
KOIBATEK,Urban,2,456,451,907,Baringo,RIFT VALLEY,8940
KOIBATEK,Urban,3,466,452,918,Baringo,RIFT VALLEY,8941
KOIBATEK,Urban,4,419,438,857,Baringo,RIFT VALLEY,8942
KOIBATEK,Urban,5,488,429,917,Baringo,RIFT VALLEY,8943
KOIBATEK,Urban,6,441,409,850,Baringo,RIFT VALLEY,8944
KOIBATEK,Urban,7,389,428,817,Baringo,RIFT VALLEY,8945
KOIBATEK,Urban,8,376,387,763,Baringo,RIFT VALLEY,8946
KOIBATEK,Urban,9,419,418,837,Baringo,RIFT VALLEY,8947
KOIBATEK,Urban,10,447,417,864,Baringo,RIFT VALLEY,8948
KOIBATEK,Urban,11,294,357,651,Baringo,RIFT VALLEY,8949
KOIBATEK,Urban,12,430,417,847,Baringo,RIFT VALLEY,8950
KOIBATEK,Urban,13,395,417,812,Baringo,RIFT VALLEY,8951
KOIBATEK,Urban,14,294,379,673,Baringo,RIFT VALLEY,8952
KOIBATEK,Urban,15,288,400,688,Baringo,RIFT VALLEY,8953
KOIBATEK,Urban,16,274,350,624,Baringo,RIFT VALLEY,8954
KOIBATEK,Urban,17,303,268,571,Baringo,RIFT VALLEY,8955
KOIBATEK,Urban,18,292,284,576,Baringo,RIFT VALLEY,8956
KOIBATEK,Urban,19,251,262,513,Baringo,RIFT VALLEY,8957
KOIBATEK,Urban,20,314,438,752,Baringo,RIFT VALLEY,8958
KOIBATEK,Urban,21,253,304,557,Baringo,RIFT VALLEY,8959
KOIBATEK,Urban,22,308,413,721,Baringo,RIFT VALLEY,8960
KOIBATEK,Urban,23,297,407,704,Baringo,RIFT VALLEY,8961
KOIBATEK,Urban,24,297,364,661,Baringo,RIFT VALLEY,8962
KOIBATEK,Urban,25,389,479,868,Baringo,RIFT VALLEY,8963
KOIBATEK,Urban,26,295,321,616,Baringo,RIFT VALLEY,8964
KOIBATEK,Urban,27,316,303,619,Baringo,RIFT VALLEY,8965
KOIBATEK,Urban,28,276,334,610,Baringo,RIFT VALLEY,8966
KOIBATEK,Urban,29,242,290,532,Baringo,RIFT VALLEY,8967
KOIBATEK,Urban,30,385,432,817,Baringo,RIFT VALLEY,8968
KOIBATEK,Urban,31,204,187,391,Baringo,RIFT VALLEY,8969
KOIBATEK,Urban,32,278,251,529,Baringo,RIFT VALLEY,8970
KOIBATEK,Urban,33,174,163,337,Baringo,RIFT VALLEY,8971
KOIBATEK,Urban,34,178,161,339,Baringo,RIFT VALLEY,8972
KOIBATEK,Urban,35,285,252,537,Baringo,RIFT VALLEY,8973
KOIBATEK,Urban,36,165,171,336,Baringo,RIFT VALLEY,8974
KOIBATEK,Urban,37,157,134,291,Baringo,RIFT VALLEY,8975
KOIBATEK,Urban,38,138,167,305,Baringo,RIFT VALLEY,8976
KOIBATEK,Urban,39,148,130,278,Baringo,RIFT VALLEY,8977
KOIBATEK,Urban,40,223,239,462,Baringo,RIFT VALLEY,8978
KOIBATEK,Urban,41,102,74,176,Baringo,RIFT VALLEY,8979
KOIBATEK,Urban,42,124,123,247,Baringo,RIFT VALLEY,8980
KOIBATEK,Urban,43,98,80,178,Baringo,RIFT VALLEY,8981
KOIBATEK,Urban,44,83,75,158,Baringo,RIFT VALLEY,8982
KOIBATEK,Urban,45,164,129,293,Baringo,RIFT VALLEY,8983
KOIBATEK,Urban,46,86,67,153,Baringo,RIFT VALLEY,8984
KOIBATEK,Urban,47,92,72,164,Baringo,RIFT VALLEY,8985
KOIBATEK,Urban,48,92,81,173,Baringo,RIFT VALLEY,8986
KOIBATEK,Urban,49,109,73,182,Baringo,RIFT VALLEY,8987
KOIBATEK,Urban,50,113,100,213,Baringo,RIFT VALLEY,8988
KOIBATEK,Urban,51,45,41,86,Baringo,RIFT VALLEY,8989
KOIBATEK,Urban,52,77,46,123,Baringo,RIFT VALLEY,8990
KOIBATEK,Urban,53,57,39,96,Baringo,RIFT VALLEY,8991
KOIBATEK,Urban,54,38,43,81,Baringo,RIFT VALLEY,8992
KOIBATEK,Urban,55,73,66,139,Baringo,RIFT VALLEY,8993
KOIBATEK,Urban,56,41,46,87,Baringo,RIFT VALLEY,8994
KOIBATEK,Urban,57,41,31,72,Baringo,RIFT VALLEY,8995
KOIBATEK,Urban,58,26,33,59,Baringo,RIFT VALLEY,8996
KOIBATEK,Urban,59,28,24,52,Baringo,RIFT VALLEY,8997
KOIBATEK,Urban,60,58,74,132,Baringo,RIFT VALLEY,8998
KOIBATEK,Urban,61,36,23,59,Baringo,RIFT VALLEY,8999
KOIBATEK,Urban,62,27,17,44,Baringo,RIFT VALLEY,9000
KOIBATEK,Urban,63,28,19,47,Baringo,RIFT VALLEY,9001
KOIBATEK,Urban,64,24,23,47,Baringo,RIFT VALLEY,9002
KOIBATEK,Urban,65,32,34,66,Baringo,RIFT VALLEY,9003
KOIBATEK,Urban,66,11,14,25,Baringo,RIFT VALLEY,9004
KOIBATEK,Urban,67,22,21,43,Baringo,RIFT VALLEY,9005
KOIBATEK,Urban,68,17,18,35,Baringo,RIFT VALLEY,9006
KOIBATEK,Urban,69,17,17,34,Baringo,RIFT VALLEY,9007
KOIBATEK,Urban,70,39,44,83,Baringo,RIFT VALLEY,9008
KOIBATEK,Urban,71,10,9,19,Baringo,RIFT VALLEY,9009
KOIBATEK,Urban,72,18,19,37,Baringo,RIFT VALLEY,9010
KOIBATEK,Urban,73,13,13,26,Baringo,RIFT VALLEY,9011
KOIBATEK,Urban,74,9,9,18,Baringo,RIFT VALLEY,9012
KOIBATEK,Urban,75,13,21,34,Baringo,RIFT VALLEY,9013
KOIBATEK,Urban,76,7,14,21,Baringo,RIFT VALLEY,9014
KOIBATEK,Urban,77,9,5,14,Baringo,RIFT VALLEY,9015
KOIBATEK,Urban,78,2,7,9,Baringo,RIFT VALLEY,9016
KOIBATEK,Urban,79,17,20,37,Baringo,RIFT VALLEY,9017
KOIBATEK,Urban,80+,78,118,196,Baringo,RIFT VALLEY,9018
KOIBATEK,Urban,Age NS,3,0,3,Baringo,RIFT VALLEY,9019
ELDORET WEST,Urban,0,2515,2517,5032,Uasin Gishu,RIFT VALLEY,9020
ELDORET WEST,Urban,1,1897,1970,3867,Uasin Gishu,RIFT VALLEY,9021
ELDORET WEST,Urban,2,2170,2151,4321,Uasin Gishu,RIFT VALLEY,9022
ELDORET WEST,Urban,3,2003,2103,4106,Uasin Gishu,RIFT VALLEY,9023
ELDORET WEST,Urban,4,2065,1931,3996,Uasin Gishu,RIFT VALLEY,9024
ELDORET WEST,Urban,5,1971,1895,3866,Uasin Gishu,RIFT VALLEY,9025
ELDORET WEST,Urban,6,1737,1776,3513,Uasin Gishu,RIFT VALLEY,9026
ELDORET WEST,Urban,7,1710,1706,3416,Uasin Gishu,RIFT VALLEY,9027
ELDORET WEST,Urban,8,1597,1703,3300,Uasin Gishu,RIFT VALLEY,9028
ELDORET WEST,Urban,9,1671,1693,3364,Uasin Gishu,RIFT VALLEY,9029
ELDORET WEST,Urban,10,1681,1694,3375,Uasin Gishu,RIFT VALLEY,9030
ELDORET WEST,Urban,11,1175,1316,2491,Uasin Gishu,RIFT VALLEY,9031
ELDORET WEST,Urban,12,1464,1552,3016,Uasin Gishu,RIFT VALLEY,9032
ELDORET WEST,Urban,13,1366,1464,2830,Uasin Gishu,RIFT VALLEY,9033
ELDORET WEST,Urban,14,1210,1306,2516,Uasin Gishu,RIFT VALLEY,9034
ELDORET WEST,Urban,15,1112,1308,2420,Uasin Gishu,RIFT VALLEY,9035
ELDORET WEST,Urban,16,1149,1275,2424,Uasin Gishu,RIFT VALLEY,9036
ELDORET WEST,Urban,17,1242,1461,2703,Uasin Gishu,RIFT VALLEY,9037
ELDORET WEST,Urban,18,1392,1683,3075,Uasin Gishu,RIFT VALLEY,9038
ELDORET WEST,Urban,19,1310,1818,3128,Uasin Gishu,RIFT VALLEY,9039
ELDORET WEST,Urban,20,1844,2602,4446,Uasin Gishu,RIFT VALLEY,9040
ELDORET WEST,Urban,21,1503,1960,3463,Uasin Gishu,RIFT VALLEY,9041
ELDORET WEST,Urban,22,1846,2455,4301,Uasin Gishu,RIFT VALLEY,9042
ELDORET WEST,Urban,23,1775,2172,3947,Uasin Gishu,RIFT VALLEY,9043
ELDORET WEST,Urban,24,1904,2088,3992,Uasin Gishu,RIFT VALLEY,9044
ELDORET WEST,Urban,25,2135,2422,4557,Uasin Gishu,RIFT VALLEY,9045
ELDORET WEST,Urban,26,1601,1754,3355,Uasin Gishu,RIFT VALLEY,9046
ELDORET WEST,Urban,27,1767,1526,3293,Uasin Gishu,RIFT VALLEY,9047
ELDORET WEST,Urban,28,1694,1742,3436,Uasin Gishu,RIFT VALLEY,9048
ELDORET WEST,Urban,29,1454,1317,2771,Uasin Gishu,RIFT VALLEY,9049
ELDORET WEST,Urban,30,2223,1971,4194,Uasin Gishu,RIFT VALLEY,9050
ELDORET WEST,Urban,31,995,787,1782,Uasin Gishu,RIFT VALLEY,9051
ELDORET WEST,Urban,32,1561,1232,2793,Uasin Gishu,RIFT VALLEY,9052
ELDORET WEST,Urban,33,920,732,1652,Uasin Gishu,RIFT VALLEY,9053
ELDORET WEST,Urban,34,1075,817,1892,Uasin Gishu,RIFT VALLEY,9054
ELDORET WEST,Urban,35,1755,1285,3040,Uasin Gishu,RIFT VALLEY,9055
ELDORET WEST,Urban,36,859,736,1595,Uasin Gishu,RIFT VALLEY,9056
ELDORET WEST,Urban,37,871,657,1528,Uasin Gishu,RIFT VALLEY,9057
ELDORET WEST,Urban,38,994,777,1771,Uasin Gishu,RIFT VALLEY,9058
ELDORET WEST,Urban,39,793,626,1419,Uasin Gishu,RIFT VALLEY,9059
ELDORET WEST,Urban,40,1311,952,2263,Uasin Gishu,RIFT VALLEY,9060
ELDORET WEST,Urban,41,524,348,872,Uasin Gishu,RIFT VALLEY,9061
ELDORET WEST,Urban,42,734,547,1281,Uasin Gishu,RIFT VALLEY,9062
ELDORET WEST,Urban,43,509,386,895,Uasin Gishu,RIFT VALLEY,9063
ELDORET WEST,Urban,44,439,271,710,Uasin Gishu,RIFT VALLEY,9064
ELDORET WEST,Urban,45,878,566,1444,Uasin Gishu,RIFT VALLEY,9065
ELDORET WEST,Urban,46,481,374,855,Uasin Gishu,RIFT VALLEY,9066
ELDORET WEST,Urban,47,542,360,902,Uasin Gishu,RIFT VALLEY,9067
ELDORET WEST,Urban,48,505,360,865,Uasin Gishu,RIFT VALLEY,9068
ELDORET WEST,Urban,49,494,247,741,Uasin Gishu,RIFT VALLEY,9069
ELDORET WEST,Urban,50,635,431,1066,Uasin Gishu,RIFT VALLEY,9070
ELDORET WEST,Urban,51,306,183,489,Uasin Gishu,RIFT VALLEY,9071
ELDORET WEST,Urban,52,327,189,516,Uasin Gishu,RIFT VALLEY,9072
ELDORET WEST,Urban,53,245,161,406,Uasin Gishu,RIFT VALLEY,9073
ELDORET WEST,Urban,54,239,141,380,Uasin Gishu,RIFT VALLEY,9074
ELDORET WEST,Urban,55,331,216,547,Uasin Gishu,RIFT VALLEY,9075
ELDORET WEST,Urban,56,196,118,314,Uasin Gishu,RIFT VALLEY,9076
ELDORET WEST,Urban,57,189,128,317,Uasin Gishu,RIFT VALLEY,9077
ELDORET WEST,Urban,58,144,95,239,Uasin Gishu,RIFT VALLEY,9078
ELDORET WEST,Urban,59,148,78,226,Uasin Gishu,RIFT VALLEY,9079
ELDORET WEST,Urban,60,232,173,405,Uasin Gishu,RIFT VALLEY,9080
ELDORET WEST,Urban,61,97,58,155,Uasin Gishu,RIFT VALLEY,9081
ELDORET WEST,Urban,62,131,54,185,Uasin Gishu,RIFT VALLEY,9082
ELDORET WEST,Urban,63,76,57,133,Uasin Gishu,RIFT VALLEY,9083
ELDORET WEST,Urban,64,63,56,119,Uasin Gishu,RIFT VALLEY,9084
ELDORET WEST,Urban,65,135,102,237,Uasin Gishu,RIFT VALLEY,9085
ELDORET WEST,Urban,66,56,45,101,Uasin Gishu,RIFT VALLEY,9086
ELDORET WEST,Urban,67,65,45,110,Uasin Gishu,RIFT VALLEY,9087
ELDORET WEST,Urban,68,51,43,94,Uasin Gishu,RIFT VALLEY,9088
ELDORET WEST,Urban,69,36,30,66,Uasin Gishu,RIFT VALLEY,9089
ELDORET WEST,Urban,70,97,83,180,Uasin Gishu,RIFT VALLEY,9090
ELDORET WEST,Urban,71,20,22,42,Uasin Gishu,RIFT VALLEY,9091
ELDORET WEST,Urban,72,32,31,63,Uasin Gishu,RIFT VALLEY,9092
ELDORET WEST,Urban,73,31,24,55,Uasin Gishu,RIFT VALLEY,9093
ELDORET WEST,Urban,74,25,28,53,Uasin Gishu,RIFT VALLEY,9094
ELDORET WEST,Urban,75,44,47,91,Uasin Gishu,RIFT VALLEY,9095
ELDORET WEST,Urban,76,14,25,39,Uasin Gishu,RIFT VALLEY,9096
ELDORET WEST,Urban,77,30,25,55,Uasin Gishu,RIFT VALLEY,9097
ELDORET WEST,Urban,78,16,19,35,Uasin Gishu,RIFT VALLEY,9098
ELDORET WEST,Urban,79,13,21,34,Uasin Gishu,RIFT VALLEY,9099
ELDORET WEST,Urban,80+,206,342,548,Uasin Gishu,RIFT VALLEY,9100
ELDORET WEST,Urban,Age NS,80,29,109,Uasin Gishu,RIFT VALLEY,9101
ELDORET EAST,Urban,0,1262,1203,2465,Uasin Gishu,RIFT VALLEY,9102
ELDORET EAST,Urban,1,964,939,1903,Uasin Gishu,RIFT VALLEY,9103
ELDORET EAST,Urban,2,1063,1018,2081,Uasin Gishu,RIFT VALLEY,9104
ELDORET EAST,Urban,3,1006,1041,2047,Uasin Gishu,RIFT VALLEY,9105
ELDORET EAST,Urban,4,948,990,1938,Uasin Gishu,RIFT VALLEY,9106
ELDORET EAST,Urban,5,936,942,1878,Uasin Gishu,RIFT VALLEY,9107
ELDORET EAST,Urban,6,877,896,1773,Uasin Gishu,RIFT VALLEY,9108
ELDORET EAST,Urban,7,963,868,1831,Uasin Gishu,RIFT VALLEY,9109
ELDORET EAST,Urban,8,790,887,1677,Uasin Gishu,RIFT VALLEY,9110
ELDORET EAST,Urban,9,914,931,1845,Uasin Gishu,RIFT VALLEY,9111
ELDORET EAST,Urban,10,941,921,1862,Uasin Gishu,RIFT VALLEY,9112
ELDORET EAST,Urban,11,690,696,1386,Uasin Gishu,RIFT VALLEY,9113
ELDORET EAST,Urban,12,816,842,1658,Uasin Gishu,RIFT VALLEY,9114
ELDORET EAST,Urban,13,703,790,1493,Uasin Gishu,RIFT VALLEY,9115
ELDORET EAST,Urban,14,673,797,1470,Uasin Gishu,RIFT VALLEY,9116
ELDORET EAST,Urban,15,590,782,1372,Uasin Gishu,RIFT VALLEY,9117
ELDORET EAST,Urban,16,672,898,1570,Uasin Gishu,RIFT VALLEY,9118
ELDORET EAST,Urban,17,756,1032,1788,Uasin Gishu,RIFT VALLEY,9119
ELDORET EAST,Urban,18,825,964,1789,Uasin Gishu,RIFT VALLEY,9120
ELDORET EAST,Urban,19,851,1042,1893,Uasin Gishu,RIFT VALLEY,9121
ELDORET EAST,Urban,20,1338,1494,2832,Uasin Gishu,RIFT VALLEY,9122
ELDORET EAST,Urban,21,1101,1221,2322,Uasin Gishu,RIFT VALLEY,9123
ELDORET EAST,Urban,22,1365,1516,2881,Uasin Gishu,RIFT VALLEY,9124
ELDORET EAST,Urban,23,1227,1306,2533,Uasin Gishu,RIFT VALLEY,9125
ELDORET EAST,Urban,24,1242,1296,2538,Uasin Gishu,RIFT VALLEY,9126
ELDORET EAST,Urban,25,1309,1340,2649,Uasin Gishu,RIFT VALLEY,9127
ELDORET EAST,Urban,26,966,1020,1986,Uasin Gishu,RIFT VALLEY,9128
ELDORET EAST,Urban,27,969,887,1856,Uasin Gishu,RIFT VALLEY,9129
ELDORET EAST,Urban,28,916,1030,1946,Uasin Gishu,RIFT VALLEY,9130
ELDORET EAST,Urban,29,786,729,1515,Uasin Gishu,RIFT VALLEY,9131
ELDORET EAST,Urban,30,1207,1148,2355,Uasin Gishu,RIFT VALLEY,9132
ELDORET EAST,Urban,31,570,482,1052,Uasin Gishu,RIFT VALLEY,9133
ELDORET EAST,Urban,32,866,760,1626,Uasin Gishu,RIFT VALLEY,9134
ELDORET EAST,Urban,33,494,412,906,Uasin Gishu,RIFT VALLEY,9135
ELDORET EAST,Urban,34,594,469,1063,Uasin Gishu,RIFT VALLEY,9136
ELDORET EAST,Urban,35,926,740,1666,Uasin Gishu,RIFT VALLEY,9137
ELDORET EAST,Urban,36,525,400,925,Uasin Gishu,RIFT VALLEY,9138
ELDORET EAST,Urban,37,478,373,851,Uasin Gishu,RIFT VALLEY,9139
ELDORET EAST,Urban,38,477,469,946,Uasin Gishu,RIFT VALLEY,9140
ELDORET EAST,Urban,39,395,328,723,Uasin Gishu,RIFT VALLEY,9141
ELDORET EAST,Urban,40,690,575,1265,Uasin Gishu,RIFT VALLEY,9142
ELDORET EAST,Urban,41,291,191,482,Uasin Gishu,RIFT VALLEY,9143
ELDORET EAST,Urban,42,393,288,681,Uasin Gishu,RIFT VALLEY,9144
ELDORET EAST,Urban,43,258,226,484,Uasin Gishu,RIFT VALLEY,9145
ELDORET EAST,Urban,44,224,143,367,Uasin Gishu,RIFT VALLEY,9146
ELDORET EAST,Urban,45,439,340,779,Uasin Gishu,RIFT VALLEY,9147
ELDORET EAST,Urban,46,242,200,442,Uasin Gishu,RIFT VALLEY,9148
ELDORET EAST,Urban,47,261,214,475,Uasin Gishu,RIFT VALLEY,9149
ELDORET EAST,Urban,48,234,209,443,Uasin Gishu,RIFT VALLEY,9150
ELDORET EAST,Urban,49,224,148,372,Uasin Gishu,RIFT VALLEY,9151
ELDORET EAST,Urban,50,302,224,526,Uasin Gishu,RIFT VALLEY,9152
ELDORET EAST,Urban,51,113,71,184,Uasin Gishu,RIFT VALLEY,9153
ELDORET EAST,Urban,52,180,132,312,Uasin Gishu,RIFT VALLEY,9154
ELDORET EAST,Urban,53,113,63,176,Uasin Gishu,RIFT VALLEY,9155
ELDORET EAST,Urban,54,128,76,204,Uasin Gishu,RIFT VALLEY,9156
ELDORET EAST,Urban,55,151,90,241,Uasin Gishu,RIFT VALLEY,9157
ELDORET EAST,Urban,56,101,76,177,Uasin Gishu,RIFT VALLEY,9158
ELDORET EAST,Urban,57,111,64,175,Uasin Gishu,RIFT VALLEY,9159
ELDORET EAST,Urban,58,83,47,130,Uasin Gishu,RIFT VALLEY,9160
ELDORET EAST,Urban,59,58,53,111,Uasin Gishu,RIFT VALLEY,9161
ELDORET EAST,Urban,60,129,113,242,Uasin Gishu,RIFT VALLEY,9162
ELDORET EAST,Urban,61,51,26,77,Uasin Gishu,RIFT VALLEY,9163
ELDORET EAST,Urban,62,65,41,106,Uasin Gishu,RIFT VALLEY,9164
ELDORET EAST,Urban,63,39,32,71,Uasin Gishu,RIFT VALLEY,9165
ELDORET EAST,Urban,64,43,42,85,Uasin Gishu,RIFT VALLEY,9166
ELDORET EAST,Urban,65,65,64,129,Uasin Gishu,RIFT VALLEY,9167
ELDORET EAST,Urban,66,31,35,66,Uasin Gishu,RIFT VALLEY,9168
ELDORET EAST,Urban,67,33,40,73,Uasin Gishu,RIFT VALLEY,9169
ELDORET EAST,Urban,68,29,27,56,Uasin Gishu,RIFT VALLEY,9170
ELDORET EAST,Urban,69,27,23,50,Uasin Gishu,RIFT VALLEY,9171
ELDORET EAST,Urban,70,42,76,118,Uasin Gishu,RIFT VALLEY,9172
ELDORET EAST,Urban,71,24,13,37,Uasin Gishu,RIFT VALLEY,9173
ELDORET EAST,Urban,72,24,24,48,Uasin Gishu,RIFT VALLEY,9174
ELDORET EAST,Urban,73,13,24,37,Uasin Gishu,RIFT VALLEY,9175
ELDORET EAST,Urban,74,18,6,24,Uasin Gishu,RIFT VALLEY,9176
ELDORET EAST,Urban,75,25,35,60,Uasin Gishu,RIFT VALLEY,9177
ELDORET EAST,Urban,76,18,12,30,Uasin Gishu,RIFT VALLEY,9178
ELDORET EAST,Urban,77,14,12,26,Uasin Gishu,RIFT VALLEY,9179
ELDORET EAST,Urban,78,14,17,31,Uasin Gishu,RIFT VALLEY,9180
ELDORET EAST,Urban,79,10,15,25,Uasin Gishu,RIFT VALLEY,9181
ELDORET EAST,Urban,80+,148,205,353,Uasin Gishu,RIFT VALLEY,9182
ELDORET EAST,Urban,Age NS,29,40,69,Uasin Gishu,RIFT VALLEY,9183
WARENG,Urban,0,2036,1949,3985,Uasin Gishu,RIFT VALLEY,9184
WARENG,Urban,1,1649,1564,3213,Uasin Gishu,RIFT VALLEY,9185
WARENG,Urban,2,1744,1757,3501,Uasin Gishu,RIFT VALLEY,9186
WARENG,Urban,3,1746,1742,3488,Uasin Gishu,RIFT VALLEY,9187
WARENG,Urban,4,1712,1632,3344,Uasin Gishu,RIFT VALLEY,9188
WARENG,Urban,5,1654,1524,3178,Uasin Gishu,RIFT VALLEY,9189
WARENG,Urban,6,1494,1558,3052,Uasin Gishu,RIFT VALLEY,9190
WARENG,Urban,7,1434,1534,2968,Uasin Gishu,RIFT VALLEY,9191
WARENG,Urban,8,1333,1403,2736,Uasin Gishu,RIFT VALLEY,9192
WARENG,Urban,9,1446,1405,2851,Uasin Gishu,RIFT VALLEY,9193
WARENG,Urban,10,1389,1500,2889,Uasin Gishu,RIFT VALLEY,9194
WARENG,Urban,11,1016,1144,2160,Uasin Gishu,RIFT VALLEY,9195
WARENG,Urban,12,1305,1291,2596,Uasin Gishu,RIFT VALLEY,9196
WARENG,Urban,13,1195,1217,2412,Uasin Gishu,RIFT VALLEY,9197
WARENG,Urban,14,1058,1060,2118,Uasin Gishu,RIFT VALLEY,9198
WARENG,Urban,15,1055,1150,2205,Uasin Gishu,RIFT VALLEY,9199
WARENG,Urban,16,996,1140,2136,Uasin Gishu,RIFT VALLEY,9200
WARENG,Urban,17,1183,1184,2367,Uasin Gishu,RIFT VALLEY,9201
WARENG,Urban,18,1216,1334,2550,Uasin Gishu,RIFT VALLEY,9202
WARENG,Urban,19,1168,1360,2528,Uasin Gishu,RIFT VALLEY,9203
WARENG,Urban,20,1590,2222,3812,Uasin Gishu,RIFT VALLEY,9204
WARENG,Urban,21,1327,1602,2929,Uasin Gishu,RIFT VALLEY,9205
WARENG,Urban,22,1639,2108,3747,Uasin Gishu,RIFT VALLEY,9206
WARENG,Urban,23,1720,1824,3544,Uasin Gishu,RIFT VALLEY,9207
WARENG,Urban,24,1647,1750,3397,Uasin Gishu,RIFT VALLEY,9208
WARENG,Urban,25,1950,2008,3958,Uasin Gishu,RIFT VALLEY,9209
WARENG,Urban,26,1441,1411,2852,Uasin Gishu,RIFT VALLEY,9210
WARENG,Urban,27,1473,1303,2776,Uasin Gishu,RIFT VALLEY,9211
WARENG,Urban,28,1414,1414,2828,Uasin Gishu,RIFT VALLEY,9212
WARENG,Urban,29,1146,1001,2147,Uasin Gishu,RIFT VALLEY,9213
WARENG,Urban,30,1825,1590,3415,Uasin Gishu,RIFT VALLEY,9214
WARENG,Urban,31,877,644,1521,Uasin Gishu,RIFT VALLEY,9215
WARENG,Urban,32,1222,1020,2242,Uasin Gishu,RIFT VALLEY,9216
WARENG,Urban,33,772,603,1375,Uasin Gishu,RIFT VALLEY,9217
WARENG,Urban,34,791,653,1444,Uasin Gishu,RIFT VALLEY,9218
WARENG,Urban,35,1408,1039,2447,Uasin Gishu,RIFT VALLEY,9219
WARENG,Urban,36,660,555,1215,Uasin Gishu,RIFT VALLEY,9220
WARENG,Urban,37,671,540,1211,Uasin Gishu,RIFT VALLEY,9221
WARENG,Urban,38,701,588,1289,Uasin Gishu,RIFT VALLEY,9222
WARENG,Urban,39,544,486,1030,Uasin Gishu,RIFT VALLEY,9223
WARENG,Urban,40,1068,754,1822,Uasin Gishu,RIFT VALLEY,9224
WARENG,Urban,41,424,292,716,Uasin Gishu,RIFT VALLEY,9225
WARENG,Urban,42,565,439,1004,Uasin Gishu,RIFT VALLEY,9226
WARENG,Urban,43,373,281,654,Uasin Gishu,RIFT VALLEY,9227
WARENG,Urban,44,317,240,557,Uasin Gishu,RIFT VALLEY,9228
WARENG,Urban,45,662,498,1160,Uasin Gishu,RIFT VALLEY,9229
WARENG,Urban,46,435,276,711,Uasin Gishu,RIFT VALLEY,9230
WARENG,Urban,47,393,248,641,Uasin Gishu,RIFT VALLEY,9231
WARENG,Urban,48,360,323,683,Uasin Gishu,RIFT VALLEY,9232
WARENG,Urban,49,328,245,573,Uasin Gishu,RIFT VALLEY,9233
WARENG,Urban,50,474,327,801,Uasin Gishu,RIFT VALLEY,9234
WARENG,Urban,51,215,131,346,Uasin Gishu,RIFT VALLEY,9235
WARENG,Urban,52,311,160,471,Uasin Gishu,RIFT VALLEY,9236
WARENG,Urban,53,184,146,330,Uasin Gishu,RIFT VALLEY,9237
WARENG,Urban,54,178,132,310,Uasin Gishu,RIFT VALLEY,9238
WARENG,Urban,55,256,170,426,Uasin Gishu,RIFT VALLEY,9239
WARENG,Urban,56,150,139,289,Uasin Gishu,RIFT VALLEY,9240
WARENG,Urban,57,206,128,334,Uasin Gishu,RIFT VALLEY,9241
WARENG,Urban,58,128,84,212,Uasin Gishu,RIFT VALLEY,9242
WARENG,Urban,59,122,72,194,Uasin Gishu,RIFT VALLEY,9243
WARENG,Urban,60,213,180,393,Uasin Gishu,RIFT VALLEY,9244
WARENG,Urban,61,109,57,166,Uasin Gishu,RIFT VALLEY,9245
WARENG,Urban,62,105,59,164,Uasin Gishu,RIFT VALLEY,9246
WARENG,Urban,63,66,58,124,Uasin Gishu,RIFT VALLEY,9247
WARENG,Urban,64,55,58,113,Uasin Gishu,RIFT VALLEY,9248
WARENG,Urban,65,120,87,207,Uasin Gishu,RIFT VALLEY,9249
WARENG,Urban,66,47,53,100,Uasin Gishu,RIFT VALLEY,9250
WARENG,Urban,67,69,48,117,Uasin Gishu,RIFT VALLEY,9251
WARENG,Urban,68,45,52,97,Uasin Gishu,RIFT VALLEY,9252
WARENG,Urban,69,44,51,95,Uasin Gishu,RIFT VALLEY,9253
WARENG,Urban,70,89,97,186,Uasin Gishu,RIFT VALLEY,9254
WARENG,Urban,71,20,31,51,Uasin Gishu,RIFT VALLEY,9255
WARENG,Urban,72,38,24,62,Uasin Gishu,RIFT VALLEY,9256
WARENG,Urban,73,29,28,57,Uasin Gishu,RIFT VALLEY,9257
WARENG,Urban,74,27,28,55,Uasin Gishu,RIFT VALLEY,9258
WARENG,Urban,75,41,38,79,Uasin Gishu,RIFT VALLEY,9259
WARENG,Urban,76,28,26,54,Uasin Gishu,RIFT VALLEY,9260
WARENG,Urban,77,22,16,38,Uasin Gishu,RIFT VALLEY,9261
WARENG,Urban,78,28,22,50,Uasin Gishu,RIFT VALLEY,9262
WARENG,Urban,79,29,28,57,Uasin Gishu,RIFT VALLEY,9263
WARENG,Urban,80+,237,344,581,Uasin Gishu,RIFT VALLEY,9264
WARENG,Urban,Age NS,39,32,71,Uasin Gishu,RIFT VALLEY,9265
MARAKWET,Urban,0,199,192,391,Elgeyo Marakwet,RIFT VALLEY,9266
MARAKWET,Urban,1,69,73,142,Elgeyo Marakwet,RIFT VALLEY,9267
MARAKWET,Urban,2,117,114,231,Elgeyo Marakwet,RIFT VALLEY,9268
MARAKWET,Urban,3,115,121,236,Elgeyo Marakwet,RIFT VALLEY,9269
MARAKWET,Urban,4,120,113,233,Elgeyo Marakwet,RIFT VALLEY,9270
MARAKWET,Urban,5,110,106,216,Elgeyo Marakwet,RIFT VALLEY,9271
MARAKWET,Urban,6,99,106,205,Elgeyo Marakwet,RIFT VALLEY,9272
MARAKWET,Urban,7,92,94,186,Elgeyo Marakwet,RIFT VALLEY,9273
MARAKWET,Urban,8,108,103,211,Elgeyo Marakwet,RIFT VALLEY,9274
MARAKWET,Urban,9,90,94,184,Elgeyo Marakwet,RIFT VALLEY,9275
MARAKWET,Urban,10,107,96,203,Elgeyo Marakwet,RIFT VALLEY,9276
MARAKWET,Urban,11,79,94,173,Elgeyo Marakwet,RIFT VALLEY,9277
MARAKWET,Urban,12,92,88,180,Elgeyo Marakwet,RIFT VALLEY,9278
MARAKWET,Urban,13,91,85,176,Elgeyo Marakwet,RIFT VALLEY,9279
MARAKWET,Urban,14,71,90,161,Elgeyo Marakwet,RIFT VALLEY,9280
MARAKWET,Urban,15,59,74,133,Elgeyo Marakwet,RIFT VALLEY,9281
MARAKWET,Urban,16,70,85,155,Elgeyo Marakwet,RIFT VALLEY,9282
MARAKWET,Urban,17,84,102,186,Elgeyo Marakwet,RIFT VALLEY,9283
MARAKWET,Urban,18,83,85,168,Elgeyo Marakwet,RIFT VALLEY,9284
MARAKWET,Urban,19,81,102,183,Elgeyo Marakwet,RIFT VALLEY,9285
MARAKWET,Urban,20,91,145,236,Elgeyo Marakwet,RIFT VALLEY,9286
MARAKWET,Urban,21,61,96,157,Elgeyo Marakwet,RIFT VALLEY,9287
MARAKWET,Urban,22,85,125,210,Elgeyo Marakwet,RIFT VALLEY,9288
MARAKWET,Urban,23,77,93,170,Elgeyo Marakwet,RIFT VALLEY,9289
MARAKWET,Urban,24,79,113,192,Elgeyo Marakwet,RIFT VALLEY,9290
MARAKWET,Urban,25,117,124,241,Elgeyo Marakwet,RIFT VALLEY,9291
MARAKWET,Urban,26,57,79,136,Elgeyo Marakwet,RIFT VALLEY,9292
MARAKWET,Urban,27,85,80,165,Elgeyo Marakwet,RIFT VALLEY,9293
MARAKWET,Urban,28,88,80,168,Elgeyo Marakwet,RIFT VALLEY,9294
MARAKWET,Urban,29,40,57,97,Elgeyo Marakwet,RIFT VALLEY,9295
MARAKWET,Urban,30,82,99,181,Elgeyo Marakwet,RIFT VALLEY,9296
MARAKWET,Urban,31,28,46,74,Elgeyo Marakwet,RIFT VALLEY,9297
MARAKWET,Urban,32,72,67,139,Elgeyo Marakwet,RIFT VALLEY,9298
MARAKWET,Urban,33,40,46,86,Elgeyo Marakwet,RIFT VALLEY,9299
MARAKWET,Urban,34,40,61,101,Elgeyo Marakwet,RIFT VALLEY,9300
MARAKWET,Urban,35,88,57,145,Elgeyo Marakwet,RIFT VALLEY,9301
MARAKWET,Urban,36,43,39,82,Elgeyo Marakwet,RIFT VALLEY,9302
MARAKWET,Urban,37,46,24,70,Elgeyo Marakwet,RIFT VALLEY,9303
MARAKWET,Urban,38,34,38,72,Elgeyo Marakwet,RIFT VALLEY,9304
MARAKWET,Urban,39,24,22,46,Elgeyo Marakwet,RIFT VALLEY,9305
MARAKWET,Urban,40,49,44,93,Elgeyo Marakwet,RIFT VALLEY,9306
MARAKWET,Urban,41,21,12,33,Elgeyo Marakwet,RIFT VALLEY,9307
MARAKWET,Urban,42,33,23,56,Elgeyo Marakwet,RIFT VALLEY,9308
MARAKWET,Urban,43,29,21,50,Elgeyo Marakwet,RIFT VALLEY,9309
MARAKWET,Urban,44,11,13,24,Elgeyo Marakwet,RIFT VALLEY,9310
MARAKWET,Urban,45,39,31,70,Elgeyo Marakwet,RIFT VALLEY,9311
MARAKWET,Urban,46,21,18,39,Elgeyo Marakwet,RIFT VALLEY,9312
MARAKWET,Urban,47,28,20,48,Elgeyo Marakwet,RIFT VALLEY,9313
MARAKWET,Urban,48,33,18,51,Elgeyo Marakwet,RIFT VALLEY,9314
MARAKWET,Urban,49,25,10,35,Elgeyo Marakwet,RIFT VALLEY,9315
MARAKWET,Urban,50,33,26,59,Elgeyo Marakwet,RIFT VALLEY,9316
MARAKWET,Urban,51,17,10,27,Elgeyo Marakwet,RIFT VALLEY,9317
MARAKWET,Urban,52,16,12,28,Elgeyo Marakwet,RIFT VALLEY,9318
MARAKWET,Urban,53,12,8,20,Elgeyo Marakwet,RIFT VALLEY,9319
MARAKWET,Urban,54,13,5,18,Elgeyo Marakwet,RIFT VALLEY,9320
MARAKWET,Urban,55,16,11,27,Elgeyo Marakwet,RIFT VALLEY,9321
MARAKWET,Urban,56,9,6,15,Elgeyo Marakwet,RIFT VALLEY,9322
MARAKWET,Urban,57,13,1,14,Elgeyo Marakwet,RIFT VALLEY,9323
MARAKWET,Urban,58,10,3,13,Elgeyo Marakwet,RIFT VALLEY,9324
MARAKWET,Urban,59,11,5,16,Elgeyo Marakwet,RIFT VALLEY,9325
MARAKWET,Urban,60,12,11,23,Elgeyo Marakwet,RIFT VALLEY,9326
MARAKWET,Urban,61,5,0,5,Elgeyo Marakwet,RIFT VALLEY,9327
MARAKWET,Urban,62,3,2,5,Elgeyo Marakwet,RIFT VALLEY,9328
MARAKWET,Urban,63,4,3,7,Elgeyo Marakwet,RIFT VALLEY,9329
MARAKWET,Urban,64,5,2,7,Elgeyo Marakwet,RIFT VALLEY,9330
MARAKWET,Urban,65,4,9,13,Elgeyo Marakwet,RIFT VALLEY,9331
MARAKWET,Urban,66,4,1,5,Elgeyo Marakwet,RIFT VALLEY,9332
MARAKWET,Urban,67,3,2,5,Elgeyo Marakwet,RIFT VALLEY,9333
MARAKWET,Urban,68,1,4,5,Elgeyo Marakwet,RIFT VALLEY,9334
MARAKWET,Urban,69,2,2,4,Elgeyo Marakwet,RIFT VALLEY,9335
MARAKWET,Urban,70,7,6,13,Elgeyo Marakwet,RIFT VALLEY,9336
MARAKWET,Urban,71,4,4,8,Elgeyo Marakwet,RIFT VALLEY,9337
MARAKWET,Urban,72,1,3,4,Elgeyo Marakwet,RIFT VALLEY,9338
MARAKWET,Urban,73,1,2,3,Elgeyo Marakwet,RIFT VALLEY,9339
MARAKWET,Urban,74,2,3,5,Elgeyo Marakwet,RIFT VALLEY,9340
MARAKWET,Urban,75,2,5,7,Elgeyo Marakwet,RIFT VALLEY,9341
MARAKWET,Urban,76,4,2,6,Elgeyo Marakwet,RIFT VALLEY,9342
MARAKWET,Urban,77,0,1,1,Elgeyo Marakwet,RIFT VALLEY,9343
MARAKWET,Urban,78,2,2,4,Elgeyo Marakwet,RIFT VALLEY,9344
MARAKWET,Urban,79,2,2,4,Elgeyo Marakwet,RIFT VALLEY,9345
MARAKWET,Urban,80+,31,40,71,Elgeyo Marakwet,RIFT VALLEY,9346
MARAKWET,Urban,Age NS,2,1,3,Elgeyo Marakwet,RIFT VALLEY,9347
KEIYO,Urban,0,757,700,1457,Elgeyo Marakwet,RIFT VALLEY,9348
KEIYO,Urban,1,672,582,1254,Elgeyo Marakwet,RIFT VALLEY,9349
KEIYO,Urban,2,639,666,1305,Elgeyo Marakwet,RIFT VALLEY,9350
KEIYO,Urban,3,726,705,1431,Elgeyo Marakwet,RIFT VALLEY,9351
KEIYO,Urban,4,671,690,1361,Elgeyo Marakwet,RIFT VALLEY,9352
KEIYO,Urban,5,650,675,1325,Elgeyo Marakwet,RIFT VALLEY,9353
KEIYO,Urban,6,638,645,1283,Elgeyo Marakwet,RIFT VALLEY,9354
KEIYO,Urban,7,621,615,1236,Elgeyo Marakwet,RIFT VALLEY,9355
KEIYO,Urban,8,618,605,1223,Elgeyo Marakwet,RIFT VALLEY,9356
KEIYO,Urban,9,636,624,1260,Elgeyo Marakwet,RIFT VALLEY,9357
KEIYO,Urban,10,653,680,1333,Elgeyo Marakwet,RIFT VALLEY,9358
KEIYO,Urban,11,498,545,1043,Elgeyo Marakwet,RIFT VALLEY,9359
KEIYO,Urban,12,622,685,1307,Elgeyo Marakwet,RIFT VALLEY,9360
KEIYO,Urban,13,538,586,1124,Elgeyo Marakwet,RIFT VALLEY,9361
KEIYO,Urban,14,562,592,1154,Elgeyo Marakwet,RIFT VALLEY,9362
KEIYO,Urban,15,572,623,1195,Elgeyo Marakwet,RIFT VALLEY,9363
KEIYO,Urban,16,533,615,1148,Elgeyo Marakwet,RIFT VALLEY,9364
KEIYO,Urban,17,537,663,1200,Elgeyo Marakwet,RIFT VALLEY,9365
KEIYO,Urban,18,527,562,1089,Elgeyo Marakwet,RIFT VALLEY,9366
KEIYO,Urban,19,508,495,1003,Elgeyo Marakwet,RIFT VALLEY,9367
KEIYO,Urban,20,529,542,1071,Elgeyo Marakwet,RIFT VALLEY,9368
KEIYO,Urban,21,352,403,755,Elgeyo Marakwet,RIFT VALLEY,9369
KEIYO,Urban,22,443,544,987,Elgeyo Marakwet,RIFT VALLEY,9370
KEIYO,Urban,23,396,483,879,Elgeyo Marakwet,RIFT VALLEY,9371
KEIYO,Urban,24,425,515,940,Elgeyo Marakwet,RIFT VALLEY,9372
KEIYO,Urban,25,522,613,1135,Elgeyo Marakwet,RIFT VALLEY,9373
KEIYO,Urban,26,357,414,771,Elgeyo Marakwet,RIFT VALLEY,9374
KEIYO,Urban,27,361,386,747,Elgeyo Marakwet,RIFT VALLEY,9375
KEIYO,Urban,28,346,343,689,Elgeyo Marakwet,RIFT VALLEY,9376
KEIYO,Urban,29,302,348,650,Elgeyo Marakwet,RIFT VALLEY,9377
KEIYO,Urban,30,448,450,898,Elgeyo Marakwet,RIFT VALLEY,9378
KEIYO,Urban,31,263,240,503,Elgeyo Marakwet,RIFT VALLEY,9379
KEIYO,Urban,32,315,297,612,Elgeyo Marakwet,RIFT VALLEY,9380
KEIYO,Urban,33,221,231,452,Elgeyo Marakwet,RIFT VALLEY,9381
KEIYO,Urban,34,244,238,482,Elgeyo Marakwet,RIFT VALLEY,9382
KEIYO,Urban,35,393,379,772,Elgeyo Marakwet,RIFT VALLEY,9383
KEIYO,Urban,36,212,212,424,Elgeyo Marakwet,RIFT VALLEY,9384
KEIYO,Urban,37,242,213,455,Elgeyo Marakwet,RIFT VALLEY,9385
KEIYO,Urban,38,199,198,397,Elgeyo Marakwet,RIFT VALLEY,9386
KEIYO,Urban,39,181,186,367,Elgeyo Marakwet,RIFT VALLEY,9387
KEIYO,Urban,40,279,281,560,Elgeyo Marakwet,RIFT VALLEY,9388
KEIYO,Urban,41,151,139,290,Elgeyo Marakwet,RIFT VALLEY,9389
KEIYO,Urban,42,154,133,287,Elgeyo Marakwet,RIFT VALLEY,9390
KEIYO,Urban,43,97,126,223,Elgeyo Marakwet,RIFT VALLEY,9391
KEIYO,Urban,44,122,127,249,Elgeyo Marakwet,RIFT VALLEY,9392
KEIYO,Urban,45,177,195,372,Elgeyo Marakwet,RIFT VALLEY,9393
KEIYO,Urban,46,106,125,231,Elgeyo Marakwet,RIFT VALLEY,9394
KEIYO,Urban,47,121,120,241,Elgeyo Marakwet,RIFT VALLEY,9395
KEIYO,Urban,48,135,181,316,Elgeyo Marakwet,RIFT VALLEY,9396
KEIYO,Urban,49,129,113,242,Elgeyo Marakwet,RIFT VALLEY,9397
KEIYO,Urban,50,165,209,374,Elgeyo Marakwet,RIFT VALLEY,9398
KEIYO,Urban,51,106,93,199,Elgeyo Marakwet,RIFT VALLEY,9399
KEIYO,Urban,52,99,90,189,Elgeyo Marakwet,RIFT VALLEY,9400
KEIYO,Urban,53,77,79,156,Elgeyo Marakwet,RIFT VALLEY,9401
KEIYO,Urban,54,87,83,170,Elgeyo Marakwet,RIFT VALLEY,9402
KEIYO,Urban,55,119,119,238,Elgeyo Marakwet,RIFT VALLEY,9403
KEIYO,Urban,56,79,53,132,Elgeyo Marakwet,RIFT VALLEY,9404
KEIYO,Urban,57,109,100,209,Elgeyo Marakwet,RIFT VALLEY,9405
KEIYO,Urban,58,36,38,74,Elgeyo Marakwet,RIFT VALLEY,9406
KEIYO,Urban,59,72,68,140,Elgeyo Marakwet,RIFT VALLEY,9407
KEIYO,Urban,60,109,93,202,Elgeyo Marakwet,RIFT VALLEY,9408
KEIYO,Urban,61,58,51,109,Elgeyo Marakwet,RIFT VALLEY,9409
KEIYO,Urban,62,44,35,79,Elgeyo Marakwet,RIFT VALLEY,9410
KEIYO,Urban,63,33,39,72,Elgeyo Marakwet,RIFT VALLEY,9411
KEIYO,Urban,64,39,35,74,Elgeyo Marakwet,RIFT VALLEY,9412
KEIYO,Urban,65,55,80,135,Elgeyo Marakwet,RIFT VALLEY,9413
KEIYO,Urban,66,41,41,82,Elgeyo Marakwet,RIFT VALLEY,9414
KEIYO,Urban,67,28,52,80,Elgeyo Marakwet,RIFT VALLEY,9415
KEIYO,Urban,68,26,27,53,Elgeyo Marakwet,RIFT VALLEY,9416
KEIYO,Urban,69,22,47,69,Elgeyo Marakwet,RIFT VALLEY,9417
KEIYO,Urban,70,57,91,148,Elgeyo Marakwet,RIFT VALLEY,9418
KEIYO,Urban,71,25,22,47,Elgeyo Marakwet,RIFT VALLEY,9419
KEIYO,Urban,72,17,27,44,Elgeyo Marakwet,RIFT VALLEY,9420
KEIYO,Urban,73,22,25,47,Elgeyo Marakwet,RIFT VALLEY,9421
KEIYO,Urban,74,17,15,32,Elgeyo Marakwet,RIFT VALLEY,9422
KEIYO,Urban,75,26,42,68,Elgeyo Marakwet,RIFT VALLEY,9423
KEIYO,Urban,76,18,8,26,Elgeyo Marakwet,RIFT VALLEY,9424
KEIYO,Urban,77,6,7,13,Elgeyo Marakwet,RIFT VALLEY,9425
KEIYO,Urban,78,25,16,41,Elgeyo Marakwet,RIFT VALLEY,9426
KEIYO,Urban,79,23,34,57,Elgeyo Marakwet,RIFT VALLEY,9427
KEIYO,Urban,80+,153,271,424,Elgeyo Marakwet,RIFT VALLEY,9428
KEIYO,Urban,Age NS,7,3,10,Elgeyo Marakwet,RIFT VALLEY,9429
NANDI NORTH,Urban,0,46,50,96,Nandi,RIFT VALLEY,9430
NANDI NORTH,Urban,1,51,47,98,Nandi,RIFT VALLEY,9431
NANDI NORTH,Urban,2,57,51,108,Nandi,RIFT VALLEY,9432
NANDI NORTH,Urban,3,51,47,98,Nandi,RIFT VALLEY,9433
NANDI NORTH,Urban,4,50,50,100,Nandi,RIFT VALLEY,9434
NANDI NORTH,Urban,5,47,50,97,Nandi,RIFT VALLEY,9435
NANDI NORTH,Urban,6,40,43,83,Nandi,RIFT VALLEY,9436
NANDI NORTH,Urban,7,41,50,91,Nandi,RIFT VALLEY,9437
NANDI NORTH,Urban,8,41,38,79,Nandi,RIFT VALLEY,9438
NANDI NORTH,Urban,9,38,48,86,Nandi,RIFT VALLEY,9439
NANDI NORTH,Urban,10,38,46,84,Nandi,RIFT VALLEY,9440
NANDI NORTH,Urban,11,25,27,52,Nandi,RIFT VALLEY,9441
NANDI NORTH,Urban,12,39,42,81,Nandi,RIFT VALLEY,9442
NANDI NORTH,Urban,13,33,40,73,Nandi,RIFT VALLEY,9443
NANDI NORTH,Urban,14,30,39,69,Nandi,RIFT VALLEY,9444
NANDI NORTH,Urban,15,33,47,80,Nandi,RIFT VALLEY,9445
NANDI NORTH,Urban,16,24,25,49,Nandi,RIFT VALLEY,9446
NANDI NORTH,Urban,17,39,44,83,Nandi,RIFT VALLEY,9447
NANDI NORTH,Urban,18,33,36,69,Nandi,RIFT VALLEY,9448
NANDI NORTH,Urban,19,49,33,82,Nandi,RIFT VALLEY,9449
NANDI NORTH,Urban,20,35,47,82,Nandi,RIFT VALLEY,9450
NANDI NORTH,Urban,21,40,34,74,Nandi,RIFT VALLEY,9451
NANDI NORTH,Urban,22,50,46,96,Nandi,RIFT VALLEY,9452
NANDI NORTH,Urban,23,42,50,92,Nandi,RIFT VALLEY,9453
NANDI NORTH,Urban,24,34,39,73,Nandi,RIFT VALLEY,9454
NANDI NORTH,Urban,25,40,52,92,Nandi,RIFT VALLEY,9455
NANDI NORTH,Urban,26,42,34,76,Nandi,RIFT VALLEY,9456
NANDI NORTH,Urban,27,40,53,93,Nandi,RIFT VALLEY,9457
NANDI NORTH,Urban,28,44,56,100,Nandi,RIFT VALLEY,9458
NANDI NORTH,Urban,29,35,42,77,Nandi,RIFT VALLEY,9459
NANDI NORTH,Urban,30,67,55,122,Nandi,RIFT VALLEY,9460
NANDI NORTH,Urban,31,35,31,66,Nandi,RIFT VALLEY,9461
NANDI NORTH,Urban,32,44,44,88,Nandi,RIFT VALLEY,9462
NANDI NORTH,Urban,33,27,33,60,Nandi,RIFT VALLEY,9463
NANDI NORTH,Urban,34,40,39,79,Nandi,RIFT VALLEY,9464
NANDI NORTH,Urban,35,48,37,85,Nandi,RIFT VALLEY,9465
NANDI NORTH,Urban,36,23,24,47,Nandi,RIFT VALLEY,9466
NANDI NORTH,Urban,37,30,25,55,Nandi,RIFT VALLEY,9467
NANDI NORTH,Urban,38,32,24,56,Nandi,RIFT VALLEY,9468
NANDI NORTH,Urban,39,18,27,45,Nandi,RIFT VALLEY,9469
NANDI NORTH,Urban,40,27,41,68,Nandi,RIFT VALLEY,9470
NANDI NORTH,Urban,41,19,25,44,Nandi,RIFT VALLEY,9471
NANDI NORTH,Urban,42,33,27,60,Nandi,RIFT VALLEY,9472
NANDI NORTH,Urban,43,21,10,31,Nandi,RIFT VALLEY,9473
NANDI NORTH,Urban,44,26,12,38,Nandi,RIFT VALLEY,9474
NANDI NORTH,Urban,45,19,9,28,Nandi,RIFT VALLEY,9475
NANDI NORTH,Urban,46,19,17,36,Nandi,RIFT VALLEY,9476
NANDI NORTH,Urban,47,12,16,28,Nandi,RIFT VALLEY,9477
NANDI NORTH,Urban,48,11,6,17,Nandi,RIFT VALLEY,9478
NANDI NORTH,Urban,49,18,8,26,Nandi,RIFT VALLEY,9479
NANDI NORTH,Urban,50,16,12,28,Nandi,RIFT VALLEY,9480
NANDI NORTH,Urban,51,7,5,12,Nandi,RIFT VALLEY,9481
NANDI NORTH,Urban,52,10,6,16,Nandi,RIFT VALLEY,9482
NANDI NORTH,Urban,53,2,6,8,Nandi,RIFT VALLEY,9483
NANDI NORTH,Urban,54,6,3,9,Nandi,RIFT VALLEY,9484
NANDI NORTH,Urban,55,13,4,17,Nandi,RIFT VALLEY,9485
NANDI NORTH,Urban,56,8,4,12,Nandi,RIFT VALLEY,9486
NANDI NORTH,Urban,57,4,5,9,Nandi,RIFT VALLEY,9487
NANDI NORTH,Urban,58,1,3,4,Nandi,RIFT VALLEY,9488
NANDI NORTH,Urban,59,3,1,4,Nandi,RIFT VALLEY,9489
NANDI NORTH,Urban,60,3,4,7,Nandi,RIFT VALLEY,9490
NANDI NORTH,Urban,61,1,4,5,Nandi,RIFT VALLEY,9491
NANDI NORTH,Urban,62,1,0,1,Nandi,RIFT VALLEY,9492
NANDI NORTH,Urban,63,2,3,5,Nandi,RIFT VALLEY,9493
NANDI NORTH,Urban,64,1,0,1,Nandi,RIFT VALLEY,9494
NANDI NORTH,Urban,65,1,2,3,Nandi,RIFT VALLEY,9495
NANDI NORTH,Urban,66,2,3,5,Nandi,RIFT VALLEY,9496
NANDI NORTH,Urban,67,2,2,4,Nandi,RIFT VALLEY,9497
NANDI NORTH,Urban,68,0,2,2,Nandi,RIFT VALLEY,9498
NANDI NORTH,Urban,69,2,4,6,Nandi,RIFT VALLEY,9499
NANDI NORTH,Urban,70,3,4,7,Nandi,RIFT VALLEY,9500
NANDI NORTH,Urban,71,0,2,2,Nandi,RIFT VALLEY,9501
NANDI NORTH,Urban,72,2,5,7,Nandi,RIFT VALLEY,9502
NANDI NORTH,Urban,73,1,1,2,Nandi,RIFT VALLEY,9503
NANDI NORTH,Urban,74,0,1,1,Nandi,RIFT VALLEY,9504
NANDI NORTH,Urban,75,2,2,4,Nandi,RIFT VALLEY,9505
NANDI NORTH,Urban,76,0,3,3,Nandi,RIFT VALLEY,9506
NANDI NORTH,Urban,77,2,1,3,Nandi,RIFT VALLEY,9507
NANDI NORTH,Urban,78,2,0,2,Nandi,RIFT VALLEY,9508
NANDI NORTH,Urban,79,2,1,3,Nandi,RIFT VALLEY,9509
NANDI NORTH,Urban,80+,10,27,37,Nandi,RIFT VALLEY,9510
NANDI NORTH,Urban,Age NS,0,4,4,Nandi,RIFT VALLEY,9511
NANDI CENTRAL,Urban,0,1333,1300,2633,Nandi,RIFT VALLEY,9512
NANDI CENTRAL,Urban,1,1249,1191,2440,Nandi,RIFT VALLEY,9513
NANDI CENTRAL,Urban,2,1402,1334,2736,Nandi,RIFT VALLEY,9514
NANDI CENTRAL,Urban,3,1332,1293,2625,Nandi,RIFT VALLEY,9515
NANDI CENTRAL,Urban,4,1318,1294,2612,Nandi,RIFT VALLEY,9516
NANDI CENTRAL,Urban,5,1338,1291,2629,Nandi,RIFT VALLEY,9517
NANDI CENTRAL,Urban,6,1306,1182,2488,Nandi,RIFT VALLEY,9518
NANDI CENTRAL,Urban,7,1156,1181,2337,Nandi,RIFT VALLEY,9519
NANDI CENTRAL,Urban,8,1197,1214,2411,Nandi,RIFT VALLEY,9520
NANDI CENTRAL,Urban,9,1275,1285,2560,Nandi,RIFT VALLEY,9521
NANDI CENTRAL,Urban,10,1221,1218,2439,Nandi,RIFT VALLEY,9522
NANDI CENTRAL,Urban,11,982,971,1953,Nandi,RIFT VALLEY,9523
NANDI CENTRAL,Urban,12,1216,1178,2394,Nandi,RIFT VALLEY,9524
NANDI CENTRAL,Urban,13,1069,1063,2132,Nandi,RIFT VALLEY,9525
NANDI CENTRAL,Urban,14,944,1007,1951,Nandi,RIFT VALLEY,9526
NANDI CENTRAL,Urban,15,932,950,1882,Nandi,RIFT VALLEY,9527
NANDI CENTRAL,Urban,16,883,1116,1999,Nandi,RIFT VALLEY,9528
NANDI CENTRAL,Urban,17,1001,1249,2250,Nandi,RIFT VALLEY,9529
NANDI CENTRAL,Urban,18,929,1066,1995,Nandi,RIFT VALLEY,9530
NANDI CENTRAL,Urban,19,852,960,1812,Nandi,RIFT VALLEY,9531
NANDI CENTRAL,Urban,20,1011,1265,2276,Nandi,RIFT VALLEY,9532
NANDI CENTRAL,Urban,21,783,900,1683,Nandi,RIFT VALLEY,9533
NANDI CENTRAL,Urban,22,932,1146,2078,Nandi,RIFT VALLEY,9534
NANDI CENTRAL,Urban,23,869,1024,1893,Nandi,RIFT VALLEY,9535
NANDI CENTRAL,Urban,24,954,1001,1955,Nandi,RIFT VALLEY,9536
NANDI CENTRAL,Urban,25,1033,1120,2153,Nandi,RIFT VALLEY,9537
NANDI CENTRAL,Urban,26,800,806,1606,Nandi,RIFT VALLEY,9538
NANDI CENTRAL,Urban,27,873,832,1705,Nandi,RIFT VALLEY,9539
NANDI CENTRAL,Urban,28,784,731,1515,Nandi,RIFT VALLEY,9540
NANDI CENTRAL,Urban,29,664,596,1260,Nandi,RIFT VALLEY,9541
NANDI CENTRAL,Urban,30,949,959,1908,Nandi,RIFT VALLEY,9542
NANDI CENTRAL,Urban,31,573,463,1036,Nandi,RIFT VALLEY,9543
NANDI CENTRAL,Urban,32,676,628,1304,Nandi,RIFT VALLEY,9544
NANDI CENTRAL,Urban,33,454,466,920,Nandi,RIFT VALLEY,9545
NANDI CENTRAL,Urban,34,528,460,988,Nandi,RIFT VALLEY,9546
NANDI CENTRAL,Urban,35,758,690,1448,Nandi,RIFT VALLEY,9547
NANDI CENTRAL,Urban,36,424,450,874,Nandi,RIFT VALLEY,9548
NANDI CENTRAL,Urban,37,418,429,847,Nandi,RIFT VALLEY,9549
NANDI CENTRAL,Urban,38,398,419,817,Nandi,RIFT VALLEY,9550
NANDI CENTRAL,Urban,39,432,343,775,Nandi,RIFT VALLEY,9551
NANDI CENTRAL,Urban,40,597,593,1190,Nandi,RIFT VALLEY,9552
NANDI CENTRAL,Urban,41,318,273,591,Nandi,RIFT VALLEY,9553
NANDI CENTRAL,Urban,42,362,294,656,Nandi,RIFT VALLEY,9554
NANDI CENTRAL,Urban,43,262,234,496,Nandi,RIFT VALLEY,9555
NANDI CENTRAL,Urban,44,254,234,488,Nandi,RIFT VALLEY,9556
NANDI CENTRAL,Urban,45,430,388,818,Nandi,RIFT VALLEY,9557
NANDI CENTRAL,Urban,46,266,264,530,Nandi,RIFT VALLEY,9558
NANDI CENTRAL,Urban,47,262,241,503,Nandi,RIFT VALLEY,9559
NANDI CENTRAL,Urban,48,262,276,538,Nandi,RIFT VALLEY,9560
NANDI CENTRAL,Urban,49,236,231,467,Nandi,RIFT VALLEY,9561
NANDI CENTRAL,Urban,50,353,328,681,Nandi,RIFT VALLEY,9562
NANDI CENTRAL,Urban,51,206,145,351,Nandi,RIFT VALLEY,9563
NANDI CENTRAL,Urban,52,215,163,378,Nandi,RIFT VALLEY,9564
NANDI CENTRAL,Urban,53,175,132,307,Nandi,RIFT VALLEY,9565
NANDI CENTRAL,Urban,54,140,132,272,Nandi,RIFT VALLEY,9566
NANDI CENTRAL,Urban,55,201,211,412,Nandi,RIFT VALLEY,9567
NANDI CENTRAL,Urban,56,135,110,245,Nandi,RIFT VALLEY,9568
NANDI CENTRAL,Urban,57,197,159,356,Nandi,RIFT VALLEY,9569
NANDI CENTRAL,Urban,58,75,66,141,Nandi,RIFT VALLEY,9570
NANDI CENTRAL,Urban,59,111,111,222,Nandi,RIFT VALLEY,9571
NANDI CENTRAL,Urban,60,194,182,376,Nandi,RIFT VALLEY,9572
NANDI CENTRAL,Urban,61,97,98,195,Nandi,RIFT VALLEY,9573
NANDI CENTRAL,Urban,62,73,61,134,Nandi,RIFT VALLEY,9574
NANDI CENTRAL,Urban,63,85,60,145,Nandi,RIFT VALLEY,9575
NANDI CENTRAL,Urban,64,73,82,155,Nandi,RIFT VALLEY,9576
NANDI CENTRAL,Urban,65,112,128,240,Nandi,RIFT VALLEY,9577
NANDI CENTRAL,Urban,66,67,91,158,Nandi,RIFT VALLEY,9578
NANDI CENTRAL,Urban,67,88,68,156,Nandi,RIFT VALLEY,9579
NANDI CENTRAL,Urban,68,40,51,91,Nandi,RIFT VALLEY,9580
NANDI CENTRAL,Urban,69,55,89,144,Nandi,RIFT VALLEY,9581
NANDI CENTRAL,Urban,70,117,143,260,Nandi,RIFT VALLEY,9582
NANDI CENTRAL,Urban,71,43,33,76,Nandi,RIFT VALLEY,9583
NANDI CENTRAL,Urban,72,61,37,98,Nandi,RIFT VALLEY,9584
NANDI CENTRAL,Urban,73,46,28,74,Nandi,RIFT VALLEY,9585
NANDI CENTRAL,Urban,74,30,49,79,Nandi,RIFT VALLEY,9586
NANDI CENTRAL,Urban,75,66,57,123,Nandi,RIFT VALLEY,9587
NANDI CENTRAL,Urban,76,30,25,55,Nandi,RIFT VALLEY,9588
NANDI CENTRAL,Urban,77,25,35,60,Nandi,RIFT VALLEY,9589
NANDI CENTRAL,Urban,78,30,31,61,Nandi,RIFT VALLEY,9590
NANDI CENTRAL,Urban,79,36,50,86,Nandi,RIFT VALLEY,9591
NANDI CENTRAL,Urban,80+,357,520,877,Nandi,RIFT VALLEY,9592
NANDI CENTRAL,Urban,Age NS,19,12,31,Nandi,RIFT VALLEY,9593
NANDI EAST,Urban,0,187,187,374,Nandi,RIFT VALLEY,9594
NANDI EAST,Urban,1,131,146,277,Nandi,RIFT VALLEY,9595
NANDI EAST,Urban,2,157,135,292,Nandi,RIFT VALLEY,9596
NANDI EAST,Urban,3,144,159,303,Nandi,RIFT VALLEY,9597
NANDI EAST,Urban,4,140,136,276,Nandi,RIFT VALLEY,9598
NANDI EAST,Urban,5,122,138,260,Nandi,RIFT VALLEY,9599
NANDI EAST,Urban,6,130,118,248,Nandi,RIFT VALLEY,9600
NANDI EAST,Urban,7,108,111,219,Nandi,RIFT VALLEY,9601
NANDI EAST,Urban,8,101,125,226,Nandi,RIFT VALLEY,9602
NANDI EAST,Urban,9,106,124,230,Nandi,RIFT VALLEY,9603
NANDI EAST,Urban,10,132,125,257,Nandi,RIFT VALLEY,9604
NANDI EAST,Urban,11,95,88,183,Nandi,RIFT VALLEY,9605
NANDI EAST,Urban,12,144,132,276,Nandi,RIFT VALLEY,9606
NANDI EAST,Urban,13,120,134,254,Nandi,RIFT VALLEY,9607
NANDI EAST,Urban,14,100,107,207,Nandi,RIFT VALLEY,9608
NANDI EAST,Urban,15,98,98,196,Nandi,RIFT VALLEY,9609
NANDI EAST,Urban,16,71,95,166,Nandi,RIFT VALLEY,9610
NANDI EAST,Urban,17,73,132,205,Nandi,RIFT VALLEY,9611
NANDI EAST,Urban,18,72,135,207,Nandi,RIFT VALLEY,9612
NANDI EAST,Urban,19,87,129,216,Nandi,RIFT VALLEY,9613
NANDI EAST,Urban,20,103,196,299,Nandi,RIFT VALLEY,9614
NANDI EAST,Urban,21,89,122,211,Nandi,RIFT VALLEY,9615
NANDI EAST,Urban,22,94,149,243,Nandi,RIFT VALLEY,9616
NANDI EAST,Urban,23,115,111,226,Nandi,RIFT VALLEY,9617
NANDI EAST,Urban,24,114,156,270,Nandi,RIFT VALLEY,9618
NANDI EAST,Urban,25,157,143,300,Nandi,RIFT VALLEY,9619
NANDI EAST,Urban,26,118,114,232,Nandi,RIFT VALLEY,9620
NANDI EAST,Urban,27,131,107,238,Nandi,RIFT VALLEY,9621
NANDI EAST,Urban,28,131,105,236,Nandi,RIFT VALLEY,9622
NANDI EAST,Urban,29,87,70,157,Nandi,RIFT VALLEY,9623
NANDI EAST,Urban,30,184,108,292,Nandi,RIFT VALLEY,9624
NANDI EAST,Urban,31,65,36,101,Nandi,RIFT VALLEY,9625
NANDI EAST,Urban,32,100,86,186,Nandi,RIFT VALLEY,9626
NANDI EAST,Urban,33,59,47,106,Nandi,RIFT VALLEY,9627
NANDI EAST,Urban,34,67,53,120,Nandi,RIFT VALLEY,9628
NANDI EAST,Urban,35,102,77,179,Nandi,RIFT VALLEY,9629
NANDI EAST,Urban,36,73,50,123,Nandi,RIFT VALLEY,9630
NANDI EAST,Urban,37,54,35,89,Nandi,RIFT VALLEY,9631
NANDI EAST,Urban,38,65,46,111,Nandi,RIFT VALLEY,9632
NANDI EAST,Urban,39,48,47,95,Nandi,RIFT VALLEY,9633
NANDI EAST,Urban,40,77,49,126,Nandi,RIFT VALLEY,9634
NANDI EAST,Urban,41,37,28,65,Nandi,RIFT VALLEY,9635
NANDI EAST,Urban,42,43,29,72,Nandi,RIFT VALLEY,9636
NANDI EAST,Urban,43,32,26,58,Nandi,RIFT VALLEY,9637
NANDI EAST,Urban,44,32,16,48,Nandi,RIFT VALLEY,9638
NANDI EAST,Urban,45,55,47,102,Nandi,RIFT VALLEY,9639
NANDI EAST,Urban,46,30,23,53,Nandi,RIFT VALLEY,9640
NANDI EAST,Urban,47,36,16,52,Nandi,RIFT VALLEY,9641
NANDI EAST,Urban,48,41,15,56,Nandi,RIFT VALLEY,9642
NANDI EAST,Urban,49,31,14,45,Nandi,RIFT VALLEY,9643
NANDI EAST,Urban,50,37,38,75,Nandi,RIFT VALLEY,9644
NANDI EAST,Urban,51,29,15,44,Nandi,RIFT VALLEY,9645
NANDI EAST,Urban,52,20,19,39,Nandi,RIFT VALLEY,9646
NANDI EAST,Urban,53,16,8,24,Nandi,RIFT VALLEY,9647
NANDI EAST,Urban,54,9,6,15,Nandi,RIFT VALLEY,9648
NANDI EAST,Urban,55,30,12,42,Nandi,RIFT VALLEY,9649
NANDI EAST,Urban,56,9,6,15,Nandi,RIFT VALLEY,9650
NANDI EAST,Urban,57,14,2,16,Nandi,RIFT VALLEY,9651
NANDI EAST,Urban,58,10,5,15,Nandi,RIFT VALLEY,9652
NANDI EAST,Urban,59,7,5,12,Nandi,RIFT VALLEY,9653
NANDI EAST,Urban,60,6,10,16,Nandi,RIFT VALLEY,9654
NANDI EAST,Urban,61,9,2,11,Nandi,RIFT VALLEY,9655
NANDI EAST,Urban,62,6,4,10,Nandi,RIFT VALLEY,9656
NANDI EAST,Urban,63,3,4,7,Nandi,RIFT VALLEY,9657
NANDI EAST,Urban,64,4,3,7,Nandi,RIFT VALLEY,9658
NANDI EAST,Urban,65,8,5,13,Nandi,RIFT VALLEY,9659
NANDI EAST,Urban,66,3,3,6,Nandi,RIFT VALLEY,9660
NANDI EAST,Urban,67,2,4,6,Nandi,RIFT VALLEY,9661
NANDI EAST,Urban,68,3,3,6,Nandi,RIFT VALLEY,9662
NANDI EAST,Urban,69,1,0,1,Nandi,RIFT VALLEY,9663
NANDI EAST,Urban,70,4,2,6,Nandi,RIFT VALLEY,9664
NANDI EAST,Urban,71,2,4,6,Nandi,RIFT VALLEY,9665
NANDI EAST,Urban,72,2,2,4,Nandi,RIFT VALLEY,9666
NANDI EAST,Urban,73,0,3,3,Nandi,RIFT VALLEY,9667
NANDI EAST,Urban,74,2,1,3,Nandi,RIFT VALLEY,9668
NANDI EAST,Urban,75,5,2,7,Nandi,RIFT VALLEY,9669
NANDI EAST,Urban,76,0,2,2,Nandi,RIFT VALLEY,9670
NANDI EAST,Urban,77,1,0,1,Nandi,RIFT VALLEY,9671
NANDI EAST,Urban,78,2,2,4,Nandi,RIFT VALLEY,9672
NANDI EAST,Urban,79,0,0,0,Nandi,RIFT VALLEY,9673
NANDI EAST,Urban,80+,11,21,32,Nandi,RIFT VALLEY,9674
NANDI EAST,Urban,Age NS,9,1,10,Nandi,RIFT VALLEY,9675
NANDI SOUTH,Urban,0,0,0,0,Nandi,RIFT VALLEY,9676
NANDI SOUTH,Urban,1,0,0,0,Nandi,RIFT VALLEY,9677
NANDI SOUTH,Urban,2,0,0,0,Nandi,RIFT VALLEY,9678
NANDI SOUTH,Urban,3,0,0,0,Nandi,RIFT VALLEY,9679
NANDI SOUTH,Urban,4,0,0,0,Nandi,RIFT VALLEY,9680
NANDI SOUTH,Urban,5,0,0,0,Nandi,RIFT VALLEY,9681
NANDI SOUTH,Urban,6,0,0,0,Nandi,RIFT VALLEY,9682
NANDI SOUTH,Urban,7,0,0,0,Nandi,RIFT VALLEY,9683
NANDI SOUTH,Urban,8,0,0,0,Nandi,RIFT VALLEY,9684
NANDI SOUTH,Urban,9,0,0,0,Nandi,RIFT VALLEY,9685
NANDI SOUTH,Urban,10,0,0,0,Nandi,RIFT VALLEY,9686
NANDI SOUTH,Urban,11,0,0,0,Nandi,RIFT VALLEY,9687
NANDI SOUTH,Urban,12,0,0,0,Nandi,RIFT VALLEY,9688
NANDI SOUTH,Urban,13,0,0,0,Nandi,RIFT VALLEY,9689
NANDI SOUTH,Urban,14,0,0,0,Nandi,RIFT VALLEY,9690
NANDI SOUTH,Urban,15,0,0,0,Nandi,RIFT VALLEY,9691
NANDI SOUTH,Urban,16,0,0,0,Nandi,RIFT VALLEY,9692
NANDI SOUTH,Urban,17,0,0,0,Nandi,RIFT VALLEY,9693
NANDI SOUTH,Urban,18,0,0,0,Nandi,RIFT VALLEY,9694
NANDI SOUTH,Urban,19,0,0,0,Nandi,RIFT VALLEY,9695
NANDI SOUTH,Urban,20,0,0,0,Nandi,RIFT VALLEY,9696
NANDI SOUTH,Urban,21,0,0,0,Nandi,RIFT VALLEY,9697
NANDI SOUTH,Urban,22,0,0,0,Nandi,RIFT VALLEY,9698
NANDI SOUTH,Urban,23,0,0,0,Nandi,RIFT VALLEY,9699
NANDI SOUTH,Urban,24,0,0,0,Nandi,RIFT VALLEY,9700
NANDI SOUTH,Urban,25,0,0,0,Nandi,RIFT VALLEY,9701
NANDI SOUTH,Urban,26,0,0,0,Nandi,RIFT VALLEY,9702
NANDI SOUTH,Urban,27,0,0,0,Nandi,RIFT VALLEY,9703
NANDI SOUTH,Urban,28,0,0,0,Nandi,RIFT VALLEY,9704
NANDI SOUTH,Urban,29,0,0,0,Nandi,RIFT VALLEY,9705
NANDI SOUTH,Urban,30,0,0,0,Nandi,RIFT VALLEY,9706
NANDI SOUTH,Urban,31,0,0,0,Nandi,RIFT VALLEY,9707
NANDI SOUTH,Urban,32,0,0,0,Nandi,RIFT VALLEY,9708
NANDI SOUTH,Urban,33,0,0,0,Nandi,RIFT VALLEY,9709
NANDI SOUTH,Urban,34,0,0,0,Nandi,RIFT VALLEY,9710
NANDI SOUTH,Urban,35,0,0,0,Nandi,RIFT VALLEY,9711
NANDI SOUTH,Urban,36,0,0,0,Nandi,RIFT VALLEY,9712
NANDI SOUTH,Urban,37,0,0,0,Nandi,RIFT VALLEY,9713
NANDI SOUTH,Urban,38,0,0,0,Nandi,RIFT VALLEY,9714
NANDI SOUTH,Urban,39,0,0,0,Nandi,RIFT VALLEY,9715
NANDI SOUTH,Urban,40,0,0,0,Nandi,RIFT VALLEY,9716
NANDI SOUTH,Urban,41,0,0,0,Nandi,RIFT VALLEY,9717
NANDI SOUTH,Urban,42,0,0,0,Nandi,RIFT VALLEY,9718
NANDI SOUTH,Urban,43,0,0,0,Nandi,RIFT VALLEY,9719
NANDI SOUTH,Urban,44,0,0,0,Nandi,RIFT VALLEY,9720
NANDI SOUTH,Urban,45,0,0,0,Nandi,RIFT VALLEY,9721
NANDI SOUTH,Urban,46,0,0,0,Nandi,RIFT VALLEY,9722
NANDI SOUTH,Urban,47,0,0,0,Nandi,RIFT VALLEY,9723
NANDI SOUTH,Urban,48,0,0,0,Nandi,RIFT VALLEY,9724
NANDI SOUTH,Urban,49,0,0,0,Nandi,RIFT VALLEY,9725
NANDI SOUTH,Urban,50,0,0,0,Nandi,RIFT VALLEY,9726
NANDI SOUTH,Urban,51,0,0,0,Nandi,RIFT VALLEY,9727
NANDI SOUTH,Urban,52,0,0,0,Nandi,RIFT VALLEY,9728
NANDI SOUTH,Urban,53,0,0,0,Nandi,RIFT VALLEY,9729
NANDI SOUTH,Urban,54,0,0,0,Nandi,RIFT VALLEY,9730
NANDI SOUTH,Urban,55,0,0,0,Nandi,RIFT VALLEY,9731
NANDI SOUTH,Urban,56,0,0,0,Nandi,RIFT VALLEY,9732
NANDI SOUTH,Urban,57,0,0,0,Nandi,RIFT VALLEY,9733
NANDI SOUTH,Urban,58,0,0,0,Nandi,RIFT VALLEY,9734
NANDI SOUTH,Urban,59,0,0,0,Nandi,RIFT VALLEY,9735
NANDI SOUTH,Urban,60,0,0,0,Nandi,RIFT VALLEY,9736
NANDI SOUTH,Urban,61,0,0,0,Nandi,RIFT VALLEY,9737
NANDI SOUTH,Urban,62,0,0,0,Nandi,RIFT VALLEY,9738
NANDI SOUTH,Urban,63,0,0,0,Nandi,RIFT VALLEY,9739
NANDI SOUTH,Urban,64,0,0,0,Nandi,RIFT VALLEY,9740
NANDI SOUTH,Urban,65,0,0,0,Nandi,RIFT VALLEY,9741
NANDI SOUTH,Urban,66,0,0,0,Nandi,RIFT VALLEY,9742
NANDI SOUTH,Urban,67,0,0,0,Nandi,RIFT VALLEY,9743
NANDI SOUTH,Urban,68,0,0,0,Nandi,RIFT VALLEY,9744
NANDI SOUTH,Urban,69,0,0,0,Nandi,RIFT VALLEY,9745
NANDI SOUTH,Urban,70,0,0,0,Nandi,RIFT VALLEY,9746
NANDI SOUTH,Urban,71,0,0,0,Nandi,RIFT VALLEY,9747
NANDI SOUTH,Urban,72,0,0,0,Nandi,RIFT VALLEY,9748
NANDI SOUTH,Urban,73,0,0,0,Nandi,RIFT VALLEY,9749
NANDI SOUTH,Urban,74,0,0,0,Nandi,RIFT VALLEY,9750
NANDI SOUTH,Urban,75,0,0,0,Nandi,RIFT VALLEY,9751
NANDI SOUTH,Urban,76,0,0,0,Nandi,RIFT VALLEY,9752
NANDI SOUTH,Urban,77,0,0,0,Nandi,RIFT VALLEY,9753
NANDI SOUTH,Urban,78,0,0,0,Nandi,RIFT VALLEY,9754
NANDI SOUTH,Urban,79,0,0,0,Nandi,RIFT VALLEY,9755
NANDI SOUTH,Urban,80+,0,0,0,Nandi,RIFT VALLEY,9756
NANDI SOUTH,Urban,Age NS,0,0,0,Nandi,RIFT VALLEY,9757
TINDERET,Urban,0,0,0,0,Nandi,RIFT VALLEY,9758
TINDERET,Urban,1,0,0,0,Nandi,RIFT VALLEY,9759
TINDERET,Urban,2,0,0,0,Nandi,RIFT VALLEY,9760
TINDERET,Urban,3,0,0,0,Nandi,RIFT VALLEY,9761
TINDERET,Urban,4,0,0,0,Nandi,RIFT VALLEY,9762
TINDERET,Urban,5,0,0,0,Nandi,RIFT VALLEY,9763
TINDERET,Urban,6,0,0,0,Nandi,RIFT VALLEY,9764
TINDERET,Urban,7,0,0,0,Nandi,RIFT VALLEY,9765
TINDERET,Urban,8,0,0,0,Nandi,RIFT VALLEY,9766
TINDERET,Urban,9,0,0,0,Nandi,RIFT VALLEY,9767
TINDERET,Urban,10,0,0,0,Nandi,RIFT VALLEY,9768
TINDERET,Urban,11,0,0,0,Nandi,RIFT VALLEY,9769
TINDERET,Urban,12,0,0,0,Nandi,RIFT VALLEY,9770
TINDERET,Urban,13,0,0,0,Nandi,RIFT VALLEY,9771
TINDERET,Urban,14,0,0,0,Nandi,RIFT VALLEY,9772
TINDERET,Urban,15,0,0,0,Nandi,RIFT VALLEY,9773
TINDERET,Urban,16,0,0,0,Nandi,RIFT VALLEY,9774
TINDERET,Urban,17,0,0,0,Nandi,RIFT VALLEY,9775
TINDERET,Urban,18,0,0,0,Nandi,RIFT VALLEY,9776
TINDERET,Urban,19,0,0,0,Nandi,RIFT VALLEY,9777
TINDERET,Urban,20,0,0,0,Nandi,RIFT VALLEY,9778
TINDERET,Urban,21,0,0,0,Nandi,RIFT VALLEY,9779
TINDERET,Urban,22,0,0,0,Nandi,RIFT VALLEY,9780
TINDERET,Urban,23,0,0,0,Nandi,RIFT VALLEY,9781
TINDERET,Urban,24,0,0,0,Nandi,RIFT VALLEY,9782
TINDERET,Urban,25,0,0,0,Nandi,RIFT VALLEY,9783
TINDERET,Urban,26,0,0,0,Nandi,RIFT VALLEY,9784
TINDERET,Urban,27,0,0,0,Nandi,RIFT VALLEY,9785
TINDERET,Urban,28,0,0,0,Nandi,RIFT VALLEY,9786
TINDERET,Urban,29,0,0,0,Nandi,RIFT VALLEY,9787
TINDERET,Urban,30,0,0,0,Nandi,RIFT VALLEY,9788
TINDERET,Urban,31,0,0,0,Nandi,RIFT VALLEY,9789
TINDERET,Urban,32,0,0,0,Nandi,RIFT VALLEY,9790
TINDERET,Urban,33,0,0,0,Nandi,RIFT VALLEY,9791
TINDERET,Urban,34,0,0,0,Nandi,RIFT VALLEY,9792
TINDERET,Urban,35,0,0,0,Nandi,RIFT VALLEY,9793
TINDERET,Urban,36,0,0,0,Nandi,RIFT VALLEY,9794
TINDERET,Urban,37,0,0,0,Nandi,RIFT VALLEY,9795
TINDERET,Urban,38,0,0,0,Nandi,RIFT VALLEY,9796
TINDERET,Urban,39,0,0,0,Nandi,RIFT VALLEY,9797
TINDERET,Urban,40,0,0,0,Nandi,RIFT VALLEY,9798
TINDERET,Urban,41,0,0,0,Nandi,RIFT VALLEY,9799
TINDERET,Urban,42,0,0,0,Nandi,RIFT VALLEY,9800
TINDERET,Urban,43,0,0,0,Nandi,RIFT VALLEY,9801
TINDERET,Urban,44,0,0,0,Nandi,RIFT VALLEY,9802
TINDERET,Urban,45,0,0,0,Nandi,RIFT VALLEY,9803
TINDERET,Urban,46,0,0,0,Nandi,RIFT VALLEY,9804
TINDERET,Urban,47,0,0,0,Nandi,RIFT VALLEY,9805
TINDERET,Urban,48,0,0,0,Nandi,RIFT VALLEY,9806
TINDERET,Urban,49,0,0,0,Nandi,RIFT VALLEY,9807
TINDERET,Urban,50,0,0,0,Nandi,RIFT VALLEY,9808
TINDERET,Urban,51,0,0,0,Nandi,RIFT VALLEY,9809
TINDERET,Urban,52,0,0,0,Nandi,RIFT VALLEY,9810
TINDERET,Urban,53,0,0,0,Nandi,RIFT VALLEY,9811
TINDERET,Urban,54,0,0,0,Nandi,RIFT VALLEY,9812
TINDERET,Urban,55,0,0,0,Nandi,RIFT VALLEY,9813
TINDERET,Urban,56,0,0,0,Nandi,RIFT VALLEY,9814
TINDERET,Urban,57,0,0,0,Nandi,RIFT VALLEY,9815
TINDERET,Urban,58,0,0,0,Nandi,RIFT VALLEY,9816
TINDERET,Urban,59,0,0,0,Nandi,RIFT VALLEY,9817
TINDERET,Urban,60,0,0,0,Nandi,RIFT VALLEY,9818
TINDERET,Urban,61,0,0,0,Nandi,RIFT VALLEY,9819
TINDERET,Urban,62,0,0,0,Nandi,RIFT VALLEY,9820
TINDERET,Urban,63,0,0,0,Nandi,RIFT VALLEY,9821
TINDERET,Urban,64,0,0,0,Nandi,RIFT VALLEY,9822
TINDERET,Urban,65,0,0,0,Nandi,RIFT VALLEY,9823
TINDERET,Urban,66,0,0,0,Nandi,RIFT VALLEY,9824
TINDERET,Urban,67,0,0,0,Nandi,RIFT VALLEY,9825
TINDERET,Urban,68,0,0,0,Nandi,RIFT VALLEY,9826
TINDERET,Urban,69,0,0,0,Nandi,RIFT VALLEY,9827
TINDERET,Urban,70,0,0,0,Nandi,RIFT VALLEY,9828
TINDERET,Urban,71,0,0,0,Nandi,RIFT VALLEY,9829
TINDERET,Urban,72,0,0,0,Nandi,RIFT VALLEY,9830
TINDERET,Urban,73,0,0,0,Nandi,RIFT VALLEY,9831
TINDERET,Urban,74,0,0,0,Nandi,RIFT VALLEY,9832
TINDERET,Urban,75,0,0,0,Nandi,RIFT VALLEY,9833
TINDERET,Urban,76,0,0,0,Nandi,RIFT VALLEY,9834
TINDERET,Urban,77,0,0,0,Nandi,RIFT VALLEY,9835
TINDERET,Urban,78,0,0,0,Nandi,RIFT VALLEY,9836
TINDERET,Urban,79,0,0,0,Nandi,RIFT VALLEY,9837
TINDERET,Urban,80+,0,0,0,Nandi,RIFT VALLEY,9838
TINDERET,Urban,Age NS,0,0,0,Nandi,RIFT VALLEY,9839
LAIKIPIA NORTH,Urban,0,24,21,45,Laikipia,RIFT VALLEY,9840
LAIKIPIA NORTH,Urban,1,17,12,29,Laikipia,RIFT VALLEY,9841
LAIKIPIA NORTH,Urban,2,16,21,37,Laikipia,RIFT VALLEY,9842
LAIKIPIA NORTH,Urban,3,26,23,49,Laikipia,RIFT VALLEY,9843
LAIKIPIA NORTH,Urban,4,11,19,30,Laikipia,RIFT VALLEY,9844
LAIKIPIA NORTH,Urban,5,21,28,49,Laikipia,RIFT VALLEY,9845
LAIKIPIA NORTH,Urban,6,18,12,30,Laikipia,RIFT VALLEY,9846
LAIKIPIA NORTH,Urban,7,25,18,43,Laikipia,RIFT VALLEY,9847
LAIKIPIA NORTH,Urban,8,27,18,45,Laikipia,RIFT VALLEY,9848
LAIKIPIA NORTH,Urban,9,14,25,39,Laikipia,RIFT VALLEY,9849
LAIKIPIA NORTH,Urban,10,24,23,47,Laikipia,RIFT VALLEY,9850
LAIKIPIA NORTH,Urban,11,11,15,26,Laikipia,RIFT VALLEY,9851
LAIKIPIA NORTH,Urban,12,12,21,33,Laikipia,RIFT VALLEY,9852
LAIKIPIA NORTH,Urban,13,16,14,30,Laikipia,RIFT VALLEY,9853
LAIKIPIA NORTH,Urban,14,23,10,33,Laikipia,RIFT VALLEY,9854
LAIKIPIA NORTH,Urban,15,16,13,29,Laikipia,RIFT VALLEY,9855
LAIKIPIA NORTH,Urban,16,12,18,30,Laikipia,RIFT VALLEY,9856
LAIKIPIA NORTH,Urban,17,11,18,29,Laikipia,RIFT VALLEY,9857
LAIKIPIA NORTH,Urban,18,11,19,30,Laikipia,RIFT VALLEY,9858
LAIKIPIA NORTH,Urban,19,15,13,28,Laikipia,RIFT VALLEY,9859
LAIKIPIA NORTH,Urban,20,17,14,31,Laikipia,RIFT VALLEY,9860
LAIKIPIA NORTH,Urban,21,18,16,34,Laikipia,RIFT VALLEY,9861
LAIKIPIA NORTH,Urban,22,21,22,43,Laikipia,RIFT VALLEY,9862
LAIKIPIA NORTH,Urban,23,25,16,41,Laikipia,RIFT VALLEY,9863
LAIKIPIA NORTH,Urban,24,20,11,31,Laikipia,RIFT VALLEY,9864
LAIKIPIA NORTH,Urban,25,20,17,37,Laikipia,RIFT VALLEY,9865
LAIKIPIA NORTH,Urban,26,21,10,31,Laikipia,RIFT VALLEY,9866
LAIKIPIA NORTH,Urban,27,18,12,30,Laikipia,RIFT VALLEY,9867
LAIKIPIA NORTH,Urban,28,12,9,21,Laikipia,RIFT VALLEY,9868
LAIKIPIA NORTH,Urban,29,15,11,26,Laikipia,RIFT VALLEY,9869
LAIKIPIA NORTH,Urban,30,22,9,31,Laikipia,RIFT VALLEY,9870
LAIKIPIA NORTH,Urban,31,7,10,17,Laikipia,RIFT VALLEY,9871
LAIKIPIA NORTH,Urban,32,11,11,22,Laikipia,RIFT VALLEY,9872
LAIKIPIA NORTH,Urban,33,9,8,17,Laikipia,RIFT VALLEY,9873
LAIKIPIA NORTH,Urban,34,7,5,12,Laikipia,RIFT VALLEY,9874
LAIKIPIA NORTH,Urban,35,22,10,32,Laikipia,RIFT VALLEY,9875
LAIKIPIA NORTH,Urban,36,5,9,14,Laikipia,RIFT VALLEY,9876
LAIKIPIA NORTH,Urban,37,8,11,19,Laikipia,RIFT VALLEY,9877
LAIKIPIA NORTH,Urban,38,6,2,8,Laikipia,RIFT VALLEY,9878
LAIKIPIA NORTH,Urban,39,8,4,12,Laikipia,RIFT VALLEY,9879
LAIKIPIA NORTH,Urban,40,10,5,15,Laikipia,RIFT VALLEY,9880
LAIKIPIA NORTH,Urban,41,7,7,14,Laikipia,RIFT VALLEY,9881
LAIKIPIA NORTH,Urban,42,7,4,11,Laikipia,RIFT VALLEY,9882
LAIKIPIA NORTH,Urban,43,3,2,5,Laikipia,RIFT VALLEY,9883
LAIKIPIA NORTH,Urban,44,5,2,7,Laikipia,RIFT VALLEY,9884
LAIKIPIA NORTH,Urban,45,11,4,15,Laikipia,RIFT VALLEY,9885
LAIKIPIA NORTH,Urban,46,4,1,5,Laikipia,RIFT VALLEY,9886
LAIKIPIA NORTH,Urban,47,8,4,12,Laikipia,RIFT VALLEY,9887
LAIKIPIA NORTH,Urban,48,6,4,10,Laikipia,RIFT VALLEY,9888
LAIKIPIA NORTH,Urban,49,6,5,11,Laikipia,RIFT VALLEY,9889
LAIKIPIA NORTH,Urban,50,4,7,11,Laikipia,RIFT VALLEY,9890
LAIKIPIA NORTH,Urban,51,5,0,5,Laikipia,RIFT VALLEY,9891
LAIKIPIA NORTH,Urban,52,7,4,11,Laikipia,RIFT VALLEY,9892
LAIKIPIA NORTH,Urban,53,6,1,7,Laikipia,RIFT VALLEY,9893
LAIKIPIA NORTH,Urban,54,1,1,2,Laikipia,RIFT VALLEY,9894
LAIKIPIA NORTH,Urban,55,1,2,3,Laikipia,RIFT VALLEY,9895
LAIKIPIA NORTH,Urban,56,6,1,7,Laikipia,RIFT VALLEY,9896
LAIKIPIA NORTH,Urban,57,3,2,5,Laikipia,RIFT VALLEY,9897
LAIKIPIA NORTH,Urban,58,0,1,1,Laikipia,RIFT VALLEY,9898
LAIKIPIA NORTH,Urban,59,3,4,7,Laikipia,RIFT VALLEY,9899
LAIKIPIA NORTH,Urban,60,5,2,7,Laikipia,RIFT VALLEY,9900
LAIKIPIA NORTH,Urban,61,3,2,5,Laikipia,RIFT VALLEY,9901
LAIKIPIA NORTH,Urban,62,1,0,1,Laikipia,RIFT VALLEY,9902
LAIKIPIA NORTH,Urban,63,2,1,3,Laikipia,RIFT VALLEY,9903
LAIKIPIA NORTH,Urban,64,2,0,2,Laikipia,RIFT VALLEY,9904
LAIKIPIA NORTH,Urban,65,2,0,2,Laikipia,RIFT VALLEY,9905
LAIKIPIA NORTH,Urban,66,0,1,1,Laikipia,RIFT VALLEY,9906
LAIKIPIA NORTH,Urban,67,2,1,3,Laikipia,RIFT VALLEY,9907
LAIKIPIA NORTH,Urban,68,0,1,1,Laikipia,RIFT VALLEY,9908
LAIKIPIA NORTH,Urban,69,0,1,1,Laikipia,RIFT VALLEY,9909
LAIKIPIA NORTH,Urban,70,0,2,2,Laikipia,RIFT VALLEY,9910
LAIKIPIA NORTH,Urban,71,1,0,1,Laikipia,RIFT VALLEY,9911
LAIKIPIA NORTH,Urban,72,0,0,0,Laikipia,RIFT VALLEY,9912
LAIKIPIA NORTH,Urban,73,0,0,0,Laikipia,RIFT VALLEY,9913
LAIKIPIA NORTH,Urban,74,2,0,2,Laikipia,RIFT VALLEY,9914
LAIKIPIA NORTH,Urban,75,0,1,1,Laikipia,RIFT VALLEY,9915
LAIKIPIA NORTH,Urban,76,0,0,0,Laikipia,RIFT VALLEY,9916
LAIKIPIA NORTH,Urban,77,0,0,0,Laikipia,RIFT VALLEY,9917
LAIKIPIA NORTH,Urban,78,0,0,0,Laikipia,RIFT VALLEY,9918
LAIKIPIA NORTH,Urban,79,0,0,0,Laikipia,RIFT VALLEY,9919
LAIKIPIA NORTH,Urban,80+,5,2,7,Laikipia,RIFT VALLEY,9920
LAIKIPIA NORTH,Urban,Age NS,0,0,0,Laikipia,RIFT VALLEY,9921
LAIKIPIA EAST,Urban,0,663,664,1327,Laikipia,RIFT VALLEY,9922
LAIKIPIA EAST,Urban,1,524,497,1021,Laikipia,RIFT VALLEY,9923
LAIKIPIA EAST,Urban,2,541,587,1128,Laikipia,RIFT VALLEY,9924
LAIKIPIA EAST,Urban,3,610,561,1171,Laikipia,RIFT VALLEY,9925
LAIKIPIA EAST,Urban,4,566,540,1106,Laikipia,RIFT VALLEY,9926
LAIKIPIA EAST,Urban,5,546,580,1126,Laikipia,RIFT VALLEY,9927
LAIKIPIA EAST,Urban,6,511,482,993,Laikipia,RIFT VALLEY,9928
LAIKIPIA EAST,Urban,7,536,483,1019,Laikipia,RIFT VALLEY,9929
LAIKIPIA EAST,Urban,8,446,487,933,Laikipia,RIFT VALLEY,9930
LAIKIPIA EAST,Urban,9,525,561,1086,Laikipia,RIFT VALLEY,9931
LAIKIPIA EAST,Urban,10,509,546,1055,Laikipia,RIFT VALLEY,9932
LAIKIPIA EAST,Urban,11,446,446,892,Laikipia,RIFT VALLEY,9933
LAIKIPIA EAST,Urban,12,549,449,998,Laikipia,RIFT VALLEY,9934
LAIKIPIA EAST,Urban,13,467,523,990,Laikipia,RIFT VALLEY,9935
LAIKIPIA EAST,Urban,14,403,468,871,Laikipia,RIFT VALLEY,9936
LAIKIPIA EAST,Urban,15,395,468,863,Laikipia,RIFT VALLEY,9937
LAIKIPIA EAST,Urban,16,380,476,856,Laikipia,RIFT VALLEY,9938
LAIKIPIA EAST,Urban,17,438,434,872,Laikipia,RIFT VALLEY,9939
LAIKIPIA EAST,Urban,18,409,490,899,Laikipia,RIFT VALLEY,9940
LAIKIPIA EAST,Urban,19,369,451,820,Laikipia,RIFT VALLEY,9941
LAIKIPIA EAST,Urban,20,448,662,1110,Laikipia,RIFT VALLEY,9942
LAIKIPIA EAST,Urban,21,457,507,964,Laikipia,RIFT VALLEY,9943
LAIKIPIA EAST,Urban,22,565,611,1176,Laikipia,RIFT VALLEY,9944
LAIKIPIA EAST,Urban,23,568,602,1170,Laikipia,RIFT VALLEY,9945
LAIKIPIA EAST,Urban,24,545,618,1163,Laikipia,RIFT VALLEY,9946
LAIKIPIA EAST,Urban,25,683,724,1407,Laikipia,RIFT VALLEY,9947
LAIKIPIA EAST,Urban,26,563,574,1137,Laikipia,RIFT VALLEY,9948
LAIKIPIA EAST,Urban,27,563,539,1102,Laikipia,RIFT VALLEY,9949
LAIKIPIA EAST,Urban,28,521,602,1123,Laikipia,RIFT VALLEY,9950
LAIKIPIA EAST,Urban,29,447,471,918,Laikipia,RIFT VALLEY,9951
LAIKIPIA EAST,Urban,30,748,698,1446,Laikipia,RIFT VALLEY,9952
LAIKIPIA EAST,Urban,31,379,290,669,Laikipia,RIFT VALLEY,9953
LAIKIPIA EAST,Urban,32,504,440,944,Laikipia,RIFT VALLEY,9954
LAIKIPIA EAST,Urban,33,329,277,606,Laikipia,RIFT VALLEY,9955
LAIKIPIA EAST,Urban,34,404,295,699,Laikipia,RIFT VALLEY,9956
LAIKIPIA EAST,Urban,35,556,492,1048,Laikipia,RIFT VALLEY,9957
LAIKIPIA EAST,Urban,36,323,290,613,Laikipia,RIFT VALLEY,9958
LAIKIPIA EAST,Urban,37,304,248,552,Laikipia,RIFT VALLEY,9959
LAIKIPIA EAST,Urban,38,335,298,633,Laikipia,RIFT VALLEY,9960
LAIKIPIA EAST,Urban,39,304,230,534,Laikipia,RIFT VALLEY,9961
LAIKIPIA EAST,Urban,40,464,437,901,Laikipia,RIFT VALLEY,9962
LAIKIPIA EAST,Urban,41,261,154,415,Laikipia,RIFT VALLEY,9963
LAIKIPIA EAST,Urban,42,300,211,511,Laikipia,RIFT VALLEY,9964
LAIKIPIA EAST,Urban,43,219,171,390,Laikipia,RIFT VALLEY,9965
LAIKIPIA EAST,Urban,44,186,144,330,Laikipia,RIFT VALLEY,9966
LAIKIPIA EAST,Urban,45,346,253,599,Laikipia,RIFT VALLEY,9967
LAIKIPIA EAST,Urban,46,208,147,355,Laikipia,RIFT VALLEY,9968
LAIKIPIA EAST,Urban,47,239,144,383,Laikipia,RIFT VALLEY,9969
LAIKIPIA EAST,Urban,48,245,117,362,Laikipia,RIFT VALLEY,9970
LAIKIPIA EAST,Urban,49,198,114,312,Laikipia,RIFT VALLEY,9971
LAIKIPIA EAST,Urban,50,257,154,411,Laikipia,RIFT VALLEY,9972
LAIKIPIA EAST,Urban,51,123,50,173,Laikipia,RIFT VALLEY,9973
LAIKIPIA EAST,Urban,52,134,65,199,Laikipia,RIFT VALLEY,9974
LAIKIPIA EAST,Urban,53,94,54,148,Laikipia,RIFT VALLEY,9975
LAIKIPIA EAST,Urban,54,99,66,165,Laikipia,RIFT VALLEY,9976
LAIKIPIA EAST,Urban,55,106,87,193,Laikipia,RIFT VALLEY,9977
LAIKIPIA EAST,Urban,56,71,54,125,Laikipia,RIFT VALLEY,9978
LAIKIPIA EAST,Urban,57,65,61,126,Laikipia,RIFT VALLEY,9979
LAIKIPIA EAST,Urban,58,47,46,93,Laikipia,RIFT VALLEY,9980
LAIKIPIA EAST,Urban,59,54,42,96,Laikipia,RIFT VALLEY,9981
LAIKIPIA EAST,Urban,60,97,81,178,Laikipia,RIFT VALLEY,9982
LAIKIPIA EAST,Urban,61,37,30,67,Laikipia,RIFT VALLEY,9983
LAIKIPIA EAST,Urban,62,42,26,68,Laikipia,RIFT VALLEY,9984
LAIKIPIA EAST,Urban,63,40,22,62,Laikipia,RIFT VALLEY,9985
LAIKIPIA EAST,Urban,64,26,27,53,Laikipia,RIFT VALLEY,9986
LAIKIPIA EAST,Urban,65,66,40,106,Laikipia,RIFT VALLEY,9987
LAIKIPIA EAST,Urban,66,31,30,61,Laikipia,RIFT VALLEY,9988
LAIKIPIA EAST,Urban,67,29,25,54,Laikipia,RIFT VALLEY,9989
LAIKIPIA EAST,Urban,68,22,12,34,Laikipia,RIFT VALLEY,9990
LAIKIPIA EAST,Urban,69,23,32,55,Laikipia,RIFT VALLEY,9991
LAIKIPIA EAST,Urban,70,53,41,94,Laikipia,RIFT VALLEY,9992
LAIKIPIA EAST,Urban,71,12,18,30,Laikipia,RIFT VALLEY,9993
LAIKIPIA EAST,Urban,72,16,6,22,Laikipia,RIFT VALLEY,9994
LAIKIPIA EAST,Urban,73,21,14,35,Laikipia,RIFT VALLEY,9995
LAIKIPIA EAST,Urban,74,15,9,24,Laikipia,RIFT VALLEY,9996
LAIKIPIA EAST,Urban,75,19,17,36,Laikipia,RIFT VALLEY,9997
LAIKIPIA EAST,Urban,76,13,14,27,Laikipia,RIFT VALLEY,9998
LAIKIPIA EAST,Urban,77,14,14,28,Laikipia,RIFT VALLEY,9999
LAIKIPIA EAST,Urban,78,11,9,20,Laikipia,RIFT VALLEY,10000
LAIKIPIA EAST,Urban,79,8,13,21,Laikipia,RIFT VALLEY,10001
LAIKIPIA EAST,Urban,80+,107,172,279,Laikipia,RIFT VALLEY,10002
LAIKIPIA EAST,Urban,Age NS,5,5,10,Laikipia,RIFT VALLEY,10003
LAIKIPIA WEST,Urban,0,793,781,1574,Laikipia,RIFT VALLEY,10004
LAIKIPIA WEST,Urban,1,582,612,1194,Laikipia,RIFT VALLEY,10005
LAIKIPIA WEST,Urban,2,673,663,1336,Laikipia,RIFT VALLEY,10006
LAIKIPIA WEST,Urban,3,636,654,1290,Laikipia,RIFT VALLEY,10007
LAIKIPIA WEST,Urban,4,668,674,1342,Laikipia,RIFT VALLEY,10008
LAIKIPIA WEST,Urban,5,631,654,1285,Laikipia,RIFT VALLEY,10009
LAIKIPIA WEST,Urban,6,635,624,1259,Laikipia,RIFT VALLEY,10010
LAIKIPIA WEST,Urban,7,570,613,1183,Laikipia,RIFT VALLEY,10011
LAIKIPIA WEST,Urban,8,597,582,1179,Laikipia,RIFT VALLEY,10012
LAIKIPIA WEST,Urban,9,580,590,1170,Laikipia,RIFT VALLEY,10013
LAIKIPIA WEST,Urban,10,646,679,1325,Laikipia,RIFT VALLEY,10014
LAIKIPIA WEST,Urban,11,448,523,971,Laikipia,RIFT VALLEY,10015
LAIKIPIA WEST,Urban,12,638,660,1298,Laikipia,RIFT VALLEY,10016
LAIKIPIA WEST,Urban,13,623,633,1256,Laikipia,RIFT VALLEY,10017
LAIKIPIA WEST,Urban,14,510,522,1032,Laikipia,RIFT VALLEY,10018
LAIKIPIA WEST,Urban,15,444,502,946,Laikipia,RIFT VALLEY,10019
LAIKIPIA WEST,Urban,16,480,554,1034,Laikipia,RIFT VALLEY,10020
LAIKIPIA WEST,Urban,17,538,596,1134,Laikipia,RIFT VALLEY,10021
LAIKIPIA WEST,Urban,18,496,605,1101,Laikipia,RIFT VALLEY,10022
LAIKIPIA WEST,Urban,19,453,513,966,Laikipia,RIFT VALLEY,10023
LAIKIPIA WEST,Urban,20,556,733,1289,Laikipia,RIFT VALLEY,10024
LAIKIPIA WEST,Urban,21,430,541,971,Laikipia,RIFT VALLEY,10025
LAIKIPIA WEST,Urban,22,532,690,1222,Laikipia,RIFT VALLEY,10026
LAIKIPIA WEST,Urban,23,502,705,1207,Laikipia,RIFT VALLEY,10027
LAIKIPIA WEST,Urban,24,517,640,1157,Laikipia,RIFT VALLEY,10028
LAIKIPIA WEST,Urban,25,715,797,1512,Laikipia,RIFT VALLEY,10029
LAIKIPIA WEST,Urban,26,506,622,1128,Laikipia,RIFT VALLEY,10030
LAIKIPIA WEST,Urban,27,481,542,1023,Laikipia,RIFT VALLEY,10031
LAIKIPIA WEST,Urban,28,558,593,1151,Laikipia,RIFT VALLEY,10032
LAIKIPIA WEST,Urban,29,432,459,891,Laikipia,RIFT VALLEY,10033
LAIKIPIA WEST,Urban,30,710,746,1456,Laikipia,RIFT VALLEY,10034
LAIKIPIA WEST,Urban,31,337,287,624,Laikipia,RIFT VALLEY,10035
LAIKIPIA WEST,Urban,32,468,479,947,Laikipia,RIFT VALLEY,10036
LAIKIPIA WEST,Urban,33,274,314,588,Laikipia,RIFT VALLEY,10037
LAIKIPIA WEST,Urban,34,323,333,656,Laikipia,RIFT VALLEY,10038
LAIKIPIA WEST,Urban,35,566,517,1083,Laikipia,RIFT VALLEY,10039
LAIKIPIA WEST,Urban,36,295,298,593,Laikipia,RIFT VALLEY,10040
LAIKIPIA WEST,Urban,37,251,249,500,Laikipia,RIFT VALLEY,10041
LAIKIPIA WEST,Urban,38,319,327,646,Laikipia,RIFT VALLEY,10042
LAIKIPIA WEST,Urban,39,274,246,520,Laikipia,RIFT VALLEY,10043
LAIKIPIA WEST,Urban,40,460,473,933,Laikipia,RIFT VALLEY,10044
LAIKIPIA WEST,Urban,41,164,128,292,Laikipia,RIFT VALLEY,10045
LAIKIPIA WEST,Urban,42,268,229,497,Laikipia,RIFT VALLEY,10046
LAIKIPIA WEST,Urban,43,205,180,385,Laikipia,RIFT VALLEY,10047
LAIKIPIA WEST,Urban,44,163,128,291,Laikipia,RIFT VALLEY,10048
LAIKIPIA WEST,Urban,45,340,327,667,Laikipia,RIFT VALLEY,10049
LAIKIPIA WEST,Urban,46,184,181,365,Laikipia,RIFT VALLEY,10050
LAIKIPIA WEST,Urban,47,182,150,332,Laikipia,RIFT VALLEY,10051
LAIKIPIA WEST,Urban,48,159,196,355,Laikipia,RIFT VALLEY,10052
LAIKIPIA WEST,Urban,49,151,136,287,Laikipia,RIFT VALLEY,10053
LAIKIPIA WEST,Urban,50,243,268,511,Laikipia,RIFT VALLEY,10054
LAIKIPIA WEST,Urban,51,64,78,142,Laikipia,RIFT VALLEY,10055
LAIKIPIA WEST,Urban,52,117,92,209,Laikipia,RIFT VALLEY,10056
LAIKIPIA WEST,Urban,53,88,61,149,Laikipia,RIFT VALLEY,10057
LAIKIPIA WEST,Urban,54,74,71,145,Laikipia,RIFT VALLEY,10058
LAIKIPIA WEST,Urban,55,126,113,239,Laikipia,RIFT VALLEY,10059
LAIKIPIA WEST,Urban,56,86,57,143,Laikipia,RIFT VALLEY,10060
LAIKIPIA WEST,Urban,57,91,79,170,Laikipia,RIFT VALLEY,10061
LAIKIPIA WEST,Urban,58,60,53,113,Laikipia,RIFT VALLEY,10062
LAIKIPIA WEST,Urban,59,54,46,100,Laikipia,RIFT VALLEY,10063
LAIKIPIA WEST,Urban,60,112,140,252,Laikipia,RIFT VALLEY,10064
LAIKIPIA WEST,Urban,61,47,34,81,Laikipia,RIFT VALLEY,10065
LAIKIPIA WEST,Urban,62,40,45,85,Laikipia,RIFT VALLEY,10066
LAIKIPIA WEST,Urban,63,37,34,71,Laikipia,RIFT VALLEY,10067
LAIKIPIA WEST,Urban,64,41,25,66,Laikipia,RIFT VALLEY,10068
LAIKIPIA WEST,Urban,65,79,64,143,Laikipia,RIFT VALLEY,10069
LAIKIPIA WEST,Urban,66,24,34,58,Laikipia,RIFT VALLEY,10070
LAIKIPIA WEST,Urban,67,29,20,49,Laikipia,RIFT VALLEY,10071
LAIKIPIA WEST,Urban,68,18,22,40,Laikipia,RIFT VALLEY,10072
LAIKIPIA WEST,Urban,69,27,18,45,Laikipia,RIFT VALLEY,10073
LAIKIPIA WEST,Urban,70,66,77,143,Laikipia,RIFT VALLEY,10074
LAIKIPIA WEST,Urban,71,12,15,27,Laikipia,RIFT VALLEY,10075
LAIKIPIA WEST,Urban,72,22,16,38,Laikipia,RIFT VALLEY,10076
LAIKIPIA WEST,Urban,73,14,11,25,Laikipia,RIFT VALLEY,10077
LAIKIPIA WEST,Urban,74,16,13,29,Laikipia,RIFT VALLEY,10078
LAIKIPIA WEST,Urban,75,26,24,50,Laikipia,RIFT VALLEY,10079
LAIKIPIA WEST,Urban,76,14,19,33,Laikipia,RIFT VALLEY,10080
LAIKIPIA WEST,Urban,77,8,8,16,Laikipia,RIFT VALLEY,10081
LAIKIPIA WEST,Urban,78,17,12,29,Laikipia,RIFT VALLEY,10082
LAIKIPIA WEST,Urban,79,17,11,28,Laikipia,RIFT VALLEY,10083
LAIKIPIA WEST,Urban,80+,125,166,291,Laikipia,RIFT VALLEY,10084
LAIKIPIA WEST,Urban,Age NS,14,26,40,Laikipia,RIFT VALLEY,10085
NAKURU,Urban,0,5235,5188,10423,Nakuru,RIFT VALLEY,10086
NAKURU,Urban,1,4319,4230,8549,Nakuru,RIFT VALLEY,10087
NAKURU,Urban,2,4409,4554,8963,Nakuru,RIFT VALLEY,10088
NAKURU,Urban,3,4476,4469,8945,Nakuru,RIFT VALLEY,10089
NAKURU,Urban,4,4317,4134,8451,Nakuru,RIFT VALLEY,10090
NAKURU,Urban,5,4145,3914,8059,Nakuru,RIFT VALLEY,10091
NAKURU,Urban,6,3745,3762,7507,Nakuru,RIFT VALLEY,10092
NAKURU,Urban,7,3687,3628,7315,Nakuru,RIFT VALLEY,10093
NAKURU,Urban,8,3497,3490,6987,Nakuru,RIFT VALLEY,10094
NAKURU,Urban,9,3718,3697,7415,Nakuru,RIFT VALLEY,10095
NAKURU,Urban,10,3671,3565,7236,Nakuru,RIFT VALLEY,10096
NAKURU,Urban,11,2776,3044,5820,Nakuru,RIFT VALLEY,10097
NAKURU,Urban,12,3266,3389,6655,Nakuru,RIFT VALLEY,10098
NAKURU,Urban,13,3187,3123,6310,Nakuru,RIFT VALLEY,10099
NAKURU,Urban,14,2821,2921,5742,Nakuru,RIFT VALLEY,10100
NAKURU,Urban,15,2596,3021,5617,Nakuru,RIFT VALLEY,10101
NAKURU,Urban,16,2756,3264,6020,Nakuru,RIFT VALLEY,10102
NAKURU,Urban,17,3199,3631,6830,Nakuru,RIFT VALLEY,10103
NAKURU,Urban,18,3339,3803,7142,Nakuru,RIFT VALLEY,10104
NAKURU,Urban,19,3053,3702,6755,Nakuru,RIFT VALLEY,10105
NAKURU,Urban,20,4057,5504,9561,Nakuru,RIFT VALLEY,10106
NAKURU,Urban,21,3371,4098,7469,Nakuru,RIFT VALLEY,10107
NAKURU,Urban,22,4302,5328,9630,Nakuru,RIFT VALLEY,10108
NAKURU,Urban,23,4225,4977,9202,Nakuru,RIFT VALLEY,10109
NAKURU,Urban,24,4372,4905,9277,Nakuru,RIFT VALLEY,10110
NAKURU,Urban,25,5011,5282,10293,Nakuru,RIFT VALLEY,10111
NAKURU,Urban,26,3967,4140,8107,Nakuru,RIFT VALLEY,10112
NAKURU,Urban,27,4134,3886,8020,Nakuru,RIFT VALLEY,10113
NAKURU,Urban,28,4028,4082,8110,Nakuru,RIFT VALLEY,10114
NAKURU,Urban,29,3273,3058,6331,Nakuru,RIFT VALLEY,10115
NAKURU,Urban,30,5063,4482,9545,Nakuru,RIFT VALLEY,10116
NAKURU,Urban,31,2586,1978,4564,Nakuru,RIFT VALLEY,10117
NAKURU,Urban,32,3607,3144,6751,Nakuru,RIFT VALLEY,10118
NAKURU,Urban,33,2174,1816,3990,Nakuru,RIFT VALLEY,10119
NAKURU,Urban,34,2509,1930,4439,Nakuru,RIFT VALLEY,10120
NAKURU,Urban,35,3761,2878,6639,Nakuru,RIFT VALLEY,10121
NAKURU,Urban,36,2102,1764,3866,Nakuru,RIFT VALLEY,10122
NAKURU,Urban,37,2044,1580,3624,Nakuru,RIFT VALLEY,10123
NAKURU,Urban,38,2127,1929,4056,Nakuru,RIFT VALLEY,10124
NAKURU,Urban,39,1763,1429,3192,Nakuru,RIFT VALLEY,10125
NAKURU,Urban,40,2892,2300,5192,Nakuru,RIFT VALLEY,10126
NAKURU,Urban,41,1239,884,2123,Nakuru,RIFT VALLEY,10127
NAKURU,Urban,42,1685,1307,2992,Nakuru,RIFT VALLEY,10128
NAKURU,Urban,43,1105,950,2055,Nakuru,RIFT VALLEY,10129
NAKURU,Urban,44,935,721,1656,Nakuru,RIFT VALLEY,10130
NAKURU,Urban,45,1927,1418,3345,Nakuru,RIFT VALLEY,10131
NAKURU,Urban,46,1128,865,1993,Nakuru,RIFT VALLEY,10132
NAKURU,Urban,47,1099,823,1922,Nakuru,RIFT VALLEY,10133
NAKURU,Urban,48,1134,827,1961,Nakuru,RIFT VALLEY,10134
NAKURU,Urban,49,1061,702,1763,Nakuru,RIFT VALLEY,10135
NAKURU,Urban,50,1451,1093,2544,Nakuru,RIFT VALLEY,10136
NAKURU,Urban,51,658,409,1067,Nakuru,RIFT VALLEY,10137
NAKURU,Urban,52,783,496,1279,Nakuru,RIFT VALLEY,10138
NAKURU,Urban,53,526,392,918,Nakuru,RIFT VALLEY,10139
NAKURU,Urban,54,547,425,972,Nakuru,RIFT VALLEY,10140
NAKURU,Urban,55,730,519,1249,Nakuru,RIFT VALLEY,10141
NAKURU,Urban,56,505,320,825,Nakuru,RIFT VALLEY,10142
NAKURU,Urban,57,486,323,809,Nakuru,RIFT VALLEY,10143
NAKURU,Urban,58,363,243,606,Nakuru,RIFT VALLEY,10144
NAKURU,Urban,59,339,247,586,Nakuru,RIFT VALLEY,10145
NAKURU,Urban,60,551,470,1021,Nakuru,RIFT VALLEY,10146
NAKURU,Urban,61,246,162,408,Nakuru,RIFT VALLEY,10147
NAKURU,Urban,62,267,152,419,Nakuru,RIFT VALLEY,10148
NAKURU,Urban,63,214,137,351,Nakuru,RIFT VALLEY,10149
NAKURU,Urban,64,213,151,364,Nakuru,RIFT VALLEY,10150
NAKURU,Urban,65,252,235,487,Nakuru,RIFT VALLEY,10151
NAKURU,Urban,66,123,126,249,Nakuru,RIFT VALLEY,10152
NAKURU,Urban,67,134,116,250,Nakuru,RIFT VALLEY,10153
NAKURU,Urban,68,110,95,205,Nakuru,RIFT VALLEY,10154
NAKURU,Urban,69,130,111,241,Nakuru,RIFT VALLEY,10155
NAKURU,Urban,70,199,219,418,Nakuru,RIFT VALLEY,10156
NAKURU,Urban,71,75,55,130,Nakuru,RIFT VALLEY,10157
NAKURU,Urban,72,114,58,172,Nakuru,RIFT VALLEY,10158
NAKURU,Urban,73,89,56,145,Nakuru,RIFT VALLEY,10159
NAKURU,Urban,74,68,70,138,Nakuru,RIFT VALLEY,10160
NAKURU,Urban,75,87,102,189,Nakuru,RIFT VALLEY,10161
NAKURU,Urban,76,53,53,106,Nakuru,RIFT VALLEY,10162
NAKURU,Urban,77,47,34,81,Nakuru,RIFT VALLEY,10163
NAKURU,Urban,78,51,41,92,Nakuru,RIFT VALLEY,10164
NAKURU,Urban,79,39,42,81,Nakuru,RIFT VALLEY,10165
NAKURU,Urban,80+,460,678,1138,Nakuru,RIFT VALLEY,10166
NAKURU,Urban,Age NS,112,64,176,Nakuru,RIFT VALLEY,10167
NAKURU NORTH,Urban,0,1091,1131,2222,Nakuru,RIFT VALLEY,10168
NAKURU NORTH,Urban,1,867,840,1707,Nakuru,RIFT VALLEY,10169
NAKURU NORTH,Urban,2,1060,972,2032,Nakuru,RIFT VALLEY,10170
NAKURU NORTH,Urban,3,1010,987,1997,Nakuru,RIFT VALLEY,10171
NAKURU NORTH,Urban,4,1004,1023,2027,Nakuru,RIFT VALLEY,10172
NAKURU NORTH,Urban,5,1003,1024,2027,Nakuru,RIFT VALLEY,10173
NAKURU NORTH,Urban,6,1000,970,1970,Nakuru,RIFT VALLEY,10174
NAKURU NORTH,Urban,7,968,967,1935,Nakuru,RIFT VALLEY,10175
NAKURU NORTH,Urban,8,911,965,1876,Nakuru,RIFT VALLEY,10176
NAKURU NORTH,Urban,9,1046,1024,2070,Nakuru,RIFT VALLEY,10177
NAKURU NORTH,Urban,10,1057,996,2053,Nakuru,RIFT VALLEY,10178
NAKURU NORTH,Urban,11,792,782,1574,Nakuru,RIFT VALLEY,10179
NAKURU NORTH,Urban,12,1054,1037,2091,Nakuru,RIFT VALLEY,10180
NAKURU NORTH,Urban,13,953,967,1920,Nakuru,RIFT VALLEY,10181
NAKURU NORTH,Urban,14,876,838,1714,Nakuru,RIFT VALLEY,10182
NAKURU NORTH,Urban,15,785,798,1583,Nakuru,RIFT VALLEY,10183
NAKURU NORTH,Urban,16,698,787,1485,Nakuru,RIFT VALLEY,10184
NAKURU NORTH,Urban,17,763,746,1509,Nakuru,RIFT VALLEY,10185
NAKURU NORTH,Urban,18,733,809,1542,Nakuru,RIFT VALLEY,10186
NAKURU NORTH,Urban,19,654,664,1318,Nakuru,RIFT VALLEY,10187
NAKURU NORTH,Urban,20,687,950,1637,Nakuru,RIFT VALLEY,10188
NAKURU NORTH,Urban,21,545,695,1240,Nakuru,RIFT VALLEY,10189
NAKURU NORTH,Urban,22,616,831,1447,Nakuru,RIFT VALLEY,10190
NAKURU NORTH,Urban,23,622,884,1506,Nakuru,RIFT VALLEY,10191
NAKURU NORTH,Urban,24,617,785,1402,Nakuru,RIFT VALLEY,10192
NAKURU NORTH,Urban,25,804,988,1792,Nakuru,RIFT VALLEY,10193
NAKURU NORTH,Urban,26,575,781,1356,Nakuru,RIFT VALLEY,10194
NAKURU NORTH,Urban,27,620,693,1313,Nakuru,RIFT VALLEY,10195
NAKURU NORTH,Urban,28,627,749,1376,Nakuru,RIFT VALLEY,10196
NAKURU NORTH,Urban,29,510,627,1137,Nakuru,RIFT VALLEY,10197
NAKURU NORTH,Urban,30,886,967,1853,Nakuru,RIFT VALLEY,10198
NAKURU NORTH,Urban,31,442,364,806,Nakuru,RIFT VALLEY,10199
NAKURU NORTH,Urban,32,591,674,1265,Nakuru,RIFT VALLEY,10200
NAKURU NORTH,Urban,33,335,395,730,Nakuru,RIFT VALLEY,10201
NAKURU NORTH,Urban,34,442,463,905,Nakuru,RIFT VALLEY,10202
NAKURU NORTH,Urban,35,702,773,1475,Nakuru,RIFT VALLEY,10203
NAKURU NORTH,Urban,36,353,413,766,Nakuru,RIFT VALLEY,10204
NAKURU NORTH,Urban,37,394,378,772,Nakuru,RIFT VALLEY,10205
NAKURU NORTH,Urban,38,435,522,957,Nakuru,RIFT VALLEY,10206
NAKURU NORTH,Urban,39,362,350,712,Nakuru,RIFT VALLEY,10207
NAKURU NORTH,Urban,40,632,616,1248,Nakuru,RIFT VALLEY,10208
NAKURU NORTH,Urban,41,239,220,459,Nakuru,RIFT VALLEY,10209
NAKURU NORTH,Urban,42,322,324,646,Nakuru,RIFT VALLEY,10210
NAKURU NORTH,Urban,43,254,276,530,Nakuru,RIFT VALLEY,10211
NAKURU NORTH,Urban,44,199,198,397,Nakuru,RIFT VALLEY,10212
NAKURU NORTH,Urban,45,454,432,886,Nakuru,RIFT VALLEY,10213
NAKURU NORTH,Urban,46,268,245,513,Nakuru,RIFT VALLEY,10214
NAKURU NORTH,Urban,47,238,231,469,Nakuru,RIFT VALLEY,10215
NAKURU NORTH,Urban,48,212,194,406,Nakuru,RIFT VALLEY,10216
NAKURU NORTH,Urban,49,202,192,394,Nakuru,RIFT VALLEY,10217
NAKURU NORTH,Urban,50,282,321,603,Nakuru,RIFT VALLEY,10218
NAKURU NORTH,Urban,51,111,111,222,Nakuru,RIFT VALLEY,10219
NAKURU NORTH,Urban,52,168,169,337,Nakuru,RIFT VALLEY,10220
NAKURU NORTH,Urban,53,113,107,220,Nakuru,RIFT VALLEY,10221
NAKURU NORTH,Urban,54,118,91,209,Nakuru,RIFT VALLEY,10222
NAKURU NORTH,Urban,55,171,167,338,Nakuru,RIFT VALLEY,10223
NAKURU NORTH,Urban,56,110,105,215,Nakuru,RIFT VALLEY,10224
NAKURU NORTH,Urban,57,115,111,226,Nakuru,RIFT VALLEY,10225
NAKURU NORTH,Urban,58,101,94,195,Nakuru,RIFT VALLEY,10226
NAKURU NORTH,Urban,59,88,100,188,Nakuru,RIFT VALLEY,10227
NAKURU NORTH,Urban,60,154,201,355,Nakuru,RIFT VALLEY,10228
NAKURU NORTH,Urban,61,79,73,152,Nakuru,RIFT VALLEY,10229
NAKURU NORTH,Urban,62,78,71,149,Nakuru,RIFT VALLEY,10230
NAKURU NORTH,Urban,63,60,62,122,Nakuru,RIFT VALLEY,10231
NAKURU NORTH,Urban,64,57,78,135,Nakuru,RIFT VALLEY,10232
NAKURU NORTH,Urban,65,96,97,193,Nakuru,RIFT VALLEY,10233
NAKURU NORTH,Urban,66,48,72,120,Nakuru,RIFT VALLEY,10234
NAKURU NORTH,Urban,67,51,55,106,Nakuru,RIFT VALLEY,10235
NAKURU NORTH,Urban,68,42,53,95,Nakuru,RIFT VALLEY,10236
NAKURU NORTH,Urban,69,37,40,77,Nakuru,RIFT VALLEY,10237
NAKURU NORTH,Urban,70,64,92,156,Nakuru,RIFT VALLEY,10238
NAKURU NORTH,Urban,71,42,29,71,Nakuru,RIFT VALLEY,10239
NAKURU NORTH,Urban,72,35,38,73,Nakuru,RIFT VALLEY,10240
NAKURU NORTH,Urban,73,32,30,62,Nakuru,RIFT VALLEY,10241
NAKURU NORTH,Urban,74,22,30,52,Nakuru,RIFT VALLEY,10242
NAKURU NORTH,Urban,75,17,41,58,Nakuru,RIFT VALLEY,10243
NAKURU NORTH,Urban,76,21,32,53,Nakuru,RIFT VALLEY,10244
NAKURU NORTH,Urban,77,25,25,50,Nakuru,RIFT VALLEY,10245
NAKURU NORTH,Urban,78,29,19,48,Nakuru,RIFT VALLEY,10246
NAKURU NORTH,Urban,79,25,26,51,Nakuru,RIFT VALLEY,10247
NAKURU NORTH,Urban,80+,253,376,629,Nakuru,RIFT VALLEY,10248
NAKURU NORTH,Urban,Age NS,13,13,26,Nakuru,RIFT VALLEY,10249
NAIVASHA,Urban,0,3639,3638,7277,Nakuru,RIFT VALLEY,10250
NAIVASHA,Urban,1,2981,3012,5993,Nakuru,RIFT VALLEY,10251
NAIVASHA,Urban,2,3100,3171,6271,Nakuru,RIFT VALLEY,10252
NAIVASHA,Urban,3,3212,3104,6316,Nakuru,RIFT VALLEY,10253
NAIVASHA,Urban,4,3179,3151,6330,Nakuru,RIFT VALLEY,10254
NAIVASHA,Urban,5,3059,2923,5982,Nakuru,RIFT VALLEY,10255
NAIVASHA,Urban,6,2723,2835,5558,Nakuru,RIFT VALLEY,10256
NAIVASHA,Urban,7,2677,2551,5228,Nakuru,RIFT VALLEY,10257
NAIVASHA,Urban,8,2489,2523,5012,Nakuru,RIFT VALLEY,10258
NAIVASHA,Urban,9,2595,2718,5313,Nakuru,RIFT VALLEY,10259
NAIVASHA,Urban,10,2603,2692,5295,Nakuru,RIFT VALLEY,10260
NAIVASHA,Urban,11,2104,2176,4280,Nakuru,RIFT VALLEY,10261
NAIVASHA,Urban,12,2659,2542,5201,Nakuru,RIFT VALLEY,10262
NAIVASHA,Urban,13,2569,2434,5003,Nakuru,RIFT VALLEY,10263
NAIVASHA,Urban,14,2211,2176,4387,Nakuru,RIFT VALLEY,10264
NAIVASHA,Urban,15,1826,1950,3776,Nakuru,RIFT VALLEY,10265
NAIVASHA,Urban,16,1806,1941,3747,Nakuru,RIFT VALLEY,10266
NAIVASHA,Urban,17,1918,2008,3926,Nakuru,RIFT VALLEY,10267
NAIVASHA,Urban,18,2014,2116,4130,Nakuru,RIFT VALLEY,10268
NAIVASHA,Urban,19,2352,2312,4664,Nakuru,RIFT VALLEY,10269
NAIVASHA,Urban,20,3489,3503,6992,Nakuru,RIFT VALLEY,10270
NAIVASHA,Urban,21,3674,2954,6628,Nakuru,RIFT VALLEY,10271
NAIVASHA,Urban,22,3775,3454,7229,Nakuru,RIFT VALLEY,10272
NAIVASHA,Urban,23,3164,3364,6528,Nakuru,RIFT VALLEY,10273
NAIVASHA,Urban,24,2723,3226,5949,Nakuru,RIFT VALLEY,10274
NAIVASHA,Urban,25,3196,3836,7032,Nakuru,RIFT VALLEY,10275
NAIVASHA,Urban,26,2650,2924,5574,Nakuru,RIFT VALLEY,10276
NAIVASHA,Urban,27,2860,2602,5462,Nakuru,RIFT VALLEY,10277
NAIVASHA,Urban,28,2651,2891,5542,Nakuru,RIFT VALLEY,10278
NAIVASHA,Urban,29,2253,2067,4320,Nakuru,RIFT VALLEY,10279
NAIVASHA,Urban,30,3405,3259,6664,Nakuru,RIFT VALLEY,10280
NAIVASHA,Urban,31,1873,1396,3269,Nakuru,RIFT VALLEY,10281
NAIVASHA,Urban,32,2377,2187,4564,Nakuru,RIFT VALLEY,10282
NAIVASHA,Urban,33,1407,1229,2636,Nakuru,RIFT VALLEY,10283
NAIVASHA,Urban,34,1662,1380,3042,Nakuru,RIFT VALLEY,10284
NAIVASHA,Urban,35,2535,2247,4782,Nakuru,RIFT VALLEY,10285
NAIVASHA,Urban,36,1481,1220,2701,Nakuru,RIFT VALLEY,10286
NAIVASHA,Urban,37,1366,1125,2491,Nakuru,RIFT VALLEY,10287
NAIVASHA,Urban,38,1467,1341,2808,Nakuru,RIFT VALLEY,10288
NAIVASHA,Urban,39,1238,959,2197,Nakuru,RIFT VALLEY,10289
NAIVASHA,Urban,40,1830,1589,3419,Nakuru,RIFT VALLEY,10290
NAIVASHA,Urban,41,804,579,1383,Nakuru,RIFT VALLEY,10291
NAIVASHA,Urban,42,1072,804,1876,Nakuru,RIFT VALLEY,10292
NAIVASHA,Urban,43,798,677,1475,Nakuru,RIFT VALLEY,10293
NAIVASHA,Urban,44,627,499,1126,Nakuru,RIFT VALLEY,10294
NAIVASHA,Urban,45,1179,965,2144,Nakuru,RIFT VALLEY,10295
NAIVASHA,Urban,46,755,591,1346,Nakuru,RIFT VALLEY,10296
NAIVASHA,Urban,47,725,522,1247,Nakuru,RIFT VALLEY,10297
NAIVASHA,Urban,48,672,484,1156,Nakuru,RIFT VALLEY,10298
NAIVASHA,Urban,49,681,480,1161,Nakuru,RIFT VALLEY,10299
NAIVASHA,Urban,50,805,753,1558,Nakuru,RIFT VALLEY,10300
NAIVASHA,Urban,51,391,273,664,Nakuru,RIFT VALLEY,10301
NAIVASHA,Urban,52,456,338,794,Nakuru,RIFT VALLEY,10302
NAIVASHA,Urban,53,332,229,561,Nakuru,RIFT VALLEY,10303
NAIVASHA,Urban,54,293,217,510,Nakuru,RIFT VALLEY,10304
NAIVASHA,Urban,55,409,368,777,Nakuru,RIFT VALLEY,10305
NAIVASHA,Urban,56,294,256,550,Nakuru,RIFT VALLEY,10306
NAIVASHA,Urban,57,266,253,519,Nakuru,RIFT VALLEY,10307
NAIVASHA,Urban,58,176,181,357,Nakuru,RIFT VALLEY,10308
NAIVASHA,Urban,59,210,192,402,Nakuru,RIFT VALLEY,10309
NAIVASHA,Urban,60,357,459,816,Nakuru,RIFT VALLEY,10310
NAIVASHA,Urban,61,182,167,349,Nakuru,RIFT VALLEY,10311
NAIVASHA,Urban,62,174,148,322,Nakuru,RIFT VALLEY,10312
NAIVASHA,Urban,63,156,140,296,Nakuru,RIFT VALLEY,10313
NAIVASHA,Urban,64,125,145,270,Nakuru,RIFT VALLEY,10314
NAIVASHA,Urban,65,217,226,443,Nakuru,RIFT VALLEY,10315
NAIVASHA,Urban,66,108,219,327,Nakuru,RIFT VALLEY,10316
NAIVASHA,Urban,67,130,107,237,Nakuru,RIFT VALLEY,10317
NAIVASHA,Urban,68,82,108,190,Nakuru,RIFT VALLEY,10318
NAIVASHA,Urban,69,109,105,214,Nakuru,RIFT VALLEY,10319
NAIVASHA,Urban,70,203,232,435,Nakuru,RIFT VALLEY,10320
NAIVASHA,Urban,71,60,58,118,Nakuru,RIFT VALLEY,10321
NAIVASHA,Urban,72,82,77,159,Nakuru,RIFT VALLEY,10322
NAIVASHA,Urban,73,73,68,141,Nakuru,RIFT VALLEY,10323
NAIVASHA,Urban,74,55,75,130,Nakuru,RIFT VALLEY,10324
NAIVASHA,Urban,75,103,109,212,Nakuru,RIFT VALLEY,10325
NAIVASHA,Urban,76,59,57,116,Nakuru,RIFT VALLEY,10326
NAIVASHA,Urban,77,45,46,91,Nakuru,RIFT VALLEY,10327
NAIVASHA,Urban,78,46,47,93,Nakuru,RIFT VALLEY,10328
NAIVASHA,Urban,79,44,80,124,Nakuru,RIFT VALLEY,10329
NAIVASHA,Urban,80+,431,618,1049,Nakuru,RIFT VALLEY,10330
NAIVASHA,Urban,Age NS,80,50,130,Nakuru,RIFT VALLEY,10331
MOLO,Urban,0,1689,1640,3329,Nakuru,RIFT VALLEY,10332
MOLO,Urban,1,1501,1356,2857,Nakuru,RIFT VALLEY,10333
MOLO,Urban,2,1617,1669,3286,Nakuru,RIFT VALLEY,10334
MOLO,Urban,3,1628,1752,3380,Nakuru,RIFT VALLEY,10335
MOLO,Urban,4,1799,1529,3328,Nakuru,RIFT VALLEY,10336
MOLO,Urban,5,1744,1632,3376,Nakuru,RIFT VALLEY,10337
MOLO,Urban,6,1520,1620,3140,Nakuru,RIFT VALLEY,10338
MOLO,Urban,7,1587,1552,3139,Nakuru,RIFT VALLEY,10339
MOLO,Urban,8,1483,1516,2999,Nakuru,RIFT VALLEY,10340
MOLO,Urban,9,1478,1474,2952,Nakuru,RIFT VALLEY,10341
MOLO,Urban,10,1546,1531,3077,Nakuru,RIFT VALLEY,10342
MOLO,Urban,11,1150,1302,2452,Nakuru,RIFT VALLEY,10343
MOLO,Urban,12,1492,1695,3187,Nakuru,RIFT VALLEY,10344
MOLO,Urban,13,1391,1544,2935,Nakuru,RIFT VALLEY,10345
MOLO,Urban,14,1198,1254,2452,Nakuru,RIFT VALLEY,10346
MOLO,Urban,15,1108,1060,2168,Nakuru,RIFT VALLEY,10347
MOLO,Urban,16,996,998,1994,Nakuru,RIFT VALLEY,10348
MOLO,Urban,17,1044,1043,2087,Nakuru,RIFT VALLEY,10349
MOLO,Urban,18,1094,1069,2163,Nakuru,RIFT VALLEY,10350
MOLO,Urban,19,902,873,1775,Nakuru,RIFT VALLEY,10351
MOLO,Urban,20,975,1336,2311,Nakuru,RIFT VALLEY,10352
MOLO,Urban,21,804,917,1721,Nakuru,RIFT VALLEY,10353
MOLO,Urban,22,949,1240,2189,Nakuru,RIFT VALLEY,10354
MOLO,Urban,23,899,1165,2064,Nakuru,RIFT VALLEY,10355
MOLO,Urban,24,944,1155,2099,Nakuru,RIFT VALLEY,10356
MOLO,Urban,25,1269,1498,2767,Nakuru,RIFT VALLEY,10357
MOLO,Urban,26,938,993,1931,Nakuru,RIFT VALLEY,10358
MOLO,Urban,27,987,921,1908,Nakuru,RIFT VALLEY,10359
MOLO,Urban,28,940,1064,2004,Nakuru,RIFT VALLEY,10360
MOLO,Urban,29,765,741,1506,Nakuru,RIFT VALLEY,10361
MOLO,Urban,30,1315,1315,2630,Nakuru,RIFT VALLEY,10362
MOLO,Urban,31,688,535,1223,Nakuru,RIFT VALLEY,10363
MOLO,Urban,32,867,868,1735,Nakuru,RIFT VALLEY,10364
MOLO,Urban,33,532,516,1048,Nakuru,RIFT VALLEY,10365
MOLO,Urban,34,623,582,1205,Nakuru,RIFT VALLEY,10366
MOLO,Urban,35,1031,1049,2080,Nakuru,RIFT VALLEY,10367
MOLO,Urban,36,541,553,1094,Nakuru,RIFT VALLEY,10368
MOLO,Urban,37,518,485,1003,Nakuru,RIFT VALLEY,10369
MOLO,Urban,38,626,616,1242,Nakuru,RIFT VALLEY,10370
MOLO,Urban,39,468,481,949,Nakuru,RIFT VALLEY,10371
MOLO,Urban,40,851,854,1705,Nakuru,RIFT VALLEY,10372
MOLO,Urban,41,342,336,678,Nakuru,RIFT VALLEY,10373
MOLO,Urban,42,463,428,891,Nakuru,RIFT VALLEY,10374
MOLO,Urban,43,312,343,655,Nakuru,RIFT VALLEY,10375
MOLO,Urban,44,290,249,539,Nakuru,RIFT VALLEY,10376
MOLO,Urban,45,612,564,1176,Nakuru,RIFT VALLEY,10377
MOLO,Urban,46,350,361,711,Nakuru,RIFT VALLEY,10378
MOLO,Urban,47,309,315,624,Nakuru,RIFT VALLEY,10379
MOLO,Urban,48,291,338,629,Nakuru,RIFT VALLEY,10380
MOLO,Urban,49,289,281,570,Nakuru,RIFT VALLEY,10381
MOLO,Urban,50,443,427,870,Nakuru,RIFT VALLEY,10382
MOLO,Urban,51,189,195,384,Nakuru,RIFT VALLEY,10383
MOLO,Urban,52,247,216,463,Nakuru,RIFT VALLEY,10384
MOLO,Urban,53,165,146,311,Nakuru,RIFT VALLEY,10385
MOLO,Urban,54,201,143,344,Nakuru,RIFT VALLEY,10386
MOLO,Urban,55,275,236,511,Nakuru,RIFT VALLEY,10387
MOLO,Urban,56,191,170,361,Nakuru,RIFT VALLEY,10388
MOLO,Urban,57,207,160,367,Nakuru,RIFT VALLEY,10389
MOLO,Urban,58,149,112,261,Nakuru,RIFT VALLEY,10390
MOLO,Urban,59,140,129,269,Nakuru,RIFT VALLEY,10391
MOLO,Urban,60,262,267,529,Nakuru,RIFT VALLEY,10392
MOLO,Urban,61,115,105,220,Nakuru,RIFT VALLEY,10393
MOLO,Urban,62,109,84,193,Nakuru,RIFT VALLEY,10394
MOLO,Urban,63,72,69,141,Nakuru,RIFT VALLEY,10395
MOLO,Urban,64,73,94,167,Nakuru,RIFT VALLEY,10396
MOLO,Urban,65,114,151,265,Nakuru,RIFT VALLEY,10397
MOLO,Urban,66,79,108,187,Nakuru,RIFT VALLEY,10398
MOLO,Urban,67,75,81,156,Nakuru,RIFT VALLEY,10399
MOLO,Urban,68,54,50,104,Nakuru,RIFT VALLEY,10400
MOLO,Urban,69,51,70,121,Nakuru,RIFT VALLEY,10401
MOLO,Urban,70,120,132,252,Nakuru,RIFT VALLEY,10402
MOLO,Urban,71,42,40,82,Nakuru,RIFT VALLEY,10403
MOLO,Urban,72,46,44,90,Nakuru,RIFT VALLEY,10404
MOLO,Urban,73,28,32,60,Nakuru,RIFT VALLEY,10405
MOLO,Urban,74,48,54,102,Nakuru,RIFT VALLEY,10406
MOLO,Urban,75,66,69,135,Nakuru,RIFT VALLEY,10407
MOLO,Urban,76,25,27,52,Nakuru,RIFT VALLEY,10408
MOLO,Urban,77,18,22,40,Nakuru,RIFT VALLEY,10409
MOLO,Urban,78,27,33,60,Nakuru,RIFT VALLEY,10410
MOLO,Urban,79,37,33,70,Nakuru,RIFT VALLEY,10411
MOLO,Urban,80+,292,421,713,Nakuru,RIFT VALLEY,10412
MOLO,Urban,Age NS,23,15,38,Nakuru,RIFT VALLEY,10413
NAROK NORTH,Urban,0,787,728,1515,Narok,RIFT VALLEY,10414
NAROK NORTH,Urban,1,673,623,1296,Narok,RIFT VALLEY,10415
NAROK NORTH,Urban,2,660,622,1282,Narok,RIFT VALLEY,10416
NAROK NORTH,Urban,3,643,686,1329,Narok,RIFT VALLEY,10417
NAROK NORTH,Urban,4,593,596,1189,Narok,RIFT VALLEY,10418
NAROK NORTH,Urban,5,591,550,1141,Narok,RIFT VALLEY,10419
NAROK NORTH,Urban,6,501,567,1068,Narok,RIFT VALLEY,10420
NAROK NORTH,Urban,7,504,492,996,Narok,RIFT VALLEY,10421
NAROK NORTH,Urban,8,481,470,951,Narok,RIFT VALLEY,10422
NAROK NORTH,Urban,9,488,510,998,Narok,RIFT VALLEY,10423
NAROK NORTH,Urban,10,466,482,948,Narok,RIFT VALLEY,10424
NAROK NORTH,Urban,11,326,383,709,Narok,RIFT VALLEY,10425
NAROK NORTH,Urban,12,421,510,931,Narok,RIFT VALLEY,10426
NAROK NORTH,Urban,13,376,504,880,Narok,RIFT VALLEY,10427
NAROK NORTH,Urban,14,333,486,819,Narok,RIFT VALLEY,10428
NAROK NORTH,Urban,15,327,483,810,Narok,RIFT VALLEY,10429
NAROK NORTH,Urban,16,327,396,723,Narok,RIFT VALLEY,10430
NAROK NORTH,Urban,17,412,446,858,Narok,RIFT VALLEY,10431
NAROK NORTH,Urban,18,446,459,905,Narok,RIFT VALLEY,10432
NAROK NORTH,Urban,19,398,420,818,Narok,RIFT VALLEY,10433
NAROK NORTH,Urban,20,508,725,1233,Narok,RIFT VALLEY,10434
NAROK NORTH,Urban,21,415,553,968,Narok,RIFT VALLEY,10435
NAROK NORTH,Urban,22,565,698,1263,Narok,RIFT VALLEY,10436
NAROK NORTH,Urban,23,580,685,1265,Narok,RIFT VALLEY,10437
NAROK NORTH,Urban,24,621,650,1271,Narok,RIFT VALLEY,10438
NAROK NORTH,Urban,25,759,787,1546,Narok,RIFT VALLEY,10439
NAROK NORTH,Urban,26,555,558,1113,Narok,RIFT VALLEY,10440
NAROK NORTH,Urban,27,639,502,1141,Narok,RIFT VALLEY,10441
NAROK NORTH,Urban,28,607,568,1175,Narok,RIFT VALLEY,10442
NAROK NORTH,Urban,29,483,401,884,Narok,RIFT VALLEY,10443
NAROK NORTH,Urban,30,832,661,1493,Narok,RIFT VALLEY,10444
NAROK NORTH,Urban,31,370,239,609,Narok,RIFT VALLEY,10445
NAROK NORTH,Urban,32,585,401,986,Narok,RIFT VALLEY,10446
NAROK NORTH,Urban,33,276,210,486,Narok,RIFT VALLEY,10447
NAROK NORTH,Urban,34,340,240,580,Narok,RIFT VALLEY,10448
NAROK NORTH,Urban,35,623,429,1052,Narok,RIFT VALLEY,10449
NAROK NORTH,Urban,36,288,186,474,Narok,RIFT VALLEY,10450
NAROK NORTH,Urban,37,282,183,465,Narok,RIFT VALLEY,10451
NAROK NORTH,Urban,38,334,270,604,Narok,RIFT VALLEY,10452
NAROK NORTH,Urban,39,235,176,411,Narok,RIFT VALLEY,10453
NAROK NORTH,Urban,40,480,323,803,Narok,RIFT VALLEY,10454
NAROK NORTH,Urban,41,179,80,259,Narok,RIFT VALLEY,10455
NAROK NORTH,Urban,42,237,174,411,Narok,RIFT VALLEY,10456
NAROK NORTH,Urban,43,158,108,266,Narok,RIFT VALLEY,10457
NAROK NORTH,Urban,44,127,85,212,Narok,RIFT VALLEY,10458
NAROK NORTH,Urban,45,287,198,485,Narok,RIFT VALLEY,10459
NAROK NORTH,Urban,46,146,93,239,Narok,RIFT VALLEY,10460
NAROK SOUTH,Urban,13,0,0,0,Narok,RIFT VALLEY,10461
NAROK NORTH,Urban,47,155,90,245,Narok,RIFT VALLEY,10462
NAROK NORTH,Urban,48,154,101,255,Narok,RIFT VALLEY,10463
NAROK NORTH,Urban,49,122,85,207,Narok,RIFT VALLEY,10464
NAROK NORTH,Urban,50,194,135,329,Narok,RIFT VALLEY,10465
NAROK NORTH,Urban,51,65,36,101,Narok,RIFT VALLEY,10466
NAROK NORTH,Urban,52,105,47,152,Narok,RIFT VALLEY,10467
NAROK NORTH,Urban,53,64,36,100,Narok,RIFT VALLEY,10468
NAROK NORTH,Urban,54,75,38,113,Narok,RIFT VALLEY,10469
NAROK NORTH,Urban,55,91,69,160,Narok,RIFT VALLEY,10470
NAROK NORTH,Urban,56,58,30,88,Narok,RIFT VALLEY,10471
NAROK NORTH,Urban,57,65,39,104,Narok,RIFT VALLEY,10472
NAROK NORTH,Urban,58,34,28,62,Narok,RIFT VALLEY,10473
NAROK NORTH,Urban,59,41,29,70,Narok,RIFT VALLEY,10474
NAROK NORTH,Urban,60,80,68,148,Narok,RIFT VALLEY,10475
NAROK NORTH,Urban,61,22,20,42,Narok,RIFT VALLEY,10476
NAROK NORTH,Urban,62,32,20,52,Narok,RIFT VALLEY,10477
NAROK NORTH,Urban,63,27,17,44,Narok,RIFT VALLEY,10478
NAROK NORTH,Urban,64,24,13,37,Narok,RIFT VALLEY,10479
NAROK NORTH,Urban,65,35,34,69,Narok,RIFT VALLEY,10480
NAROK NORTH,Urban,66,10,18,28,Narok,RIFT VALLEY,10481
NAROK NORTH,Urban,67,25,16,41,Narok,RIFT VALLEY,10482
NAROK NORTH,Urban,68,18,15,33,Narok,RIFT VALLEY,10483
NAROK NORTH,Urban,69,11,11,22,Narok,RIFT VALLEY,10484
NAROK NORTH,Urban,70,20,46,66,Narok,RIFT VALLEY,10485
NAROK NORTH,Urban,71,9,6,15,Narok,RIFT VALLEY,10486
NAROK NORTH,Urban,72,8,7,15,Narok,RIFT VALLEY,10487
NAROK NORTH,Urban,73,5,10,15,Narok,RIFT VALLEY,10488
NAROK NORTH,Urban,74,8,6,14,Narok,RIFT VALLEY,10489
NAROK NORTH,Urban,75,12,14,26,Narok,RIFT VALLEY,10490
NAROK NORTH,Urban,76,6,4,10,Narok,RIFT VALLEY,10491
NAROK NORTH,Urban,77,8,5,13,Narok,RIFT VALLEY,10492
NAROK NORTH,Urban,78,2,8,10,Narok,RIFT VALLEY,10493
NAROK NORTH,Urban,79,9,8,17,Narok,RIFT VALLEY,10494
NAROK NORTH,Urban,80+,65,109,174,Narok,RIFT VALLEY,10495
NAROK NORTH,Urban,Age NS,22,19,41,Narok,RIFT VALLEY,10496
NAROK SOUTH,Urban,0,0,0,0,Narok,RIFT VALLEY,10497
NAROK SOUTH,Urban,1,0,0,0,Narok,RIFT VALLEY,10498
NAROK SOUTH,Urban,2,0,0,0,Narok,RIFT VALLEY,10499
NAROK SOUTH,Urban,3,0,0,0,Narok,RIFT VALLEY,10500
NAROK SOUTH,Urban,4,0,0,0,Narok,RIFT VALLEY,10501
NAROK SOUTH,Urban,5,0,0,0,Narok,RIFT VALLEY,10502
NAROK SOUTH,Urban,6,0,0,0,Narok,RIFT VALLEY,10503
NAROK SOUTH,Urban,7,0,0,0,Narok,RIFT VALLEY,10504
NAROK SOUTH,Urban,8,0,0,0,Narok,RIFT VALLEY,10505
NAROK SOUTH,Urban,9,0,0,0,Narok,RIFT VALLEY,10506
NAROK SOUTH,Urban,10,0,0,0,Narok,RIFT VALLEY,10507
NAROK SOUTH,Urban,11,0,0,0,Narok,RIFT VALLEY,10508
NAROK SOUTH,Urban,12,0,0,0,Narok,RIFT VALLEY,10509
NAROK SOUTH,Urban,14,0,0,0,Narok,RIFT VALLEY,10510
NAROK SOUTH,Urban,15,0,0,0,Narok,RIFT VALLEY,10511
NAROK SOUTH,Urban,16,0,0,0,Narok,RIFT VALLEY,10512
NAROK SOUTH,Urban,17,0,0,0,Narok,RIFT VALLEY,10513
NAROK SOUTH,Urban,18,0,0,0,Narok,RIFT VALLEY,10514
NAROK SOUTH,Urban,19,0,0,0,Narok,RIFT VALLEY,10515
NAROK SOUTH,Urban,20,0,0,0,Narok,RIFT VALLEY,10516
NAROK SOUTH,Urban,21,0,0,0,Narok,RIFT VALLEY,10517
NAROK SOUTH,Urban,22,0,0,0,Narok,RIFT VALLEY,10518
NAROK SOUTH,Urban,23,0,0,0,Narok,RIFT VALLEY,10519
NAROK SOUTH,Urban,24,0,0,0,Narok,RIFT VALLEY,10520
NAROK SOUTH,Urban,25,0,0,0,Narok,RIFT VALLEY,10521
NAROK SOUTH,Urban,26,0,0,0,Narok,RIFT VALLEY,10522
NAROK SOUTH,Urban,27,0,0,0,Narok,RIFT VALLEY,10523
NAROK SOUTH,Urban,28,0,0,0,Narok,RIFT VALLEY,10524
NAROK SOUTH,Urban,29,0,0,0,Narok,RIFT VALLEY,10525
NAROK SOUTH,Urban,30,0,0,0,Narok,RIFT VALLEY,10526
NAROK SOUTH,Urban,31,0,0,0,Narok,RIFT VALLEY,10527
NAROK SOUTH,Urban,32,0,0,0,Narok,RIFT VALLEY,10528
NAROK SOUTH,Urban,33,0,0,0,Narok,RIFT VALLEY,10529
NAROK SOUTH,Urban,34,0,0,0,Narok,RIFT VALLEY,10530
NAROK SOUTH,Urban,35,0,0,0,Narok,RIFT VALLEY,10531
NAROK SOUTH,Urban,36,0,0,0,Narok,RIFT VALLEY,10532
NAROK SOUTH,Urban,37,0,0,0,Narok,RIFT VALLEY,10533
NAROK SOUTH,Urban,38,0,0,0,Narok,RIFT VALLEY,10534
NAROK SOUTH,Urban,39,0,0,0,Narok,RIFT VALLEY,10535
NAROK SOUTH,Urban,40,0,0,0,Narok,RIFT VALLEY,10536
NAROK SOUTH,Urban,41,0,0,0,Narok,RIFT VALLEY,10537
NAROK SOUTH,Urban,42,0,0,0,Narok,RIFT VALLEY,10538
NAROK SOUTH,Urban,43,0,0,0,Narok,RIFT VALLEY,10539
NAROK SOUTH,Urban,44,0,0,0,Narok,RIFT VALLEY,10540
NAROK SOUTH,Urban,45,0,0,0,Narok,RIFT VALLEY,10541
NAROK SOUTH,Urban,46,0,0,0,Narok,RIFT VALLEY,10542
NAROK SOUTH,Urban,47,0,0,0,Narok,RIFT VALLEY,10543
NAROK SOUTH,Urban,48,0,0,0,Narok,RIFT VALLEY,10544
NAROK SOUTH,Urban,49,0,0,0,Narok,RIFT VALLEY,10545
NAROK SOUTH,Urban,50,0,0,0,Narok,RIFT VALLEY,10546
NAROK SOUTH,Urban,51,0,0,0,Narok,RIFT VALLEY,10547
NAROK SOUTH,Urban,52,0,0,0,Narok,RIFT VALLEY,10548
NAROK SOUTH,Urban,53,0,0,0,Narok,RIFT VALLEY,10549
NAROK SOUTH,Urban,54,0,0,0,Narok,RIFT VALLEY,10550
NAROK SOUTH,Urban,55,0,0,0,Narok,RIFT VALLEY,10551
NAROK SOUTH,Urban,56,0,0,0,Narok,RIFT VALLEY,10552
NAROK SOUTH,Urban,57,0,0,0,Narok,RIFT VALLEY,10553
NAROK SOUTH,Urban,58,0,0,0,Narok,RIFT VALLEY,10554
NAROK SOUTH,Urban,59,0,0,0,Narok,RIFT VALLEY,10555
NAROK SOUTH,Urban,60,0,0,0,Narok,RIFT VALLEY,10556
NAROK SOUTH,Urban,61,0,0,0,Narok,RIFT VALLEY,10557
NAROK SOUTH,Urban,62,0,0,0,Narok,RIFT VALLEY,10558
NAROK SOUTH,Urban,63,0,0,0,Narok,RIFT VALLEY,10559
NAROK SOUTH,Urban,64,0,0,0,Narok,RIFT VALLEY,10560
NAROK SOUTH,Urban,65,0,0,0,Narok,RIFT VALLEY,10561
NAROK SOUTH,Urban,66,0,0,0,Narok,RIFT VALLEY,10562
NAROK SOUTH,Urban,67,0,0,0,Narok,RIFT VALLEY,10563
NAROK SOUTH,Urban,68,0,0,0,Narok,RIFT VALLEY,10564
NAROK SOUTH,Urban,69,0,0,0,Narok,RIFT VALLEY,10565
NAROK SOUTH,Urban,70,0,0,0,Narok,RIFT VALLEY,10566
NAROK SOUTH,Urban,71,0,0,0,Narok,RIFT VALLEY,10567
NAROK SOUTH,Urban,72,0,0,0,Narok,RIFT VALLEY,10568
NAROK SOUTH,Urban,73,0,0,0,Narok,RIFT VALLEY,10569
NAROK SOUTH,Urban,74,0,0,0,Narok,RIFT VALLEY,10570
NAROK SOUTH,Urban,75,0,0,0,Narok,RIFT VALLEY,10571
NAROK SOUTH,Urban,76,0,0,0,Narok,RIFT VALLEY,10572
NAROK SOUTH,Urban,77,0,0,0,Narok,RIFT VALLEY,10573
NAROK SOUTH,Urban,78,0,0,0,Narok,RIFT VALLEY,10574
NAROK SOUTH,Urban,79,0,0,0,Narok,RIFT VALLEY,10575
NAROK SOUTH,Urban,80+,0,0,0,Narok,RIFT VALLEY,10576
NAROK SOUTH,Urban,Age NS,0,0,0,Narok,RIFT VALLEY,10577
TRANS MARA,Urban,0,271,245,516,Narok,RIFT VALLEY,10578
TRANS MARA,Urban,1,203,205,408,Narok,RIFT VALLEY,10579
TRANS MARA,Urban,2,237,231,468,Narok,RIFT VALLEY,10580
TRANS MARA,Urban,3,230,247,477,Narok,RIFT VALLEY,10581
TRANS MARA,Urban,4,203,224,427,Narok,RIFT VALLEY,10582
TRANS MARA,Urban,5,203,206,409,Narok,RIFT VALLEY,10583
TRANS MARA,Urban,6,196,178,374,Narok,RIFT VALLEY,10584
TRANS MARA,Urban,7,169,208,377,Narok,RIFT VALLEY,10585
TRANS MARA,Urban,8,169,187,356,Narok,RIFT VALLEY,10586
TRANS MARA,Urban,9,182,184,366,Narok,RIFT VALLEY,10587
TRANS MARA,Urban,10,177,190,367,Narok,RIFT VALLEY,10588
TRANS MARA,Urban,11,121,149,270,Narok,RIFT VALLEY,10589
TRANS MARA,Urban,12,163,170,333,Narok,RIFT VALLEY,10590
TRANS MARA,Urban,13,157,189,346,Narok,RIFT VALLEY,10591
TRANS MARA,Urban,14,134,164,298,Narok,RIFT VALLEY,10592
TRANS MARA,Urban,15,145,153,298,Narok,RIFT VALLEY,10593
TRANS MARA,Urban,16,130,125,255,Narok,RIFT VALLEY,10594
TRANS MARA,Urban,17,143,123,266,Narok,RIFT VALLEY,10595
TRANS MARA,Urban,18,118,179,297,Narok,RIFT VALLEY,10596
TRANS MARA,Urban,19,105,151,256,Narok,RIFT VALLEY,10597
TRANS MARA,Urban,20,178,260,438,Narok,RIFT VALLEY,10598
TRANS MARA,Urban,21,126,172,298,Narok,RIFT VALLEY,10599
TRANS MARA,Urban,22,139,215,354,Narok,RIFT VALLEY,10600
TRANS MARA,Urban,23,139,178,317,Narok,RIFT VALLEY,10601
TRANS MARA,Urban,24,120,165,285,Narok,RIFT VALLEY,10602
TRANS MARA,Urban,25,235,218,453,Narok,RIFT VALLEY,10603
TRANS MARA,Urban,26,152,123,275,Narok,RIFT VALLEY,10604
TRANS MARA,Urban,27,140,124,264,Narok,RIFT VALLEY,10605
TRANS MARA,Urban,28,141,147,288,Narok,RIFT VALLEY,10606
TRANS MARA,Urban,29,98,80,178,Narok,RIFT VALLEY,10607
TRANS MARA,Urban,30,171,181,352,Narok,RIFT VALLEY,10608
TRANS MARA,Urban,31,85,60,145,Narok,RIFT VALLEY,10609
TRANS MARA,Urban,32,110,89,199,Narok,RIFT VALLEY,10610
TRANS MARA,Urban,33,72,60,132,Narok,RIFT VALLEY,10611
TRANS MARA,Urban,34,88,58,146,Narok,RIFT VALLEY,10612
TRANS MARA,Urban,35,155,135,290,Narok,RIFT VALLEY,10613
TRANS MARA,Urban,36,86,55,141,Narok,RIFT VALLEY,10614
TRANS MARA,Urban,37,76,70,146,Narok,RIFT VALLEY,10615
TRANS MARA,Urban,38,78,61,139,Narok,RIFT VALLEY,10616
TRANS MARA,Urban,39,62,50,112,Narok,RIFT VALLEY,10617
TRANS MARA,Urban,40,128,73,201,Narok,RIFT VALLEY,10618
TRANS MARA,Urban,41,39,24,63,Narok,RIFT VALLEY,10619
TRANS MARA,Urban,42,77,47,124,Narok,RIFT VALLEY,10620
TRANS MARA,Urban,43,33,30,63,Narok,RIFT VALLEY,10621
TRANS MARA,Urban,44,37,24,61,Narok,RIFT VALLEY,10622
TRANS MARA,Urban,45,67,50,117,Narok,RIFT VALLEY,10623
TRANS MARA,Urban,46,48,27,75,Narok,RIFT VALLEY,10624
TRANS MARA,Urban,47,41,28,69,Narok,RIFT VALLEY,10625
TRANS MARA,Urban,48,39,34,73,Narok,RIFT VALLEY,10626
TRANS MARA,Urban,49,39,21,60,Narok,RIFT VALLEY,10627
TRANS MARA,Urban,50,62,37,99,Narok,RIFT VALLEY,10628
TRANS MARA,Urban,51,23,16,39,Narok,RIFT VALLEY,10629
TRANS MARA,Urban,52,30,14,44,Narok,RIFT VALLEY,10630
TRANS MARA,Urban,53,19,8,27,Narok,RIFT VALLEY,10631
TRANS MARA,Urban,54,20,10,30,Narok,RIFT VALLEY,10632
TRANS MARA,Urban,55,30,24,54,Narok,RIFT VALLEY,10633
TRANS MARA,Urban,56,14,18,32,Narok,RIFT VALLEY,10634
TRANS MARA,Urban,57,18,9,27,Narok,RIFT VALLEY,10635
TRANS MARA,Urban,58,14,16,30,Narok,RIFT VALLEY,10636
TRANS MARA,Urban,59,10,7,17,Narok,RIFT VALLEY,10637
TRANS MARA,Urban,60,18,18,36,Narok,RIFT VALLEY,10638
TRANS MARA,Urban,61,9,5,14,Narok,RIFT VALLEY,10639
TRANS MARA,Urban,62,11,13,24,Narok,RIFT VALLEY,10640
TRANS MARA,Urban,63,4,7,11,Narok,RIFT VALLEY,10641
TRANS MARA,Urban,64,9,5,14,Narok,RIFT VALLEY,10642
TRANS MARA,Urban,65,9,6,15,Narok,RIFT VALLEY,10643
TRANS MARA,Urban,66,4,4,8,Narok,RIFT VALLEY,10644
TRANS MARA,Urban,67,10,9,19,Narok,RIFT VALLEY,10645
TRANS MARA,Urban,68,8,5,13,Narok,RIFT VALLEY,10646
TRANS MARA,Urban,69,3,3,6,Narok,RIFT VALLEY,10647
TRANS MARA,Urban,70,7,9,16,Narok,RIFT VALLEY,10648
TRANS MARA,Urban,71,4,3,7,Narok,RIFT VALLEY,10649
TRANS MARA,Urban,72,1,3,4,Narok,RIFT VALLEY,10650
TRANS MARA,Urban,73,4,2,6,Narok,RIFT VALLEY,10651
TRANS MARA,Urban,74,5,2,7,Narok,RIFT VALLEY,10652
TRANS MARA,Urban,75,3,6,9,Narok,RIFT VALLEY,10653
TRANS MARA,Urban,76,3,2,5,Narok,RIFT VALLEY,10654
TRANS MARA,Urban,77,0,2,2,Narok,RIFT VALLEY,10655
TRANS MARA,Urban,78,1,3,4,Narok,RIFT VALLEY,10656
TRANS MARA,Urban,79,3,1,4,Narok,RIFT VALLEY,10657
TRANS MARA,Urban,80+,25,29,54,Narok,RIFT VALLEY,10658
TRANS MARA,Urban,Age NS,9,8,17,Narok,RIFT VALLEY,10659
KAJIADO CENTRAL,Urban,0,546,512,1058,Kajiado,RIFT VALLEY,10660
KAJIADO CENTRAL,Urban,1,417,406,823,Kajiado,RIFT VALLEY,10661
KAJIADO CENTRAL,Urban,2,497,459,956,Kajiado,RIFT VALLEY,10662
KAJIADO CENTRAL,Urban,3,485,457,942,Kajiado,RIFT VALLEY,10663
KAJIADO CENTRAL,Urban,4,483,454,937,Kajiado,RIFT VALLEY,10664
KAJIADO CENTRAL,Urban,5,474,439,913,Kajiado,RIFT VALLEY,10665
KAJIADO CENTRAL,Urban,6,424,441,865,Kajiado,RIFT VALLEY,10666
KAJIADO CENTRAL,Urban,7,436,398,834,Kajiado,RIFT VALLEY,10667
KAJIADO CENTRAL,Urban,8,408,371,779,Kajiado,RIFT VALLEY,10668
KAJIADO CENTRAL,Urban,9,431,414,845,Kajiado,RIFT VALLEY,10669
KAJIADO CENTRAL,Urban,10,456,413,869,Kajiado,RIFT VALLEY,10670
KAJIADO CENTRAL,Urban,11,369,345,714,Kajiado,RIFT VALLEY,10671
KAJIADO CENTRAL,Urban,12,450,375,825,Kajiado,RIFT VALLEY,10672
KAJIADO CENTRAL,Urban,13,447,412,859,Kajiado,RIFT VALLEY,10673
KAJIADO CENTRAL,Urban,14,350,450,800,Kajiado,RIFT VALLEY,10674
KAJIADO CENTRAL,Urban,15,345,426,771,Kajiado,RIFT VALLEY,10675
KAJIADO CENTRAL,Urban,16,302,353,655,Kajiado,RIFT VALLEY,10676
KAJIADO CENTRAL,Urban,17,321,346,667,Kajiado,RIFT VALLEY,10677
KAJIADO CENTRAL,Urban,18,330,381,711,Kajiado,RIFT VALLEY,10678
KAJIADO CENTRAL,Urban,19,257,312,569,Kajiado,RIFT VALLEY,10679
KAJIADO CENTRAL,Urban,20,354,490,844,Kajiado,RIFT VALLEY,10680
KAJIADO CENTRAL,Urban,21,252,351,603,Kajiado,RIFT VALLEY,10681
KAJIADO CENTRAL,Urban,22,322,395,717,Kajiado,RIFT VALLEY,10682
KAJIADO CENTRAL,Urban,23,320,415,735,Kajiado,RIFT VALLEY,10683
KAJIADO CENTRAL,Urban,24,332,451,783,Kajiado,RIFT VALLEY,10684
KAJIADO CENTRAL,Urban,25,419,505,924,Kajiado,RIFT VALLEY,10685
KAJIADO CENTRAL,Urban,26,313,338,651,Kajiado,RIFT VALLEY,10686
KAJIADO CENTRAL,Urban,27,362,349,711,Kajiado,RIFT VALLEY,10687
KAJIADO CENTRAL,Urban,28,335,405,740,Kajiado,RIFT VALLEY,10688
KAJIADO CENTRAL,Urban,29,279,261,540,Kajiado,RIFT VALLEY,10689
KAJIADO CENTRAL,Urban,30,526,497,1023,Kajiado,RIFT VALLEY,10690
KAJIADO CENTRAL,Urban,31,201,166,367,Kajiado,RIFT VALLEY,10691
KAJIADO CENTRAL,Urban,32,319,280,599,Kajiado,RIFT VALLEY,10692
KAJIADO CENTRAL,Urban,33,177,164,341,Kajiado,RIFT VALLEY,10693
KAJIADO CENTRAL,Urban,34,216,175,391,Kajiado,RIFT VALLEY,10694
KAJIADO CENTRAL,Urban,35,390,321,711,Kajiado,RIFT VALLEY,10695
KAJIADO CENTRAL,Urban,36,217,169,386,Kajiado,RIFT VALLEY,10696
KAJIADO CENTRAL,Urban,37,196,162,358,Kajiado,RIFT VALLEY,10697
KAJIADO CENTRAL,Urban,38,232,180,412,Kajiado,RIFT VALLEY,10698
KAJIADO CENTRAL,Urban,39,161,127,288,Kajiado,RIFT VALLEY,10699
KAJIADO CENTRAL,Urban,40,320,298,618,Kajiado,RIFT VALLEY,10700
KAJIADO CENTRAL,Urban,41,119,87,206,Kajiado,RIFT VALLEY,10701
KAJIADO CENTRAL,Urban,42,135,122,257,Kajiado,RIFT VALLEY,10702
KAJIADO CENTRAL,Urban,43,111,90,201,Kajiado,RIFT VALLEY,10703
KAJIADO CENTRAL,Urban,44,80,74,154,Kajiado,RIFT VALLEY,10704
KAJIADO CENTRAL,Urban,45,221,145,366,Kajiado,RIFT VALLEY,10705
KAJIADO CENTRAL,Urban,46,125,74,199,Kajiado,RIFT VALLEY,10706
KAJIADO CENTRAL,Urban,47,104,73,177,Kajiado,RIFT VALLEY,10707
KAJIADO CENTRAL,Urban,48,109,87,196,Kajiado,RIFT VALLEY,10708
KAJIADO CENTRAL,Urban,49,116,58,174,Kajiado,RIFT VALLEY,10709
KAJIADO CENTRAL,Urban,50,173,142,315,Kajiado,RIFT VALLEY,10710
KAJIADO CENTRAL,Urban,51,58,60,118,Kajiado,RIFT VALLEY,10711
KAJIADO CENTRAL,Urban,52,97,54,151,Kajiado,RIFT VALLEY,10712
KAJIADO CENTRAL,Urban,53,45,43,88,Kajiado,RIFT VALLEY,10713
KAJIADO CENTRAL,Urban,54,58,48,106,Kajiado,RIFT VALLEY,10714
KAJIADO CENTRAL,Urban,55,75,59,134,Kajiado,RIFT VALLEY,10715
KAJIADO CENTRAL,Urban,56,58,41,99,Kajiado,RIFT VALLEY,10716
KAJIADO CENTRAL,Urban,57,45,32,77,Kajiado,RIFT VALLEY,10717
KAJIADO CENTRAL,Urban,58,23,31,54,Kajiado,RIFT VALLEY,10718
KAJIADO CENTRAL,Urban,59,33,20,53,Kajiado,RIFT VALLEY,10719
KAJIADO CENTRAL,Urban,60,56,88,144,Kajiado,RIFT VALLEY,10720
KAJIADO CENTRAL,Urban,61,23,11,34,Kajiado,RIFT VALLEY,10721
KAJIADO CENTRAL,Urban,62,28,23,51,Kajiado,RIFT VALLEY,10722
KAJIADO CENTRAL,Urban,63,17,17,34,Kajiado,RIFT VALLEY,10723
KAJIADO CENTRAL,Urban,64,16,16,32,Kajiado,RIFT VALLEY,10724
KAJIADO CENTRAL,Urban,65,37,34,71,Kajiado,RIFT VALLEY,10725
KAJIADO CENTRAL,Urban,66,4,13,17,Kajiado,RIFT VALLEY,10726
KAJIADO CENTRAL,Urban,67,23,17,40,Kajiado,RIFT VALLEY,10727
KAJIADO CENTRAL,Urban,68,24,36,60,Kajiado,RIFT VALLEY,10728
KAJIADO CENTRAL,Urban,69,15,16,31,Kajiado,RIFT VALLEY,10729
KAJIADO CENTRAL,Urban,70,39,69,108,Kajiado,RIFT VALLEY,10730
KAJIADO CENTRAL,Urban,71,6,10,16,Kajiado,RIFT VALLEY,10731
KAJIADO CENTRAL,Urban,72,14,12,26,Kajiado,RIFT VALLEY,10732
KAJIADO CENTRAL,Urban,73,9,5,14,Kajiado,RIFT VALLEY,10733
KAJIADO CENTRAL,Urban,74,12,8,20,Kajiado,RIFT VALLEY,10734
KAJIADO CENTRAL,Urban,75,11,25,36,Kajiado,RIFT VALLEY,10735
KAJIADO CENTRAL,Urban,76,8,7,15,Kajiado,RIFT VALLEY,10736
KAJIADO CENTRAL,Urban,77,10,4,14,Kajiado,RIFT VALLEY,10737
KAJIADO CENTRAL,Urban,78,10,6,16,Kajiado,RIFT VALLEY,10738
KAJIADO CENTRAL,Urban,79,8,7,15,Kajiado,RIFT VALLEY,10739
KAJIADO CENTRAL,Urban,80+,70,120,190,Kajiado,RIFT VALLEY,10740
KAJIADO CENTRAL,Urban,Age NS,6,4,10,Kajiado,RIFT VALLEY,10741
LOITOKITOK,Urban,0,264,248,512,Kajiado,RIFT VALLEY,10742
LOITOKITOK,Urban,1,194,175,369,Kajiado,RIFT VALLEY,10743
LOITOKITOK,Urban,2,197,228,425,Kajiado,RIFT VALLEY,10744
LOITOKITOK,Urban,3,189,218,407,Kajiado,RIFT VALLEY,10745
LOITOKITOK,Urban,4,197,207,404,Kajiado,RIFT VALLEY,10746
LOITOKITOK,Urban,5,209,194,403,Kajiado,RIFT VALLEY,10747
LOITOKITOK,Urban,6,194,186,380,Kajiado,RIFT VALLEY,10748
LOITOKITOK,Urban,7,195,180,375,Kajiado,RIFT VALLEY,10749
LOITOKITOK,Urban,8,192,169,361,Kajiado,RIFT VALLEY,10750
LOITOKITOK,Urban,9,217,196,413,Kajiado,RIFT VALLEY,10751
LOITOKITOK,Urban,10,195,167,362,Kajiado,RIFT VALLEY,10752
LOITOKITOK,Urban,11,163,129,292,Kajiado,RIFT VALLEY,10753
LOITOKITOK,Urban,12,172,166,338,Kajiado,RIFT VALLEY,10754
LOITOKITOK,Urban,13,171,185,356,Kajiado,RIFT VALLEY,10755
LOITOKITOK,Urban,14,152,158,310,Kajiado,RIFT VALLEY,10756
LOITOKITOK,Urban,15,157,154,311,Kajiado,RIFT VALLEY,10757
LOITOKITOK,Urban,16,135,159,294,Kajiado,RIFT VALLEY,10758
LOITOKITOK,Urban,17,159,140,299,Kajiado,RIFT VALLEY,10759
LOITOKITOK,Urban,18,133,162,295,Kajiado,RIFT VALLEY,10760
LOITOKITOK,Urban,19,125,150,275,Kajiado,RIFT VALLEY,10761
LOITOKITOK,Urban,20,146,204,350,Kajiado,RIFT VALLEY,10762
LOITOKITOK,Urban,21,130,156,286,Kajiado,RIFT VALLEY,10763
LOITOKITOK,Urban,22,123,149,272,Kajiado,RIFT VALLEY,10764
LOITOKITOK,Urban,23,135,183,318,Kajiado,RIFT VALLEY,10765
LOITOKITOK,Urban,24,135,172,307,Kajiado,RIFT VALLEY,10766
LOITOKITOK,Urban,25,181,190,371,Kajiado,RIFT VALLEY,10767
LOITOKITOK,Urban,26,147,158,305,Kajiado,RIFT VALLEY,10768
LOITOKITOK,Urban,27,149,164,313,Kajiado,RIFT VALLEY,10769
LOITOKITOK,Urban,28,142,166,308,Kajiado,RIFT VALLEY,10770
LOITOKITOK,Urban,29,115,131,246,Kajiado,RIFT VALLEY,10771
LOITOKITOK,Urban,30,188,175,363,Kajiado,RIFT VALLEY,10772
LOITOKITOK,Urban,31,86,84,170,Kajiado,RIFT VALLEY,10773
LOITOKITOK,Urban,32,138,123,261,Kajiado,RIFT VALLEY,10774
LOITOKITOK,Urban,33,82,86,168,Kajiado,RIFT VALLEY,10775
LOITOKITOK,Urban,34,86,82,168,Kajiado,RIFT VALLEY,10776
LOITOKITOK,Urban,35,133,113,246,Kajiado,RIFT VALLEY,10777
LOITOKITOK,Urban,36,87,69,156,Kajiado,RIFT VALLEY,10778
LOITOKITOK,Urban,37,75,82,157,Kajiado,RIFT VALLEY,10779
LOITOKITOK,Urban,38,96,100,196,Kajiado,RIFT VALLEY,10780
LOITOKITOK,Urban,39,84,74,158,Kajiado,RIFT VALLEY,10781
LOITOKITOK,Urban,40,133,143,276,Kajiado,RIFT VALLEY,10782
LOITOKITOK,Urban,41,47,55,102,Kajiado,RIFT VALLEY,10783
LOITOKITOK,Urban,42,70,65,135,Kajiado,RIFT VALLEY,10784
LOITOKITOK,Urban,43,64,40,104,Kajiado,RIFT VALLEY,10785
LOITOKITOK,Urban,44,50,47,97,Kajiado,RIFT VALLEY,10786
LOITOKITOK,Urban,45,102,76,178,Kajiado,RIFT VALLEY,10787
LOITOKITOK,Urban,46,63,53,116,Kajiado,RIFT VALLEY,10788
LOITOKITOK,Urban,47,49,34,83,Kajiado,RIFT VALLEY,10789
LOITOKITOK,Urban,48,56,50,106,Kajiado,RIFT VALLEY,10790
LOITOKITOK,Urban,49,53,60,113,Kajiado,RIFT VALLEY,10791
LOITOKITOK,Urban,50,75,75,150,Kajiado,RIFT VALLEY,10792
LOITOKITOK,Urban,51,38,30,68,Kajiado,RIFT VALLEY,10793
LOITOKITOK,Urban,52,45,27,72,Kajiado,RIFT VALLEY,10794
LOITOKITOK,Urban,53,31,26,57,Kajiado,RIFT VALLEY,10795
LOITOKITOK,Urban,54,23,15,38,Kajiado,RIFT VALLEY,10796
LOITOKITOK,Urban,55,40,36,76,Kajiado,RIFT VALLEY,10797
LOITOKITOK,Urban,56,26,18,44,Kajiado,RIFT VALLEY,10798
LOITOKITOK,Urban,57,28,20,48,Kajiado,RIFT VALLEY,10799
LOITOKITOK,Urban,58,15,16,31,Kajiado,RIFT VALLEY,10800
LOITOKITOK,Urban,59,22,15,37,Kajiado,RIFT VALLEY,10801
LOITOKITOK,Urban,60,46,33,79,Kajiado,RIFT VALLEY,10802
LOITOKITOK,Urban,61,11,10,21,Kajiado,RIFT VALLEY,10803
LOITOKITOK,Urban,62,21,10,31,Kajiado,RIFT VALLEY,10804
LOITOKITOK,Urban,63,11,7,18,Kajiado,RIFT VALLEY,10805
LOITOKITOK,Urban,64,6,13,19,Kajiado,RIFT VALLEY,10806
LOITOKITOK,Urban,65,19,20,39,Kajiado,RIFT VALLEY,10807
LOITOKITOK,Urban,66,9,5,14,Kajiado,RIFT VALLEY,10808
LOITOKITOK,Urban,67,13,8,21,Kajiado,RIFT VALLEY,10809
LOITOKITOK,Urban,68,7,9,16,Kajiado,RIFT VALLEY,10810
LOITOKITOK,Urban,69,6,11,17,Kajiado,RIFT VALLEY,10811
LOITOKITOK,Urban,70,16,23,39,Kajiado,RIFT VALLEY,10812
LOITOKITOK,Urban,71,5,4,9,Kajiado,RIFT VALLEY,10813
LOITOKITOK,Urban,72,17,11,28,Kajiado,RIFT VALLEY,10814
LOITOKITOK,Urban,73,3,5,8,Kajiado,RIFT VALLEY,10815
LOITOKITOK,Urban,74,3,4,7,Kajiado,RIFT VALLEY,10816
LOITOKITOK,Urban,75,11,3,14,Kajiado,RIFT VALLEY,10817
LOITOKITOK,Urban,76,4,2,6,Kajiado,RIFT VALLEY,10818
LOITOKITOK,Urban,77,4,4,8,Kajiado,RIFT VALLEY,10819
LOITOKITOK,Urban,78,5,9,14,Kajiado,RIFT VALLEY,10820
LOITOKITOK,Urban,79,5,3,8,Kajiado,RIFT VALLEY,10821
LOITOKITOK,Urban,80+,42,49,91,Kajiado,RIFT VALLEY,10822
LOITOKITOK,Urban,Age NS,3,6,9,Kajiado,RIFT VALLEY,10823
KERICHO,Urban,0,2136,1973,4109,Kericho,RIFT VALLEY,10824
KERICHO,Urban,1,1726,1675,3401,Kericho,RIFT VALLEY,10825
KERICHO,Urban,2,2024,1928,3952,Kericho,RIFT VALLEY,10826
KERICHO,Urban,3,1866,1918,3784,Kericho,RIFT VALLEY,10827
KERICHO,Urban,4,1906,1883,3789,Kericho,RIFT VALLEY,10828
KERICHO,Urban,5,1851,1788,3639,Kericho,RIFT VALLEY,10829
KERICHO,Urban,6,1669,1620,3289,Kericho,RIFT VALLEY,10830
KERICHO,Urban,7,1689,1665,3354,Kericho,RIFT VALLEY,10831
KERICHO,Urban,8,1637,1654,3291,Kericho,RIFT VALLEY,10832
KERICHO,Urban,9,1747,1728,3475,Kericho,RIFT VALLEY,10833
KERICHO,Urban,10,1742,1767,3509,Kericho,RIFT VALLEY,10834
KERICHO,Urban,11,1396,1439,2835,Kericho,RIFT VALLEY,10835
KERICHO,Urban,12,1604,1706,3310,Kericho,RIFT VALLEY,10836
KERICHO,Urban,13,1544,1515,3059,Kericho,RIFT VALLEY,10837
KERICHO,Urban,14,1367,1451,2818,Kericho,RIFT VALLEY,10838
KERICHO,Urban,15,1339,1465,2804,Kericho,RIFT VALLEY,10839
KERICHO,Urban,16,1354,1440,2794,Kericho,RIFT VALLEY,10840
KERICHO,Urban,17,1539,1521,3060,Kericho,RIFT VALLEY,10841
KERICHO,Urban,18,1521,1583,3104,Kericho,RIFT VALLEY,10842
KERICHO,Urban,19,1291,1492,2783,Kericho,RIFT VALLEY,10843
KERICHO,Urban,20,1744,2239,3983,Kericho,RIFT VALLEY,10844
KERICHO,Urban,21,1336,1599,2935,Kericho,RIFT VALLEY,10845
KERICHO,Urban,22,1709,1992,3701,Kericho,RIFT VALLEY,10846
KERICHO,Urban,23,1578,1734,3312,Kericho,RIFT VALLEY,10847
KERICHO,Urban,24,1509,1700,3209,Kericho,RIFT VALLEY,10848
KERICHO,Urban,25,1934,2112,4046,Kericho,RIFT VALLEY,10849
KERICHO,Urban,26,1370,1391,2761,Kericho,RIFT VALLEY,10850
KERICHO,Urban,27,1522,1282,2804,Kericho,RIFT VALLEY,10851
KERICHO,Urban,28,1302,1228,2530,Kericho,RIFT VALLEY,10852
KERICHO,Urban,29,1276,1043,2319,Kericho,RIFT VALLEY,10853
KERICHO,Urban,30,1893,1537,3430,Kericho,RIFT VALLEY,10854
KERICHO,Urban,31,1092,780,1872,Kericho,RIFT VALLEY,10855
KERICHO,Urban,32,1165,922,2087,Kericho,RIFT VALLEY,10856
KERICHO,Urban,33,830,693,1523,Kericho,RIFT VALLEY,10857
KERICHO,Urban,34,831,680,1511,Kericho,RIFT VALLEY,10858
KERICHO,Urban,35,1487,1073,2560,Kericho,RIFT VALLEY,10859
KERICHO,Urban,36,716,585,1301,Kericho,RIFT VALLEY,10860
KERICHO,Urban,37,799,579,1378,Kericho,RIFT VALLEY,10861
KERICHO,Urban,38,620,582,1202,Kericho,RIFT VALLEY,10862
KERICHO,Urban,39,630,525,1155,Kericho,RIFT VALLEY,10863
KERICHO,Urban,40,961,880,1841,Kericho,RIFT VALLEY,10864
KERICHO,Urban,41,522,379,901,Kericho,RIFT VALLEY,10865
KERICHO,Urban,42,542,382,924,Kericho,RIFT VALLEY,10866
KERICHO,Urban,43,370,328,698,Kericho,RIFT VALLEY,10867
KERICHO,Urban,44,350,328,678,Kericho,RIFT VALLEY,10868
KERICHO,Urban,45,630,554,1184,Kericho,RIFT VALLEY,10869
KERICHO,Urban,46,409,382,791,Kericho,RIFT VALLEY,10870
KERICHO,Urban,47,456,341,797,Kericho,RIFT VALLEY,10871
KERICHO,Urban,48,552,458,1010,Kericho,RIFT VALLEY,10872
KERICHO,Urban,49,450,276,726,Kericho,RIFT VALLEY,10873
KERICHO,Urban,50,581,475,1056,Kericho,RIFT VALLEY,10874
KERICHO,Urban,51,316,259,575,Kericho,RIFT VALLEY,10875
KERICHO,Urban,52,333,208,541,Kericho,RIFT VALLEY,10876
KERICHO,Urban,53,276,212,488,Kericho,RIFT VALLEY,10877
KERICHO,Urban,54,239,197,436,Kericho,RIFT VALLEY,10878
KERICHO,Urban,55,349,319,668,Kericho,RIFT VALLEY,10879
KERICHO,Urban,56,227,135,362,Kericho,RIFT VALLEY,10880
KERICHO,Urban,57,276,192,468,Kericho,RIFT VALLEY,10881
KERICHO,Urban,58,124,110,234,Kericho,RIFT VALLEY,10882
KERICHO,Urban,59,214,154,368,Kericho,RIFT VALLEY,10883
KERICHO,Urban,60,310,265,575,Kericho,RIFT VALLEY,10884
KERICHO,Urban,61,195,104,299,Kericho,RIFT VALLEY,10885
KERICHO,Urban,62,145,92,237,Kericho,RIFT VALLEY,10886
KERICHO,Urban,63,114,87,201,Kericho,RIFT VALLEY,10887
KERICHO,Urban,64,142,102,244,Kericho,RIFT VALLEY,10888
KERICHO,Urban,65,135,139,274,Kericho,RIFT VALLEY,10889
KERICHO,Urban,66,71,55,126,Kericho,RIFT VALLEY,10890
KERICHO,Urban,67,102,79,181,Kericho,RIFT VALLEY,10891
KERICHO,Urban,68,55,49,104,Kericho,RIFT VALLEY,10892
KERICHO,Urban,69,76,120,196,Kericho,RIFT VALLEY,10893
KERICHO,Urban,70,147,155,302,Kericho,RIFT VALLEY,10894
KERICHO,Urban,71,63,51,114,Kericho,RIFT VALLEY,10895
KERICHO,Urban,72,62,57,119,Kericho,RIFT VALLEY,10896
KERICHO,Urban,73,54,54,108,Kericho,RIFT VALLEY,10897
KERICHO,Urban,74,50,49,99,Kericho,RIFT VALLEY,10898
KERICHO,Urban,75,63,75,138,Kericho,RIFT VALLEY,10899
KERICHO,Urban,76,36,44,80,Kericho,RIFT VALLEY,10900
KERICHO,Urban,77,36,29,65,Kericho,RIFT VALLEY,10901
KERICHO,Urban,78,40,42,82,Kericho,RIFT VALLEY,10902
KERICHO,Urban,79,41,81,122,Kericho,RIFT VALLEY,10903
KERICHO,Urban,80+,377,544,921,Kericho,RIFT VALLEY,10904
KERICHO,Urban,Age NS,29,22,51,Kericho,RIFT VALLEY,10905
KIPKELION,Urban,0,1599,1553,3152,Kericho,RIFT VALLEY,10906
KIPKELION,Urban,1,1470,1364,2834,Kericho,RIFT VALLEY,10907
KIPKELION,Urban,2,1566,1535,3101,Kericho,RIFT VALLEY,10908
KIPKELION,Urban,3,1550,1515,3065,Kericho,RIFT VALLEY,10909
KIPKELION,Urban,4,1623,1527,3150,Kericho,RIFT VALLEY,10910
KIPKELION,Urban,5,1546,1439,2985,Kericho,RIFT VALLEY,10911
KIPKELION,Urban,6,1471,1360,2831,Kericho,RIFT VALLEY,10912
KIPKELION,Urban,7,1404,1385,2789,Kericho,RIFT VALLEY,10913
KIPKELION,Urban,8,1417,1330,2747,Kericho,RIFT VALLEY,10914
KIPKELION,Urban,9,1553,1496,3049,Kericho,RIFT VALLEY,10915
KIPKELION,Urban,10,1463,1452,2915,Kericho,RIFT VALLEY,10916
KIPKELION,Urban,11,1125,1145,2270,Kericho,RIFT VALLEY,10917
KIPKELION,Urban,12,1434,1426,2860,Kericho,RIFT VALLEY,10918
KIPKELION,Urban,13,1282,1272,2554,Kericho,RIFT VALLEY,10919
KIPKELION,Urban,14,1159,1237,2396,Kericho,RIFT VALLEY,10920
KIPKELION,Urban,15,1122,1122,2244,Kericho,RIFT VALLEY,10921
KIPKELION,Urban,16,1128,1035,2163,Kericho,RIFT VALLEY,10922
KIPKELION,Urban,17,1204,1082,2286,Kericho,RIFT VALLEY,10923
KIPKELION,Urban,18,1005,990,1995,Kericho,RIFT VALLEY,10924
KIPKELION,Urban,19,986,963,1949,Kericho,RIFT VALLEY,10925
KIPKELION,Urban,20,1093,1242,2335,Kericho,RIFT VALLEY,10926
KIPKELION,Urban,21,789,894,1683,Kericho,RIFT VALLEY,10927
KIPKELION,Urban,22,901,1024,1925,Kericho,RIFT VALLEY,10928
KIPKELION,Urban,23,772,923,1695,Kericho,RIFT VALLEY,10929
KIPKELION,Urban,24,717,852,1569,Kericho,RIFT VALLEY,10930
KIPKELION,Urban,25,915,1013,1928,Kericho,RIFT VALLEY,10931
KIPKELION,Urban,26,660,637,1297,Kericho,RIFT VALLEY,10932
KIPKELION,Urban,27,718,716,1434,Kericho,RIFT VALLEY,10933
KIPKELION,Urban,28,497,595,1092,Kericho,RIFT VALLEY,10934
KIPKELION,Urban,29,534,555,1089,Kericho,RIFT VALLEY,10935
KIPKELION,Urban,30,774,824,1598,Kericho,RIFT VALLEY,10936
KIPKELION,Urban,31,578,494,1072,Kericho,RIFT VALLEY,10937
KIPKELION,Urban,32,501,554,1055,Kericho,RIFT VALLEY,10938
KIPKELION,Urban,33,367,409,776,Kericho,RIFT VALLEY,10939
KIPKELION,Urban,34,398,413,811,Kericho,RIFT VALLEY,10940
KIPKELION,Urban,35,707,699,1406,Kericho,RIFT VALLEY,10941
KIPKELION,Urban,36,379,365,744,Kericho,RIFT VALLEY,10942
KIPKELION,Urban,37,385,413,798,Kericho,RIFT VALLEY,10943
KIPKELION,Urban,38,313,332,645,Kericho,RIFT VALLEY,10944
KIPKELION,Urban,39,371,332,703,Kericho,RIFT VALLEY,10945
KIPKELION,Urban,40,470,513,983,Kericho,RIFT VALLEY,10946
KIPKELION,Urban,41,283,254,537,Kericho,RIFT VALLEY,10947
KIPKELION,Urban,42,268,290,558,Kericho,RIFT VALLEY,10948
KIPKELION,Urban,43,195,249,444,Kericho,RIFT VALLEY,10949
KIPKELION,Urban,44,203,186,389,Kericho,RIFT VALLEY,10950
KIPKELION,Urban,45,387,395,782,Kericho,RIFT VALLEY,10951
KIPKELION,Urban,46,249,267,516,Kericho,RIFT VALLEY,10952
KIPKELION,Urban,47,220,287,507,Kericho,RIFT VALLEY,10953
KIPKELION,Urban,48,298,453,751,Kericho,RIFT VALLEY,10954
KIPKELION,Urban,49,243,245,488,Kericho,RIFT VALLEY,10955
KIPKELION,Urban,50,322,406,728,Kericho,RIFT VALLEY,10956
KIPKELION,Urban,51,219,194,413,Kericho,RIFT VALLEY,10957
KIPKELION,Urban,52,213,179,392,Kericho,RIFT VALLEY,10958
KIPKELION,Urban,53,186,161,347,Kericho,RIFT VALLEY,10959
KIPKELION,Urban,54,169,166,335,Kericho,RIFT VALLEY,10960
KIPKELION,Urban,55,239,263,502,Kericho,RIFT VALLEY,10961
KIPKELION,Urban,56,167,146,313,Kericho,RIFT VALLEY,10962
KIPKELION,Urban,57,194,197,391,Kericho,RIFT VALLEY,10963
KIPKELION,Urban,58,115,113,228,Kericho,RIFT VALLEY,10964
KIPKELION,Urban,59,137,123,260,Kericho,RIFT VALLEY,10965
KIPKELION,Urban,60,242,271,513,Kericho,RIFT VALLEY,10966
KIPKELION,Urban,61,153,137,290,Kericho,RIFT VALLEY,10967
KIPKELION,Urban,62,122,79,201,Kericho,RIFT VALLEY,10968
KIPKELION,Urban,63,104,85,189,Kericho,RIFT VALLEY,10969
KIPKELION,Urban,64,97,102,199,Kericho,RIFT VALLEY,10970
KIPKELION,Urban,65,126,148,274,Kericho,RIFT VALLEY,10971
KIPKELION,Urban,66,53,71,124,Kericho,RIFT VALLEY,10972
KIPKELION,Urban,67,82,64,146,Kericho,RIFT VALLEY,10973
KIPKELION,Urban,68,55,65,120,Kericho,RIFT VALLEY,10974
KIPKELION,Urban,69,71,109,180,Kericho,RIFT VALLEY,10975
KIPKELION,Urban,70,105,167,272,Kericho,RIFT VALLEY,10976
KIPKELION,Urban,71,59,49,108,Kericho,RIFT VALLEY,10977
KIPKELION,Urban,72,59,52,111,Kericho,RIFT VALLEY,10978
KIPKELION,Urban,73,66,54,120,Kericho,RIFT VALLEY,10979
KIPKELION,Urban,74,65,59,124,Kericho,RIFT VALLEY,10980
KIPKELION,Urban,75,57,72,129,Kericho,RIFT VALLEY,10981
KIPKELION,Urban,76,34,35,69,Kericho,RIFT VALLEY,10982
KIPKELION,Urban,77,47,37,84,Kericho,RIFT VALLEY,10983
KIPKELION,Urban,78,41,37,78,Kericho,RIFT VALLEY,10984
KIPKELION,Urban,79,48,61,109,Kericho,RIFT VALLEY,10985
KIPKELION,Urban,80+,377,475,852,Kericho,RIFT VALLEY,10986
KIPKELION,Urban,Age NS,7,3,10,Kericho,RIFT VALLEY,10987
BURET,Urban,0,417,374,791,Bomet,RIFT VALLEY,10988
BURET,Urban,1,377,347,724,Bomet,RIFT VALLEY,10989
BURET,Urban,2,409,387,796,Bomet,RIFT VALLEY,10990
BURET,Urban,3,403,380,783,Bomet,RIFT VALLEY,10991
BURET,Urban,4,389,411,800,Bomet,RIFT VALLEY,10992
BURET,Urban,5,359,336,695,Bomet,RIFT VALLEY,10993
BURET,Urban,6,365,357,722,Bomet,RIFT VALLEY,10994
BURET,Urban,7,382,362,744,Bomet,RIFT VALLEY,10995
BURET,Urban,8,332,344,676,Bomet,RIFT VALLEY,10996
BURET,Urban,9,343,400,743,Bomet,RIFT VALLEY,10997
BURET,Urban,10,316,358,674,Bomet,RIFT VALLEY,10998
BURET,Urban,11,257,296,553,Bomet,RIFT VALLEY,10999
BURET,Urban,12,324,339,663,Bomet,RIFT VALLEY,11000
BURET,Urban,13,273,287,560,Bomet,RIFT VALLEY,11001
BURET,Urban,14,271,259,530,Bomet,RIFT VALLEY,11002
BURET,Urban,15,221,281,502,Bomet,RIFT VALLEY,11003
BURET,Urban,16,243,355,598,Bomet,RIFT VALLEY,11004
BURET,Urban,17,251,334,585,Bomet,RIFT VALLEY,11005
BURET,Urban,18,254,298,552,Bomet,RIFT VALLEY,11006
BURET,Urban,19,266,289,555,Bomet,RIFT VALLEY,11007
BURET,Urban,20,283,473,756,Bomet,RIFT VALLEY,11008
BURET,Urban,21,235,320,555,Bomet,RIFT VALLEY,11009
BURET,Urban,22,269,356,625,Bomet,RIFT VALLEY,11010
BURET,Urban,23,257,343,600,Bomet,RIFT VALLEY,11011
BURET,Urban,24,259,286,545,Bomet,RIFT VALLEY,11012
BURET,Urban,25,342,360,702,Bomet,RIFT VALLEY,11013
BURET,Urban,26,252,246,498,Bomet,RIFT VALLEY,11014
BURET,Urban,27,261,231,492,Bomet,RIFT VALLEY,11015
BURET,Urban,28,210,225,435,Bomet,RIFT VALLEY,11016
BURET,Urban,29,207,171,378,Bomet,RIFT VALLEY,11017
BURET,Urban,30,297,273,570,Bomet,RIFT VALLEY,11018
BURET,Urban,31,186,128,314,Bomet,RIFT VALLEY,11019
BURET,Urban,32,196,147,343,Bomet,RIFT VALLEY,11020
BURET,Urban,33,120,123,243,Bomet,RIFT VALLEY,11021
BURET,Urban,34,147,124,271,Bomet,RIFT VALLEY,11022
BURET,Urban,35,243,210,453,Bomet,RIFT VALLEY,11023
BURET,Urban,36,114,119,233,Bomet,RIFT VALLEY,11024
BURET,Urban,37,137,124,261,Bomet,RIFT VALLEY,11025
BURET,Urban,38,108,113,221,Bomet,RIFT VALLEY,11026
BURET,Urban,39,99,92,191,Bomet,RIFT VALLEY,11027
BURET,Urban,40,169,157,326,Bomet,RIFT VALLEY,11028
BURET,Urban,41,100,68,168,Bomet,RIFT VALLEY,11029
BURET,Urban,42,79,56,135,Bomet,RIFT VALLEY,11030
BURET,Urban,43,42,52,94,Bomet,RIFT VALLEY,11031
BURET,Urban,44,42,48,90,Bomet,RIFT VALLEY,11032
BURET,Urban,45,102,108,210,Bomet,RIFT VALLEY,11033
BURET,Urban,46,61,54,115,Bomet,RIFT VALLEY,11034
BURET,Urban,47,66,57,123,Bomet,RIFT VALLEY,11035
BURET,Urban,48,79,109,188,Bomet,RIFT VALLEY,11036
BURET,Urban,49,66,40,106,Bomet,RIFT VALLEY,11037
BURET,Urban,50,107,75,182,Bomet,RIFT VALLEY,11038
BURET,Urban,51,67,34,101,Bomet,RIFT VALLEY,11039
BURET,Urban,52,52,48,100,Bomet,RIFT VALLEY,11040
BURET,Urban,53,44,39,83,Bomet,RIFT VALLEY,11041
BURET,Urban,54,39,35,74,Bomet,RIFT VALLEY,11042
BURET,Urban,55,67,46,113,Bomet,RIFT VALLEY,11043
BURET,Urban,56,35,32,67,Bomet,RIFT VALLEY,11044
BURET,Urban,57,49,48,97,Bomet,RIFT VALLEY,11045
BURET,Urban,58,30,19,49,Bomet,RIFT VALLEY,11046
BURET,Urban,59,34,33,67,Bomet,RIFT VALLEY,11047
BURET,Urban,60,43,48,91,Bomet,RIFT VALLEY,11048
BURET,Urban,61,37,26,63,Bomet,RIFT VALLEY,11049
BURET,Urban,62,23,20,43,Bomet,RIFT VALLEY,11050
BURET,Urban,63,31,17,48,Bomet,RIFT VALLEY,11051
BURET,Urban,64,15,19,34,Bomet,RIFT VALLEY,11052
BURET,Urban,65,30,28,58,Bomet,RIFT VALLEY,11053
BURET,Urban,66,11,17,28,Bomet,RIFT VALLEY,11054
BURET,Urban,67,28,8,36,Bomet,RIFT VALLEY,11055
BURET,Urban,68,8,14,22,Bomet,RIFT VALLEY,11056
BURET,Urban,69,24,20,44,Bomet,RIFT VALLEY,11057
BURET,Urban,70,34,36,70,Bomet,RIFT VALLEY,11058
BURET,Urban,71,10,9,19,Bomet,RIFT VALLEY,11059
BURET,Urban,72,7,10,17,Bomet,RIFT VALLEY,11060
BURET,Urban,73,14,10,24,Bomet,RIFT VALLEY,11061
BURET,Urban,74,8,15,23,Bomet,RIFT VALLEY,11062
BURET,Urban,75,8,18,26,Bomet,RIFT VALLEY,11063
BURET,Urban,76,9,10,19,Bomet,RIFT VALLEY,11064
BURET,Urban,77,7,9,16,Bomet,RIFT VALLEY,11065
BURET,Urban,78,12,11,23,Bomet,RIFT VALLEY,11066
BURET,Urban,79,5,12,17,Bomet,RIFT VALLEY,11067
BURET,Urban,80+,84,143,227,Bomet,RIFT VALLEY,11068
BURET,Urban,Age NS,6,8,14,Bomet,RIFT VALLEY,11069
SOTIK,Urban,0,153,141,294,Bomet,RIFT VALLEY,11070
SOTIK,Urban,1,98,101,199,Bomet,RIFT VALLEY,11071
SOTIK,Urban,2,105,122,227,Bomet,RIFT VALLEY,11072
SOTIK,Urban,3,105,119,224,Bomet,RIFT VALLEY,11073
SOTIK,Urban,4,99,120,219,Bomet,RIFT VALLEY,11074
SOTIK,Urban,5,98,115,213,Bomet,RIFT VALLEY,11075
SOTIK,Urban,6,99,104,203,Bomet,RIFT VALLEY,11076
SOTIK,Urban,7,112,94,206,Bomet,RIFT VALLEY,11077
SOTIK,Urban,8,92,99,191,Bomet,RIFT VALLEY,11078
SOTIK,Urban,9,96,116,212,Bomet,RIFT VALLEY,11079
SOTIK,Urban,10,118,113,231,Bomet,RIFT VALLEY,11080
SOTIK,Urban,11,89,89,178,Bomet,RIFT VALLEY,11081
SOTIK,Urban,12,113,117,230,Bomet,RIFT VALLEY,11082
SOTIK,Urban,13,106,81,187,Bomet,RIFT VALLEY,11083
SOTIK,Urban,14,79,87,166,Bomet,RIFT VALLEY,11084
SOTIK,Urban,15,94,91,185,Bomet,RIFT VALLEY,11085
SOTIK,Urban,16,79,84,163,Bomet,RIFT VALLEY,11086
SOTIK,Urban,17,75,89,164,Bomet,RIFT VALLEY,11087
SOTIK,Urban,18,89,74,163,Bomet,RIFT VALLEY,11088
SOTIK,Urban,19,85,83,168,Bomet,RIFT VALLEY,11089
SOTIK,Urban,20,111,168,279,Bomet,RIFT VALLEY,11090
SOTIK,Urban,21,90,89,179,Bomet,RIFT VALLEY,11091
SOTIK,Urban,22,127,140,267,Bomet,RIFT VALLEY,11092
SOTIK,Urban,23,98,129,227,Bomet,RIFT VALLEY,11093
SOTIK,Urban,24,85,116,201,Bomet,RIFT VALLEY,11094
SOTIK,Urban,25,135,143,278,Bomet,RIFT VALLEY,11095
SOTIK,Urban,26,89,85,174,Bomet,RIFT VALLEY,11096
SOTIK,Urban,27,118,87,205,Bomet,RIFT VALLEY,11097
SOTIK,Urban,28,100,89,189,Bomet,RIFT VALLEY,11098
SOTIK,Urban,29,80,46,126,Bomet,RIFT VALLEY,11099
SOTIK,Urban,30,128,115,243,Bomet,RIFT VALLEY,11100
SOTIK,Urban,31,64,35,99,Bomet,RIFT VALLEY,11101
SOTIK,Urban,32,97,51,148,Bomet,RIFT VALLEY,11102
SOTIK,Urban,33,75,30,105,Bomet,RIFT VALLEY,11103
SOTIK,Urban,34,52,30,82,Bomet,RIFT VALLEY,11104
SOTIK,Urban,35,104,68,172,Bomet,RIFT VALLEY,11105
SOTIK,Urban,36,48,41,89,Bomet,RIFT VALLEY,11106
SOTIK,Urban,37,48,42,90,Bomet,RIFT VALLEY,11107
SOTIK,Urban,38,30,38,68,Bomet,RIFT VALLEY,11108
SOTIK,Urban,39,42,32,74,Bomet,RIFT VALLEY,11109
SOTIK,Urban,40,52,38,90,Bomet,RIFT VALLEY,11110
SOTIK,Urban,41,30,14,44,Bomet,RIFT VALLEY,11111
SOTIK,Urban,42,42,35,77,Bomet,RIFT VALLEY,11112
SOTIK,Urban,43,24,19,43,Bomet,RIFT VALLEY,11113
SOTIK,Urban,44,18,17,35,Bomet,RIFT VALLEY,11114
SOTIK,Urban,45,34,30,64,Bomet,RIFT VALLEY,11115
SOTIK,Urban,46,38,23,61,Bomet,RIFT VALLEY,11116
SOTIK,Urban,47,28,20,48,Bomet,RIFT VALLEY,11117
SOTIK,Urban,48,39,18,57,Bomet,RIFT VALLEY,11118
SOTIK,Urban,49,28,14,42,Bomet,RIFT VALLEY,11119
SOTIK,Urban,50,33,26,59,Bomet,RIFT VALLEY,11120
SOTIK,Urban,51,13,9,22,Bomet,RIFT VALLEY,11121
SOTIK,Urban,52,20,11,31,Bomet,RIFT VALLEY,11122
SOTIK,Urban,53,11,9,20,Bomet,RIFT VALLEY,11123
SOTIK,Urban,54,20,8,28,Bomet,RIFT VALLEY,11124
SOTIK,Urban,55,28,13,41,Bomet,RIFT VALLEY,11125
SOTIK,Urban,56,14,12,26,Bomet,RIFT VALLEY,11126
SOTIK,Urban,57,12,3,15,Bomet,RIFT VALLEY,11127
SOTIK,Urban,58,5,3,8,Bomet,RIFT VALLEY,11128
SOTIK,Urban,59,7,6,13,Bomet,RIFT VALLEY,11129
SOTIK,Urban,60,15,13,28,Bomet,RIFT VALLEY,11130
SOTIK,Urban,61,10,7,17,Bomet,RIFT VALLEY,11131
SOTIK,Urban,62,6,2,8,Bomet,RIFT VALLEY,11132
SOTIK,Urban,63,6,5,11,Bomet,RIFT VALLEY,11133
SOTIK,Urban,64,9,3,12,Bomet,RIFT VALLEY,11134
SOTIK,Urban,65,11,2,13,Bomet,RIFT VALLEY,11135
SOTIK,Urban,66,3,0,3,Bomet,RIFT VALLEY,11136
SOTIK,Urban,67,10,1,11,Bomet,RIFT VALLEY,11137
SOTIK,Urban,68,6,6,12,Bomet,RIFT VALLEY,11138
SOTIK,Urban,69,3,2,5,Bomet,RIFT VALLEY,11139
SOTIK,Urban,70,4,4,8,Bomet,RIFT VALLEY,11140
SOTIK,Urban,71,5,2,7,Bomet,RIFT VALLEY,11141
SOTIK,Urban,72,3,5,8,Bomet,RIFT VALLEY,11142
SOTIK,Urban,73,2,1,3,Bomet,RIFT VALLEY,11143
SOTIK,Urban,74,2,1,3,Bomet,RIFT VALLEY,11144
SOTIK,Urban,75,2,0,2,Bomet,RIFT VALLEY,11145
SOTIK,Urban,76,1,2,3,Bomet,RIFT VALLEY,11146
SOTIK,Urban,77,4,1,5,Bomet,RIFT VALLEY,11147
SOTIK,Urban,78,5,4,9,Bomet,RIFT VALLEY,11148
SOTIK,Urban,79,3,1,4,Bomet,RIFT VALLEY,11149
SOTIK,Urban,80+,20,24,44,Bomet,RIFT VALLEY,11150
SOTIK,Urban,Age NS,6,2,8,Bomet,RIFT VALLEY,11151
BOMET,Urban,0,1664,1608,3272,Bomet,RIFT VALLEY,11152
BOMET,Urban,1,1500,1353,2853,Bomet,RIFT VALLEY,11153
BOMET,Urban,2,1589,1512,3101,Bomet,RIFT VALLEY,11154
BOMET,Urban,3,1648,1488,3136,Bomet,RIFT VALLEY,11155
BOMET,Urban,4,1550,1557,3107,Bomet,RIFT VALLEY,11156
BOMET,Urban,5,1601,1597,3198,Bomet,RIFT VALLEY,11157
BOMET,Urban,6,1575,1513,3088,Bomet,RIFT VALLEY,11158
BOMET,Urban,7,1457,1397,2854,Bomet,RIFT VALLEY,11159
BOMET,Urban,8,1434,1367,2801,Bomet,RIFT VALLEY,11160
BOMET,Urban,9,1508,1518,3026,Bomet,RIFT VALLEY,11161
BOMET,Urban,10,1525,1433,2958,Bomet,RIFT VALLEY,11162
BOMET,Urban,11,1240,1157,2397,Bomet,RIFT VALLEY,11163
BOMET,Urban,12,1487,1448,2935,Bomet,RIFT VALLEY,11164
BOMET,Urban,13,1301,1485,2786,Bomet,RIFT VALLEY,11165
BOMET,Urban,14,1279,1397,2676,Bomet,RIFT VALLEY,11166
BOMET,Urban,15,1210,1142,2352,Bomet,RIFT VALLEY,11167
BOMET,Urban,16,1116,1161,2277,Bomet,RIFT VALLEY,11168
BOMET,Urban,17,1135,1144,2279,Bomet,RIFT VALLEY,11169
BOMET,Urban,18,1065,1076,2141,Bomet,RIFT VALLEY,11170
BOMET,Urban,19,1008,1050,2058,Bomet,RIFT VALLEY,11171
BOMET,Urban,20,1125,1466,2591,Bomet,RIFT VALLEY,11172
BOMET,Urban,21,895,992,1887,Bomet,RIFT VALLEY,11173
BOMET,Urban,22,1011,1146,2157,Bomet,RIFT VALLEY,11174
BOMET,Urban,23,928,1081,2009,Bomet,RIFT VALLEY,11175
BOMET,Urban,24,825,963,1788,Bomet,RIFT VALLEY,11176
BOMET,Urban,25,1045,1150,2195,Bomet,RIFT VALLEY,11177
BOMET,Urban,26,726,758,1484,Bomet,RIFT VALLEY,11178
BOMET,Urban,27,795,773,1568,Bomet,RIFT VALLEY,11179
BOMET,Urban,28,597,613,1210,Bomet,RIFT VALLEY,11180
BOMET,Urban,29,615,616,1231,Bomet,RIFT VALLEY,11181
BOMET,Urban,30,869,880,1749,Bomet,RIFT VALLEY,11182
BOMET,Urban,31,607,567,1174,Bomet,RIFT VALLEY,11183
BOMET,Urban,32,537,523,1060,Bomet,RIFT VALLEY,11184
BOMET,Urban,33,488,472,960,Bomet,RIFT VALLEY,11185
BOMET,Urban,34,461,479,940,Bomet,RIFT VALLEY,11186
BOMET,Urban,35,789,711,1500,Bomet,RIFT VALLEY,11187
BOMET,Urban,36,431,399,830,Bomet,RIFT VALLEY,11188
BOMET,Urban,37,468,444,912,Bomet,RIFT VALLEY,11189
BOMET,Urban,38,332,333,665,Bomet,RIFT VALLEY,11190
BOMET,Urban,39,362,355,717,Bomet,RIFT VALLEY,11191
BOMET,Urban,40,557,548,1105,Bomet,RIFT VALLEY,11192
BOMET,Urban,41,331,362,693,Bomet,RIFT VALLEY,11193
BOMET,Urban,42,282,263,545,Bomet,RIFT VALLEY,11194
BOMET,Urban,43,210,186,396,Bomet,RIFT VALLEY,11195
BOMET,Urban,44,198,263,461,Bomet,RIFT VALLEY,11196
BOMET,Urban,45,318,333,651,Bomet,RIFT VALLEY,11197
BOMET,Urban,46,242,270,512,Bomet,RIFT VALLEY,11198
BOMET,Urban,47,289,316,605,Bomet,RIFT VALLEY,11199
BOMET,Urban,48,352,437,789,Bomet,RIFT VALLEY,11200
BOMET,Urban,49,264,189,453,Bomet,RIFT VALLEY,11201
BOMET,Urban,50,346,326,672,Bomet,RIFT VALLEY,11202
BOMET,Urban,51,204,201,405,Bomet,RIFT VALLEY,11203
BOMET,Urban,52,198,173,371,Bomet,RIFT VALLEY,11204
BOMET,Urban,53,207,184,391,Bomet,RIFT VALLEY,11205
BOMET,Urban,54,160,149,309,Bomet,RIFT VALLEY,11206
BOMET,Urban,55,249,209,458,Bomet,RIFT VALLEY,11207
BOMET,Urban,56,163,123,286,Bomet,RIFT VALLEY,11208
BOMET,Urban,57,235,220,455,Bomet,RIFT VALLEY,11209
BOMET,Urban,58,86,81,167,Bomet,RIFT VALLEY,11210
BOMET,Urban,59,126,129,255,Bomet,RIFT VALLEY,11211
BOMET,Urban,60,223,228,451,Bomet,RIFT VALLEY,11212
BOMET,Urban,61,180,124,304,Bomet,RIFT VALLEY,11213
BOMET,Urban,62,90,80,170,Bomet,RIFT VALLEY,11214
BOMET,Urban,63,108,90,198,Bomet,RIFT VALLEY,11215
BOMET,Urban,64,90,112,202,Bomet,RIFT VALLEY,11216
BOMET,Urban,65,91,121,212,Bomet,RIFT VALLEY,11217
BOMET,Urban,66,70,52,122,Bomet,RIFT VALLEY,11218
BOMET,Urban,67,96,71,167,Bomet,RIFT VALLEY,11219
BOMET,Urban,68,41,49,90,Bomet,RIFT VALLEY,11220
BOMET,Urban,69,75,95,170,Bomet,RIFT VALLEY,11221
BOMET,Urban,70,116,163,279,Bomet,RIFT VALLEY,11222
BOMET,Urban,71,46,64,110,Bomet,RIFT VALLEY,11223
BOMET,Urban,72,47,59,106,Bomet,RIFT VALLEY,11224
BOMET,Urban,73,56,48,104,Bomet,RIFT VALLEY,11225
BOMET,Urban,74,58,79,137,Bomet,RIFT VALLEY,11226
BOMET,Urban,75,60,102,162,Bomet,RIFT VALLEY,11227
BOMET,Urban,76,42,45,87,Bomet,RIFT VALLEY,11228
BOMET,Urban,77,32,45,77,Bomet,RIFT VALLEY,11229
BOMET,Urban,78,36,45,81,Bomet,RIFT VALLEY,11230
BOMET,Urban,79,60,74,134,Bomet,RIFT VALLEY,11231
BOMET,Urban,80+,448,695,1143,Bomet,RIFT VALLEY,11232
BOMET,Urban,Age NS,57,43,100,Bomet,RIFT VALLEY,11233
KAJIADO NORTH,Urban,0,3953,3961,7914,Kajiado,RIFT VALLEY,11234
KAJIADO NORTH,Urban,1,2953,2967,5920,Kajiado,RIFT VALLEY,11235
KAJIADO NORTH,Urban,2,3172,3080,6252,Kajiado,RIFT VALLEY,11236
KAJIADO NORTH,Urban,3,3140,3181,6321,Kajiado,RIFT VALLEY,11237
KAJIADO NORTH,Urban,4,2929,2866,5795,Kajiado,RIFT VALLEY,11238
KAJIADO NORTH,Urban,5,2775,2705,5480,Kajiado,RIFT VALLEY,11239
KAJIADO NORTH,Urban,6,2467,2521,4988,Kajiado,RIFT VALLEY,11240
KAJIADO NORTH,Urban,7,2425,2251,4676,Kajiado,RIFT VALLEY,11241
KAJIADO NORTH,Urban,8,2166,2237,4403,Kajiado,RIFT VALLEY,11242
KAJIADO NORTH,Urban,9,2275,2431,4706,Kajiado,RIFT VALLEY,11243
KAJIADO NORTH,Urban,10,2240,2184,4424,Kajiado,RIFT VALLEY,11244
KAJIADO NORTH,Urban,11,1699,1837,3536,Kajiado,RIFT VALLEY,11245
KAJIADO NORTH,Urban,12,1991,2013,4004,Kajiado,RIFT VALLEY,11246
KAJIADO NORTH,Urban,13,1746,2003,3749,Kajiado,RIFT VALLEY,11247
KAJIADO NORTH,Urban,14,1504,1752,3256,Kajiado,RIFT VALLEY,11248
KAJIADO NORTH,Urban,15,1519,1854,3373,Kajiado,RIFT VALLEY,11249
KAJIADO NORTH,Urban,16,1565,2016,3581,Kajiado,RIFT VALLEY,11250
KAJIADO NORTH,Urban,17,1709,2179,3888,Kajiado,RIFT VALLEY,11251
KAJIADO NORTH,Urban,18,1824,2669,4493,Kajiado,RIFT VALLEY,11252
KAJIADO NORTH,Urban,19,1885,2783,4668,Kajiado,RIFT VALLEY,11253
KAJIADO NORTH,Urban,20,2628,4171,6799,Kajiado,RIFT VALLEY,11254
KAJIADO NORTH,Urban,21,2444,3275,5719,Kajiado,RIFT VALLEY,11255
KAJIADO NORTH,Urban,22,3132,4350,7482,Kajiado,RIFT VALLEY,11256
KAJIADO NORTH,Urban,23,3256,4193,7449,Kajiado,RIFT VALLEY,11257
KAJIADO NORTH,Urban,24,3526,4161,7687,Kajiado,RIFT VALLEY,11258
KAJIADO NORTH,Urban,25,4225,4723,8948,Kajiado,RIFT VALLEY,11259
KAJIADO NORTH,Urban,26,3426,3583,7009,Kajiado,RIFT VALLEY,11260
KAJIADO NORTH,Urban,27,3592,3397,6989,Kajiado,RIFT VALLEY,11261
KAJIADO NORTH,Urban,28,3658,3548,7206,Kajiado,RIFT VALLEY,11262
KAJIADO NORTH,Urban,29,3059,2723,5782,Kajiado,RIFT VALLEY,11263
KAJIADO NORTH,Urban,30,4638,3749,8387,Kajiado,RIFT VALLEY,11264
KAJIADO NORTH,Urban,31,2177,1517,3694,Kajiado,RIFT VALLEY,11265
KAJIADO NORTH,Urban,32,2959,2388,5347,Kajiado,RIFT VALLEY,11266
KAJIADO NORTH,Urban,33,1853,1444,3297,Kajiado,RIFT VALLEY,11267
KAJIADO NORTH,Urban,34,2043,1522,3565,Kajiado,RIFT VALLEY,11268
KAJIADO NORTH,Urban,35,3300,2149,5449,Kajiado,RIFT VALLEY,11269
KAJIADO NORTH,Urban,36,1739,1363,3102,Kajiado,RIFT VALLEY,11270
KAJIADO NORTH,Urban,37,1592,1166,2758,Kajiado,RIFT VALLEY,11271
KAJIADO NORTH,Urban,38,1804,1421,3225,Kajiado,RIFT VALLEY,11272
KAJIADO NORTH,Urban,39,1436,1009,2445,Kajiado,RIFT VALLEY,11273
KAJIADO NORTH,Urban,40,2470,1559,4029,Kajiado,RIFT VALLEY,11274
KAJIADO NORTH,Urban,41,933,581,1514,Kajiado,RIFT VALLEY,11275
KAJIADO NORTH,Urban,42,1373,830,2203,Kajiado,RIFT VALLEY,11276
KAJIADO NORTH,Urban,43,919,634,1553,Kajiado,RIFT VALLEY,11277
KAJIADO NORTH,Urban,44,721,486,1207,Kajiado,RIFT VALLEY,11278
KAJIADO NORTH,Urban,45,1390,882,2272,Kajiado,RIFT VALLEY,11279
KAJIADO NORTH,Urban,46,795,541,1336,Kajiado,RIFT VALLEY,11280
KAJIADO NORTH,Urban,47,683,509,1192,Kajiado,RIFT VALLEY,11281
KAJIADO NORTH,Urban,48,682,523,1205,Kajiado,RIFT VALLEY,11282
KAJIADO NORTH,Urban,49,690,438,1128,Kajiado,RIFT VALLEY,11283
KAJIADO NORTH,Urban,50,915,691,1606,Kajiado,RIFT VALLEY,11284
KAJIADO NORTH,Urban,51,412,264,676,Kajiado,RIFT VALLEY,11285
KAJIADO NORTH,Urban,52,503,304,807,Kajiado,RIFT VALLEY,11286
KAJIADO NORTH,Urban,53,371,224,595,Kajiado,RIFT VALLEY,11287
KAJIADO NORTH,Urban,54,370,227,597,Kajiado,RIFT VALLEY,11288
KAJIADO NORTH,Urban,55,496,319,815,Kajiado,RIFT VALLEY,11289
KAJIADO NORTH,Urban,56,336,226,562,Kajiado,RIFT VALLEY,11290
KAJIADO NORTH,Urban,57,313,194,507,Kajiado,RIFT VALLEY,11291
KAJIADO NORTH,Urban,58,237,150,387,Kajiado,RIFT VALLEY,11292
KAJIADO NORTH,Urban,59,242,158,400,Kajiado,RIFT VALLEY,11293
KAJIADO NORTH,Urban,60,369,309,678,Kajiado,RIFT VALLEY,11294
KAJIADO NORTH,Urban,61,157,106,263,Kajiado,RIFT VALLEY,11295
KAJIADO NORTH,Urban,62,160,113,273,Kajiado,RIFT VALLEY,11296
KAJIADO NORTH,Urban,63,138,103,241,Kajiado,RIFT VALLEY,11297
KAJIADO NORTH,Urban,64,125,88,213,Kajiado,RIFT VALLEY,11298
KAJIADO NORTH,Urban,65,177,153,330,Kajiado,RIFT VALLEY,11299
KAJIADO NORTH,Urban,66,68,68,136,Kajiado,RIFT VALLEY,11300
KAJIADO NORTH,Urban,67,106,84,190,Kajiado,RIFT VALLEY,11301
KAJIADO NORTH,Urban,68,59,76,135,Kajiado,RIFT VALLEY,11302
KAJIADO NORTH,Urban,69,57,50,107,Kajiado,RIFT VALLEY,11303
KAJIADO NORTH,Urban,70,133,165,298,Kajiado,RIFT VALLEY,11304
KAJIADO NORTH,Urban,71,51,44,95,Kajiado,RIFT VALLEY,11305
KAJIADO NORTH,Urban,72,50,41,91,Kajiado,RIFT VALLEY,11306
KAJIADO NORTH,Urban,73,49,40,89,Kajiado,RIFT VALLEY,11307
KAJIADO NORTH,Urban,74,45,46,91,Kajiado,RIFT VALLEY,11308
KAJIADO NORTH,Urban,75,61,83,144,Kajiado,RIFT VALLEY,11309
KAJIADO NORTH,Urban,76,37,34,71,Kajiado,RIFT VALLEY,11310
KAJIADO NORTH,Urban,77,42,24,66,Kajiado,RIFT VALLEY,11311
KAJIADO NORTH,Urban,78,31,30,61,Kajiado,RIFT VALLEY,11312
KAJIADO NORTH,Urban,79,43,34,77,Kajiado,RIFT VALLEY,11313
KAJIADO NORTH,Urban,80+,280,465,745,Kajiado,RIFT VALLEY,11314
KAJIADO NORTH,Urban,Age NS,55,56,111,Kajiado,RIFT VALLEY,11315
KAKAMEGA CENTRAL,Urban,0,1421,1477,2898,Kakamega,WESTERN,11316
KAKAMEGA CENTRAL,Urban,1,1145,1198,2343,Kakamega,WESTERN,11317
KAKAMEGA CENTRAL,Urban,2,1261,1314,2575,Kakamega,WESTERN,11318
KAKAMEGA CENTRAL,Urban,3,1286,1151,2437,Kakamega,WESTERN,11319
KAKAMEGA CENTRAL,Urban,4,1187,1199,2386,Kakamega,WESTERN,11320
KAKAMEGA CENTRAL,Urban,5,1230,1124,2354,Kakamega,WESTERN,11321
KAKAMEGA CENTRAL,Urban,6,1024,1106,2130,Kakamega,WESTERN,11322
KAKAMEGA CENTRAL,Urban,7,1122,1029,2151,Kakamega,WESTERN,11323
KAKAMEGA CENTRAL,Urban,8,967,1108,2075,Kakamega,WESTERN,11324
KAKAMEGA CENTRAL,Urban,9,1138,1136,2274,Kakamega,WESTERN,11325
KAKAMEGA CENTRAL,Urban,10,1176,1182,2358,Kakamega,WESTERN,11326
KAKAMEGA CENTRAL,Urban,11,845,956,1801,Kakamega,WESTERN,11327
KAKAMEGA CENTRAL,Urban,12,1106,1288,2394,Kakamega,WESTERN,11328
KAKAMEGA CENTRAL,Urban,13,1084,1066,2150,Kakamega,WESTERN,11329
KAKAMEGA CENTRAL,Urban,14,981,1007,1988,Kakamega,WESTERN,11330
KAKAMEGA CENTRAL,Urban,15,959,1064,2023,Kakamega,WESTERN,11331
KAKAMEGA CENTRAL,Urban,16,979,1107,2086,Kakamega,WESTERN,11332
KAKAMEGA CENTRAL,Urban,17,1196,1130,2326,Kakamega,WESTERN,11333
KAKAMEGA CENTRAL,Urban,18,1247,1197,2444,Kakamega,WESTERN,11334
KAKAMEGA CENTRAL,Urban,19,1093,1179,2272,Kakamega,WESTERN,11335
KAKAMEGA CENTRAL,Urban,20,1423,1571,2994,Kakamega,WESTERN,11336
KAKAMEGA CENTRAL,Urban,21,1057,1165,2222,Kakamega,WESTERN,11337
KAKAMEGA CENTRAL,Urban,22,1299,1384,2683,Kakamega,WESTERN,11338
KAKAMEGA CENTRAL,Urban,23,1209,1340,2549,Kakamega,WESTERN,11339
KAKAMEGA CENTRAL,Urban,24,1111,1159,2270,Kakamega,WESTERN,11340
KAKAMEGA CENTRAL,Urban,25,1313,1236,2549,Kakamega,WESTERN,11341
KAKAMEGA CENTRAL,Urban,26,970,907,1877,Kakamega,WESTERN,11342
KAKAMEGA CENTRAL,Urban,27,1015,864,1879,Kakamega,WESTERN,11343
KAKAMEGA CENTRAL,Urban,28,937,869,1806,Kakamega,WESTERN,11344
KAKAMEGA CENTRAL,Urban,29,797,670,1467,Kakamega,WESTERN,11345
KAKAMEGA CENTRAL,Urban,30,1126,1035,2161,Kakamega,WESTERN,11346
KAKAMEGA CENTRAL,Urban,31,628,478,1106,Kakamega,WESTERN,11347
KAKAMEGA CENTRAL,Urban,32,882,730,1612,Kakamega,WESTERN,11348
KAKAMEGA CENTRAL,Urban,33,578,491,1069,Kakamega,WESTERN,11349
KAKAMEGA CENTRAL,Urban,34,587,527,1114,Kakamega,WESTERN,11350
KAKAMEGA CENTRAL,Urban,35,858,693,1551,Kakamega,WESTERN,11351
KAKAMEGA CENTRAL,Urban,36,482,458,940,Kakamega,WESTERN,11352
KAKAMEGA CENTRAL,Urban,37,474,380,854,Kakamega,WESTERN,11353
KAKAMEGA CENTRAL,Urban,38,525,503,1028,Kakamega,WESTERN,11354
KAKAMEGA CENTRAL,Urban,39,417,388,805,Kakamega,WESTERN,11355
KAKAMEGA CENTRAL,Urban,40,719,677,1396,Kakamega,WESTERN,11356
KAKAMEGA CENTRAL,Urban,41,310,287,597,Kakamega,WESTERN,11357
KAKAMEGA CENTRAL,Urban,42,420,394,814,Kakamega,WESTERN,11358
KAKAMEGA CENTRAL,Urban,43,338,289,627,Kakamega,WESTERN,11359
KAKAMEGA CENTRAL,Urban,44,278,264,542,Kakamega,WESTERN,11360
KAKAMEGA CENTRAL,Urban,45,491,439,930,Kakamega,WESTERN,11361
KAKAMEGA CENTRAL,Urban,46,305,299,604,Kakamega,WESTERN,11362
KAKAMEGA CENTRAL,Urban,47,321,267,588,Kakamega,WESTERN,11363
KAKAMEGA CENTRAL,Urban,48,321,294,615,Kakamega,WESTERN,11364
KAKAMEGA CENTRAL,Urban,49,301,278,579,Kakamega,WESTERN,11365
KAKAMEGA CENTRAL,Urban,50,387,392,779,Kakamega,WESTERN,11366
KAKAMEGA CENTRAL,Urban,51,209,182,391,Kakamega,WESTERN,11367
KAKAMEGA CENTRAL,Urban,52,215,185,400,Kakamega,WESTERN,11368
KAKAMEGA CENTRAL,Urban,53,207,185,392,Kakamega,WESTERN,11369
KAKAMEGA CENTRAL,Urban,54,189,171,360,Kakamega,WESTERN,11370
KAKAMEGA CENTRAL,Urban,55,218,223,441,Kakamega,WESTERN,11371
KAKAMEGA CENTRAL,Urban,56,165,148,313,Kakamega,WESTERN,11372
KAKAMEGA CENTRAL,Urban,57,138,135,273,Kakamega,WESTERN,11373
KAKAMEGA CENTRAL,Urban,58,104,110,214,Kakamega,WESTERN,11374
KAKAMEGA CENTRAL,Urban,59,104,106,210,Kakamega,WESTERN,11375
KAKAMEGA CENTRAL,Urban,60,184,195,379,Kakamega,WESTERN,11376
KAKAMEGA CENTRAL,Urban,61,91,82,173,Kakamega,WESTERN,11377
KAKAMEGA CENTRAL,Urban,62,107,77,184,Kakamega,WESTERN,11378
KAKAMEGA CENTRAL,Urban,63,83,66,149,Kakamega,WESTERN,11379
KAKAMEGA CENTRAL,Urban,64,68,57,125,Kakamega,WESTERN,11380
KAKAMEGA CENTRAL,Urban,65,90,88,178,Kakamega,WESTERN,11381
KAKAMEGA CENTRAL,Urban,66,80,86,166,Kakamega,WESTERN,11382
KAKAMEGA CENTRAL,Urban,67,60,56,116,Kakamega,WESTERN,11383
KAKAMEGA CENTRAL,Urban,68,43,58,101,Kakamega,WESTERN,11384
KAKAMEGA CENTRAL,Urban,69,43,51,94,Kakamega,WESTERN,11385
KAKAMEGA CENTRAL,Urban,70,74,76,150,Kakamega,WESTERN,11386
KAKAMEGA CENTRAL,Urban,71,34,21,55,Kakamega,WESTERN,11387
KAKAMEGA CENTRAL,Urban,72,36,42,78,Kakamega,WESTERN,11388
KAKAMEGA CENTRAL,Urban,73,37,25,62,Kakamega,WESTERN,11389
KAKAMEGA CENTRAL,Urban,74,20,36,56,Kakamega,WESTERN,11390
KAKAMEGA CENTRAL,Urban,75,35,44,79,Kakamega,WESTERN,11391
KAKAMEGA CENTRAL,Urban,76,25,29,54,Kakamega,WESTERN,11392
KAKAMEGA CENTRAL,Urban,77,23,36,59,Kakamega,WESTERN,11393
KAKAMEGA CENTRAL,Urban,78,28,24,52,Kakamega,WESTERN,11394
KAKAMEGA CENTRAL,Urban,79,21,26,47,Kakamega,WESTERN,11395
KAKAMEGA CENTRAL,Urban,80+,156,237,393,Kakamega,WESTERN,11396
KAKAMEGA CENTRAL,Urban,Age NS,44,21,65,Kakamega,WESTERN,11397
KAKAMEGA SOUTH,Urban,0,0,0,0,Kakamega,WESTERN,11398
KAKAMEGA SOUTH,Urban,1,0,0,0,Kakamega,WESTERN,11399
KAKAMEGA SOUTH,Urban,2,0,0,0,Kakamega,WESTERN,11400
KAKAMEGA SOUTH,Urban,3,0,0,0,Kakamega,WESTERN,11401
KAKAMEGA SOUTH,Urban,4,0,0,0,Kakamega,WESTERN,11402
KAKAMEGA SOUTH,Urban,5,0,0,0,Kakamega,WESTERN,11403
KAKAMEGA SOUTH,Urban,6,0,0,0,Kakamega,WESTERN,11404
KAKAMEGA SOUTH,Urban,7,0,0,0,Kakamega,WESTERN,11405
KAKAMEGA SOUTH,Urban,8,0,0,0,Kakamega,WESTERN,11406
KAKAMEGA SOUTH,Urban,9,0,0,0,Kakamega,WESTERN,11407
KAKAMEGA SOUTH,Urban,10,0,0,0,Kakamega,WESTERN,11408
KAKAMEGA SOUTH,Urban,11,0,0,0,Kakamega,WESTERN,11409
KAKAMEGA SOUTH,Urban,12,0,0,0,Kakamega,WESTERN,11410
KAKAMEGA SOUTH,Urban,13,0,0,0,Kakamega,WESTERN,11411
KAKAMEGA SOUTH,Urban,14,0,0,0,Kakamega,WESTERN,11412
KAKAMEGA SOUTH,Urban,15,0,0,0,Kakamega,WESTERN,11413
KAKAMEGA SOUTH,Urban,16,0,0,0,Kakamega,WESTERN,11414
KAKAMEGA SOUTH,Urban,17,0,0,0,Kakamega,WESTERN,11415
KAKAMEGA SOUTH,Urban,18,0,0,0,Kakamega,WESTERN,11416
KAKAMEGA SOUTH,Urban,19,0,0,0,Kakamega,WESTERN,11417
KAKAMEGA SOUTH,Urban,20,0,0,0,Kakamega,WESTERN,11418
KAKAMEGA SOUTH,Urban,21,0,0,0,Kakamega,WESTERN,11419
KAKAMEGA SOUTH,Urban,22,0,0,0,Kakamega,WESTERN,11420
KAKAMEGA SOUTH,Urban,23,0,0,0,Kakamega,WESTERN,11421
KAKAMEGA SOUTH,Urban,24,0,0,0,Kakamega,WESTERN,11422
KAKAMEGA SOUTH,Urban,25,0,0,0,Kakamega,WESTERN,11423
KAKAMEGA SOUTH,Urban,26,0,0,0,Kakamega,WESTERN,11424
KAKAMEGA SOUTH,Urban,27,0,0,0,Kakamega,WESTERN,11425
KAKAMEGA SOUTH,Urban,28,0,0,0,Kakamega,WESTERN,11426
KAKAMEGA SOUTH,Urban,29,0,0,0,Kakamega,WESTERN,11427
KAKAMEGA SOUTH,Urban,30,0,0,0,Kakamega,WESTERN,11428
KAKAMEGA SOUTH,Urban,31,0,0,0,Kakamega,WESTERN,11429
KAKAMEGA SOUTH,Urban,32,0,0,0,Kakamega,WESTERN,11430
KAKAMEGA SOUTH,Urban,33,0,0,0,Kakamega,WESTERN,11431
KAKAMEGA SOUTH,Urban,34,0,0,0,Kakamega,WESTERN,11432
KAKAMEGA SOUTH,Urban,35,0,0,0,Kakamega,WESTERN,11433
KAKAMEGA SOUTH,Urban,36,0,0,0,Kakamega,WESTERN,11434
KAKAMEGA SOUTH,Urban,37,0,0,0,Kakamega,WESTERN,11435
KAKAMEGA SOUTH,Urban,38,0,0,0,Kakamega,WESTERN,11436
KAKAMEGA SOUTH,Urban,39,0,0,0,Kakamega,WESTERN,11437
KAKAMEGA SOUTH,Urban,40,0,0,0,Kakamega,WESTERN,11438
KAKAMEGA SOUTH,Urban,41,0,0,0,Kakamega,WESTERN,11439
KAKAMEGA SOUTH,Urban,42,0,0,0,Kakamega,WESTERN,11440
KAKAMEGA SOUTH,Urban,43,0,0,0,Kakamega,WESTERN,11441
KAKAMEGA SOUTH,Urban,44,0,0,0,Kakamega,WESTERN,11442
KAKAMEGA SOUTH,Urban,45,0,0,0,Kakamega,WESTERN,11443
KAKAMEGA SOUTH,Urban,46,0,0,0,Kakamega,WESTERN,11444
KAKAMEGA SOUTH,Urban,47,0,0,0,Kakamega,WESTERN,11445
KAKAMEGA SOUTH,Urban,48,0,0,0,Kakamega,WESTERN,11446
KAKAMEGA SOUTH,Urban,49,0,0,0,Kakamega,WESTERN,11447
KAKAMEGA SOUTH,Urban,50,0,0,0,Kakamega,WESTERN,11448
KAKAMEGA SOUTH,Urban,51,0,0,0,Kakamega,WESTERN,11449
KAKAMEGA SOUTH,Urban,52,0,0,0,Kakamega,WESTERN,11450
KAKAMEGA SOUTH,Urban,53,0,0,0,Kakamega,WESTERN,11451
KAKAMEGA SOUTH,Urban,54,0,0,0,Kakamega,WESTERN,11452
KAKAMEGA SOUTH,Urban,55,0,0,0,Kakamega,WESTERN,11453
KAKAMEGA SOUTH,Urban,56,0,0,0,Kakamega,WESTERN,11454
KAKAMEGA SOUTH,Urban,57,0,0,0,Kakamega,WESTERN,11455
KAKAMEGA SOUTH,Urban,58,0,0,0,Kakamega,WESTERN,11456
KAKAMEGA SOUTH,Urban,59,0,0,0,Kakamega,WESTERN,11457
KAKAMEGA SOUTH,Urban,60,0,0,0,Kakamega,WESTERN,11458
KAKAMEGA SOUTH,Urban,61,0,0,0,Kakamega,WESTERN,11459
KAKAMEGA SOUTH,Urban,62,0,0,0,Kakamega,WESTERN,11460
KAKAMEGA SOUTH,Urban,63,0,0,0,Kakamega,WESTERN,11461
KAKAMEGA SOUTH,Urban,64,0,0,0,Kakamega,WESTERN,11462
KAKAMEGA SOUTH,Urban,65,0,0,0,Kakamega,WESTERN,11463
KAKAMEGA SOUTH,Urban,66,0,0,0,Kakamega,WESTERN,11464
KAKAMEGA SOUTH,Urban,67,0,0,0,Kakamega,WESTERN,11465
KAKAMEGA SOUTH,Urban,68,0,0,0,Kakamega,WESTERN,11466
KAKAMEGA SOUTH,Urban,69,0,0,0,Kakamega,WESTERN,11467
KAKAMEGA SOUTH,Urban,70,0,0,0,Kakamega,WESTERN,11468
KAKAMEGA SOUTH,Urban,71,0,0,0,Kakamega,WESTERN,11469
KAKAMEGA SOUTH,Urban,72,0,0,0,Kakamega,WESTERN,11470
KAKAMEGA SOUTH,Urban,73,0,0,0,Kakamega,WESTERN,11471
KAKAMEGA SOUTH,Urban,74,0,0,0,Kakamega,WESTERN,11472
KAKAMEGA SOUTH,Urban,75,0,0,0,Kakamega,WESTERN,11473
KAKAMEGA SOUTH,Urban,76,0,0,0,Kakamega,WESTERN,11474
KAKAMEGA SOUTH,Urban,77,0,0,0,Kakamega,WESTERN,11475
KAKAMEGA SOUTH,Urban,78,0,0,0,Kakamega,WESTERN,11476
KAKAMEGA SOUTH,Urban,79,0,0,0,Kakamega,WESTERN,11477
KAKAMEGA SOUTH,Urban,80+,0,0,0,Kakamega,WESTERN,11478
KAKAMEGA SOUTH,Urban,Age NS,0,0,0,Kakamega,WESTERN,11479
KAKAMEGA NORTH,Urban,0,89,73,162,Kakamega,WESTERN,11480
KAKAMEGA NORTH,Urban,1,74,75,149,Kakamega,WESTERN,11481
KAKAMEGA NORTH,Urban,2,63,74,137,Kakamega,WESTERN,11482
KAKAMEGA NORTH,Urban,3,60,88,148,Kakamega,WESTERN,11483
KAKAMEGA NORTH,Urban,4,69,69,138,Kakamega,WESTERN,11484
KAKAMEGA NORTH,Urban,5,60,63,123,Kakamega,WESTERN,11485
KAKAMEGA NORTH,Urban,6,54,61,115,Kakamega,WESTERN,11486
KAKAMEGA NORTH,Urban,7,57,58,115,Kakamega,WESTERN,11487
KAKAMEGA NORTH,Urban,8,67,59,126,Kakamega,WESTERN,11488
KAKAMEGA NORTH,Urban,9,57,60,117,Kakamega,WESTERN,11489
KAKAMEGA NORTH,Urban,10,80,55,135,Kakamega,WESTERN,11490
KAKAMEGA NORTH,Urban,11,47,53,100,Kakamega,WESTERN,11491
KAKAMEGA NORTH,Urban,12,52,64,116,Kakamega,WESTERN,11492
KAKAMEGA NORTH,Urban,13,55,61,116,Kakamega,WESTERN,11493
KAKAMEGA NORTH,Urban,14,50,69,119,Kakamega,WESTERN,11494
KAKAMEGA NORTH,Urban,15,27,64,91,Kakamega,WESTERN,11495
KAKAMEGA NORTH,Urban,16,51,59,110,Kakamega,WESTERN,11496
KAKAMEGA NORTH,Urban,17,71,74,145,Kakamega,WESTERN,11497
KAKAMEGA NORTH,Urban,18,97,51,148,Kakamega,WESTERN,11498
KAKAMEGA NORTH,Urban,19,76,37,113,Kakamega,WESTERN,11499
KAKAMEGA NORTH,Urban,20,49,60,109,Kakamega,WESTERN,11500
KAKAMEGA NORTH,Urban,21,41,52,93,Kakamega,WESTERN,11501
KAKAMEGA NORTH,Urban,22,52,72,124,Kakamega,WESTERN,11502
KAKAMEGA NORTH,Urban,23,43,63,106,Kakamega,WESTERN,11503
KAKAMEGA NORTH,Urban,24,26,58,84,Kakamega,WESTERN,11504
KAKAMEGA NORTH,Urban,25,53,68,121,Kakamega,WESTERN,11505
KAKAMEGA NORTH,Urban,26,55,50,105,Kakamega,WESTERN,11506
KAKAMEGA NORTH,Urban,27,52,44,96,Kakamega,WESTERN,11507
KAKAMEGA NORTH,Urban,28,40,54,94,Kakamega,WESTERN,11508
KAKAMEGA NORTH,Urban,29,36,38,74,Kakamega,WESTERN,11509
KAKAMEGA NORTH,Urban,30,31,60,91,Kakamega,WESTERN,11510
KAKAMEGA NORTH,Urban,31,32,29,61,Kakamega,WESTERN,11511
KAKAMEGA NORTH,Urban,32,34,43,77,Kakamega,WESTERN,11512
KAKAMEGA NORTH,Urban,33,27,26,53,Kakamega,WESTERN,11513
KAKAMEGA NORTH,Urban,34,32,29,61,Kakamega,WESTERN,11514
KAKAMEGA NORTH,Urban,35,36,45,81,Kakamega,WESTERN,11515
KAKAMEGA NORTH,Urban,36,33,19,52,Kakamega,WESTERN,11516
KAKAMEGA NORTH,Urban,37,30,25,55,Kakamega,WESTERN,11517
KAKAMEGA NORTH,Urban,38,18,35,53,Kakamega,WESTERN,11518
KAKAMEGA NORTH,Urban,39,23,19,42,Kakamega,WESTERN,11519
KAKAMEGA NORTH,Urban,40,32,37,69,Kakamega,WESTERN,11520
KAKAMEGA NORTH,Urban,41,19,16,35,Kakamega,WESTERN,11521
KAKAMEGA NORTH,Urban,42,21,26,47,Kakamega,WESTERN,11522
KAKAMEGA NORTH,Urban,43,12,18,30,Kakamega,WESTERN,11523
KAKAMEGA NORTH,Urban,44,17,8,25,Kakamega,WESTERN,11524
KAKAMEGA NORTH,Urban,45,22,20,42,Kakamega,WESTERN,11525
KAKAMEGA NORTH,Urban,46,15,18,33,Kakamega,WESTERN,11526
KAKAMEGA NORTH,Urban,47,16,18,34,Kakamega,WESTERN,11527
KAKAMEGA NORTH,Urban,48,11,13,24,Kakamega,WESTERN,11528
KAKAMEGA NORTH,Urban,49,18,12,30,Kakamega,WESTERN,11529
KAKAMEGA NORTH,Urban,50,11,17,28,Kakamega,WESTERN,11530
KAKAMEGA NORTH,Urban,51,9,7,16,Kakamega,WESTERN,11531
KAKAMEGA NORTH,Urban,52,10,8,18,Kakamega,WESTERN,11532
KAKAMEGA NORTH,Urban,53,11,10,21,Kakamega,WESTERN,11533
KAKAMEGA NORTH,Urban,54,9,6,15,Kakamega,WESTERN,11534
KAKAMEGA NORTH,Urban,55,11,10,21,Kakamega,WESTERN,11535
KAKAMEGA NORTH,Urban,56,8,8,16,Kakamega,WESTERN,11536
KAKAMEGA NORTH,Urban,57,6,8,14,Kakamega,WESTERN,11537
KAKAMEGA NORTH,Urban,58,5,7,12,Kakamega,WESTERN,11538
KAKAMEGA NORTH,Urban,59,5,9,14,Kakamega,WESTERN,11539
KAKAMEGA NORTH,Urban,60,12,12,24,Kakamega,WESTERN,11540
KAKAMEGA NORTH,Urban,61,8,7,15,Kakamega,WESTERN,11541
KAKAMEGA NORTH,Urban,62,10,4,14,Kakamega,WESTERN,11542
KAKAMEGA NORTH,Urban,63,3,5,8,Kakamega,WESTERN,11543
KAKAMEGA NORTH,Urban,64,2,4,6,Kakamega,WESTERN,11544
KAKAMEGA NORTH,Urban,65,3,4,7,Kakamega,WESTERN,11545
KAKAMEGA NORTH,Urban,66,6,2,8,Kakamega,WESTERN,11546
KAKAMEGA NORTH,Urban,67,4,6,10,Kakamega,WESTERN,11547
KAKAMEGA NORTH,Urban,68,1,3,4,Kakamega,WESTERN,11548
KAKAMEGA NORTH,Urban,69,2,6,8,Kakamega,WESTERN,11549
KAKAMEGA NORTH,Urban,70,7,4,11,Kakamega,WESTERN,11550
KAKAMEGA NORTH,Urban,71,7,1,8,Kakamega,WESTERN,11551
KAKAMEGA NORTH,Urban,72,4,1,5,Kakamega,WESTERN,11552
KAKAMEGA NORTH,Urban,73,6,4,10,Kakamega,WESTERN,11553
KAKAMEGA NORTH,Urban,74,2,2,4,Kakamega,WESTERN,11554
KAKAMEGA NORTH,Urban,75,0,0,0,Kakamega,WESTERN,11555
KAKAMEGA NORTH,Urban,76,3,3,6,Kakamega,WESTERN,11556
KAKAMEGA NORTH,Urban,77,1,4,5,Kakamega,WESTERN,11557
KAKAMEGA NORTH,Urban,78,2,1,3,Kakamega,WESTERN,11558
KAKAMEGA NORTH,Urban,79,1,1,2,Kakamega,WESTERN,11559
KAKAMEGA NORTH,Urban,80+,12,17,29,Kakamega,WESTERN,11560
KAKAMEGA NORTH,Urban,Age NS,2,2,4,Kakamega,WESTERN,11561
KAKAMEGA EAST,Urban,0,45,34,79,Kakamega,WESTERN,11562
KAKAMEGA EAST,Urban,1,22,37,59,Kakamega,WESTERN,11563
KAKAMEGA EAST,Urban,2,38,46,84,Kakamega,WESTERN,11564
KAKAMEGA EAST,Urban,3,36,20,56,Kakamega,WESTERN,11565
KAKAMEGA EAST,Urban,4,44,35,79,Kakamega,WESTERN,11566
KAKAMEGA EAST,Urban,5,35,46,81,Kakamega,WESTERN,11567
KAKAMEGA EAST,Urban,6,33,33,66,Kakamega,WESTERN,11568
KAKAMEGA EAST,Urban,7,39,34,73,Kakamega,WESTERN,11569
KAKAMEGA EAST,Urban,8,30,27,57,Kakamega,WESTERN,11570
KAKAMEGA EAST,Urban,9,34,42,76,Kakamega,WESTERN,11571
KAKAMEGA EAST,Urban,10,38,36,74,Kakamega,WESTERN,11572
KAKAMEGA EAST,Urban,11,26,28,54,Kakamega,WESTERN,11573
KAKAMEGA EAST,Urban,12,32,30,62,Kakamega,WESTERN,11574
KAKAMEGA EAST,Urban,13,36,25,61,Kakamega,WESTERN,11575
KAKAMEGA EAST,Urban,14,29,24,53,Kakamega,WESTERN,11576
KAKAMEGA EAST,Urban,15,22,26,48,Kakamega,WESTERN,11577
KAKAMEGA EAST,Urban,16,17,24,41,Kakamega,WESTERN,11578
KAKAMEGA EAST,Urban,17,22,19,41,Kakamega,WESTERN,11579
KAKAMEGA EAST,Urban,18,21,26,47,Kakamega,WESTERN,11580
KAKAMEGA EAST,Urban,19,23,20,43,Kakamega,WESTERN,11581
KAKAMEGA EAST,Urban,20,24,31,55,Kakamega,WESTERN,11582
KAKAMEGA EAST,Urban,21,19,26,45,Kakamega,WESTERN,11583
KAKAMEGA EAST,Urban,22,15,31,46,Kakamega,WESTERN,11584
KAKAMEGA EAST,Urban,23,22,26,48,Kakamega,WESTERN,11585
KAKAMEGA EAST,Urban,24,18,23,41,Kakamega,WESTERN,11586
KAKAMEGA EAST,Urban,25,17,28,45,Kakamega,WESTERN,11587
KAKAMEGA EAST,Urban,26,13,21,34,Kakamega,WESTERN,11588
KAKAMEGA EAST,Urban,27,23,16,39,Kakamega,WESTERN,11589
KAKAMEGA EAST,Urban,28,16,19,35,Kakamega,WESTERN,11590
KAKAMEGA EAST,Urban,29,18,15,33,Kakamega,WESTERN,11591
KAKAMEGA EAST,Urban,30,24,22,46,Kakamega,WESTERN,11592
KAKAMEGA EAST,Urban,31,15,12,27,Kakamega,WESTERN,11593
KAKAMEGA EAST,Urban,32,9,17,26,Kakamega,WESTERN,11594
KAKAMEGA EAST,Urban,33,11,20,31,Kakamega,WESTERN,11595
KAKAMEGA EAST,Urban,34,8,10,18,Kakamega,WESTERN,11596
KAKAMEGA EAST,Urban,35,15,19,34,Kakamega,WESTERN,11597
KAKAMEGA EAST,Urban,36,11,9,20,Kakamega,WESTERN,11598
KAKAMEGA EAST,Urban,37,7,7,14,Kakamega,WESTERN,11599
KAKAMEGA EAST,Urban,38,15,5,20,Kakamega,WESTERN,11600
KAKAMEGA EAST,Urban,39,11,6,17,Kakamega,WESTERN,11601
KAKAMEGA EAST,Urban,40,8,16,24,Kakamega,WESTERN,11602
KAKAMEGA EAST,Urban,41,6,2,8,Kakamega,WESTERN,11603
KAKAMEGA EAST,Urban,42,3,8,11,Kakamega,WESTERN,11604
KAKAMEGA EAST,Urban,43,6,8,14,Kakamega,WESTERN,11605
KAKAMEGA EAST,Urban,44,2,4,6,Kakamega,WESTERN,11606
KAKAMEGA EAST,Urban,45,10,9,19,Kakamega,WESTERN,11607
KAKAMEGA EAST,Urban,46,4,9,13,Kakamega,WESTERN,11608
KAKAMEGA EAST,Urban,47,6,11,17,Kakamega,WESTERN,11609
KAKAMEGA EAST,Urban,48,7,11,18,Kakamega,WESTERN,11610
KAKAMEGA EAST,Urban,49,5,5,10,Kakamega,WESTERN,11611
KAKAMEGA EAST,Urban,50,4,9,13,Kakamega,WESTERN,11612
KAKAMEGA EAST,Urban,51,6,3,9,Kakamega,WESTERN,11613
KAKAMEGA EAST,Urban,52,8,8,16,Kakamega,WESTERN,11614
KAKAMEGA EAST,Urban,53,4,5,9,Kakamega,WESTERN,11615
KAKAMEGA EAST,Urban,54,6,13,19,Kakamega,WESTERN,11616
KAKAMEGA EAST,Urban,55,5,6,11,Kakamega,WESTERN,11617
KAKAMEGA EAST,Urban,56,5,6,11,Kakamega,WESTERN,11618
KAKAMEGA EAST,Urban,57,3,2,5,Kakamega,WESTERN,11619
KAKAMEGA EAST,Urban,58,4,2,6,Kakamega,WESTERN,11620
KAKAMEGA EAST,Urban,59,5,3,8,Kakamega,WESTERN,11621
KAKAMEGA EAST,Urban,60,3,5,8,Kakamega,WESTERN,11622
KAKAMEGA EAST,Urban,61,4,2,6,Kakamega,WESTERN,11623
KAKAMEGA EAST,Urban,62,2,4,6,Kakamega,WESTERN,11624
KAKAMEGA EAST,Urban,63,2,2,4,Kakamega,WESTERN,11625
KAKAMEGA EAST,Urban,64,5,3,8,Kakamega,WESTERN,11626
KAKAMEGA EAST,Urban,65,2,1,3,Kakamega,WESTERN,11627
KAKAMEGA EAST,Urban,66,1,5,6,Kakamega,WESTERN,11628
KAKAMEGA EAST,Urban,67,2,2,4,Kakamega,WESTERN,11629
KAKAMEGA EAST,Urban,68,1,1,2,Kakamega,WESTERN,11630
KAKAMEGA EAST,Urban,69,2,3,5,Kakamega,WESTERN,11631
KAKAMEGA EAST,Urban,70,3,3,6,Kakamega,WESTERN,11632
KAKAMEGA EAST,Urban,71,5,1,6,Kakamega,WESTERN,11633
KAKAMEGA EAST,Urban,72,3,2,5,Kakamega,WESTERN,11634
KAKAMEGA EAST,Urban,73,4,2,6,Kakamega,WESTERN,11635
KAKAMEGA EAST,Urban,74,1,3,4,Kakamega,WESTERN,11636
KAKAMEGA EAST,Urban,75,0,1,1,Kakamega,WESTERN,11637
KAKAMEGA EAST,Urban,76,1,1,2,Kakamega,WESTERN,11638
KAKAMEGA EAST,Urban,77,2,2,4,Kakamega,WESTERN,11639
KAKAMEGA EAST,Urban,78,1,1,2,Kakamega,WESTERN,11640
KAKAMEGA EAST,Urban,79,1,4,5,Kakamega,WESTERN,11641
KAKAMEGA EAST,Urban,80+,5,8,13,Kakamega,WESTERN,11642
KAKAMEGA EAST,Urban,Age NS,20,19,39,Kakamega,WESTERN,11643
LUGARI,Urban,0,354,348,702,Kakamega,WESTERN,11644
LUGARI,Urban,1,328,313,641,Kakamega,WESTERN,11645
LUGARI,Urban,2,327,343,670,Kakamega,WESTERN,11646
LUGARI,Urban,3,329,333,662,Kakamega,WESTERN,11647
LUGARI,Urban,4,326,325,651,Kakamega,WESTERN,11648
LUGARI,Urban,5,299,342,641,Kakamega,WESTERN,11649
LUGARI,Urban,6,309,315,624,Kakamega,WESTERN,11650
LUGARI,Urban,7,339,283,622,Kakamega,WESTERN,11651
LUGARI,Urban,8,298,292,590,Kakamega,WESTERN,11652
LUGARI,Urban,9,296,318,614,Kakamega,WESTERN,11653
LUGARI,Urban,10,302,278,580,Kakamega,WESTERN,11654
LUGARI,Urban,11,226,228,454,Kakamega,WESTERN,11655
LUGARI,Urban,12,289,294,583,Kakamega,WESTERN,11656
LUGARI,Urban,13,237,277,514,Kakamega,WESTERN,11657
LUGARI,Urban,14,262,229,491,Kakamega,WESTERN,11658
LUGARI,Urban,15,230,232,462,Kakamega,WESTERN,11659
LUGARI,Urban,16,199,208,407,Kakamega,WESTERN,11660
LUGARI,Urban,17,247,225,472,Kakamega,WESTERN,11661
LUGARI,Urban,18,229,224,453,Kakamega,WESTERN,11662
LUGARI,Urban,19,180,193,373,Kakamega,WESTERN,11663
LUGARI,Urban,20,183,253,436,Kakamega,WESTERN,11664
LUGARI,Urban,21,162,204,366,Kakamega,WESTERN,11665
LUGARI,Urban,22,208,238,446,Kakamega,WESTERN,11666
LUGARI,Urban,23,174,234,408,Kakamega,WESTERN,11667
LUGARI,Urban,24,156,214,370,Kakamega,WESTERN,11668
LUGARI,Urban,25,159,259,418,Kakamega,WESTERN,11669
LUGARI,Urban,26,147,172,319,Kakamega,WESTERN,11670
LUGARI,Urban,27,152,150,302,Kakamega,WESTERN,11671
LUGARI,Urban,28,144,153,297,Kakamega,WESTERN,11672
LUGARI,Urban,29,134,113,247,Kakamega,WESTERN,11673
LUGARI,Urban,30,189,229,418,Kakamega,WESTERN,11674
LUGARI,Urban,31,121,124,245,Kakamega,WESTERN,11675
LUGARI,Urban,32,137,151,288,Kakamega,WESTERN,11676
LUGARI,Urban,33,117,107,224,Kakamega,WESTERN,11677
LUGARI,Urban,34,105,104,209,Kakamega,WESTERN,11678
LUGARI,Urban,35,146,162,308,Kakamega,WESTERN,11679
LUGARI,Urban,36,96,83,179,Kakamega,WESTERN,11680
LUGARI,Urban,37,82,97,179,Kakamega,WESTERN,11681
LUGARI,Urban,38,101,125,226,Kakamega,WESTERN,11682
LUGARI,Urban,39,96,93,189,Kakamega,WESTERN,11683
LUGARI,Urban,40,138,119,257,Kakamega,WESTERN,11684
LUGARI,Urban,41,68,54,122,Kakamega,WESTERN,11685
LUGARI,Urban,42,98,75,173,Kakamega,WESTERN,11686
LUGARI,Urban,43,69,87,156,Kakamega,WESTERN,11687
LUGARI,Urban,44,57,56,113,Kakamega,WESTERN,11688
LUGARI,Urban,45,98,114,212,Kakamega,WESTERN,11689
LUGARI,Urban,46,55,71,126,Kakamega,WESTERN,11690
LUGARI,Urban,47,64,54,118,Kakamega,WESTERN,11691
LUGARI,Urban,48,46,62,108,Kakamega,WESTERN,11692
LUGARI,Urban,49,78,62,140,Kakamega,WESTERN,11693
LUGARI,Urban,50,72,82,154,Kakamega,WESTERN,11694
LUGARI,Urban,51,44,40,84,Kakamega,WESTERN,11695
LUGARI,Urban,52,48,53,101,Kakamega,WESTERN,11696
LUGARI,Urban,53,43,38,81,Kakamega,WESTERN,11697
LUGARI,Urban,54,35,41,76,Kakamega,WESTERN,11698
LUGARI,Urban,55,50,44,94,Kakamega,WESTERN,11699
LUGARI,Urban,56,33,33,66,Kakamega,WESTERN,11700
LUGARI,Urban,57,32,50,82,Kakamega,WESTERN,11701
LUGARI,Urban,58,20,25,45,Kakamega,WESTERN,11702
LUGARI,Urban,59,27,30,57,Kakamega,WESTERN,11703
LUGARI,Urban,60,40,44,84,Kakamega,WESTERN,11704
LUGARI,Urban,61,21,36,57,Kakamega,WESTERN,11705
LUGARI,Urban,62,18,22,40,Kakamega,WESTERN,11706
LUGARI,Urban,63,21,15,36,Kakamega,WESTERN,11707
LUGARI,Urban,64,18,23,41,Kakamega,WESTERN,11708
LUGARI,Urban,65,17,25,42,Kakamega,WESTERN,11709
LUGARI,Urban,66,19,20,39,Kakamega,WESTERN,11710
LUGARI,Urban,67,16,23,39,Kakamega,WESTERN,11711
LUGARI,Urban,68,10,12,22,Kakamega,WESTERN,11712
LUGARI,Urban,69,19,17,36,Kakamega,WESTERN,11713
LUGARI,Urban,70,20,22,42,Kakamega,WESTERN,11714
LUGARI,Urban,71,13,14,27,Kakamega,WESTERN,11715
LUGARI,Urban,72,14,9,23,Kakamega,WESTERN,11716
LUGARI,Urban,73,11,15,26,Kakamega,WESTERN,11717
LUGARI,Urban,74,9,11,20,Kakamega,WESTERN,11718
LUGARI,Urban,75,8,11,19,Kakamega,WESTERN,11719
LUGARI,Urban,76,7,8,15,Kakamega,WESTERN,11720
LUGARI,Urban,77,8,13,21,Kakamega,WESTERN,11721
LUGARI,Urban,78,7,7,14,Kakamega,WESTERN,11722
LUGARI,Urban,79,6,8,14,Kakamega,WESTERN,11723
LUGARI,Urban,80+,71,72,143,Kakamega,WESTERN,11724
LUGARI,Urban,Age NS,5,1,6,Kakamega,WESTERN,11725
VIHIGA,Urban,0,1794,1827,3621,Vihiga,WESTERN,11726
VIHIGA,Urban,1,1758,1681,3439,Vihiga,WESTERN,11727
VIHIGA,Urban,2,1938,1827,3765,Vihiga,WESTERN,11728
VIHIGA,Urban,3,1894,1868,3762,Vihiga,WESTERN,11729
VIHIGA,Urban,4,1929,1801,3730,Vihiga,WESTERN,11730
VIHIGA,Urban,5,1974,1745,3719,Vihiga,WESTERN,11731
VIHIGA,Urban,6,1956,1778,3734,Vihiga,WESTERN,11732
VIHIGA,Urban,7,1889,1783,3672,Vihiga,WESTERN,11733
VIHIGA,Urban,8,1907,1731,3638,Vihiga,WESTERN,11734
VIHIGA,Urban,9,1939,1860,3799,Vihiga,WESTERN,11735
VIHIGA,Urban,10,1830,1859,3689,Vihiga,WESTERN,11736
VIHIGA,Urban,11,1434,1502,2936,Vihiga,WESTERN,11737
VIHIGA,Urban,12,1774,1767,3541,Vihiga,WESTERN,11738
VIHIGA,Urban,13,1690,1789,3479,Vihiga,WESTERN,11739
VIHIGA,Urban,14,1562,1587,3149,Vihiga,WESTERN,11740
VIHIGA,Urban,15,1594,1552,3146,Vihiga,WESTERN,11741
VIHIGA,Urban,16,1486,1506,2992,Vihiga,WESTERN,11742
VIHIGA,Urban,17,1536,1549,3085,Vihiga,WESTERN,11743
VIHIGA,Urban,18,1444,1348,2792,Vihiga,WESTERN,11744
VIHIGA,Urban,19,1226,1139,2365,Vihiga,WESTERN,11745
VIHIGA,Urban,20,1115,1193,2308,Vihiga,WESTERN,11746
VIHIGA,Urban,21,849,986,1835,Vihiga,WESTERN,11747
VIHIGA,Urban,22,821,1131,1952,Vihiga,WESTERN,11748
VIHIGA,Urban,23,753,1033,1786,Vihiga,WESTERN,11749
VIHIGA,Urban,24,708,946,1654,Vihiga,WESTERN,11750
VIHIGA,Urban,25,800,1118,1918,Vihiga,WESTERN,11751
VIHIGA,Urban,26,624,938,1562,Vihiga,WESTERN,11752
VIHIGA,Urban,27,713,862,1575,Vihiga,WESTERN,11753
VIHIGA,Urban,28,581,812,1393,Vihiga,WESTERN,11754
VIHIGA,Urban,29,609,750,1359,Vihiga,WESTERN,11755
VIHIGA,Urban,30,725,1041,1766,Vihiga,WESTERN,11756
VIHIGA,Urban,31,560,673,1233,Vihiga,WESTERN,11757
VIHIGA,Urban,32,584,823,1407,Vihiga,WESTERN,11758
VIHIGA,Urban,33,488,613,1101,Vihiga,WESTERN,11759
VIHIGA,Urban,34,546,643,1189,Vihiga,WESTERN,11760
VIHIGA,Urban,35,679,881,1560,Vihiga,WESTERN,11761
VIHIGA,Urban,36,464,599,1063,Vihiga,WESTERN,11762
VIHIGA,Urban,37,522,553,1075,Vihiga,WESTERN,11763
VIHIGA,Urban,38,502,569,1071,Vihiga,WESTERN,11764
VIHIGA,Urban,39,455,516,971,Vihiga,WESTERN,11765
VIHIGA,Urban,40,602,791,1393,Vihiga,WESTERN,11766
VIHIGA,Urban,41,388,489,877,Vihiga,WESTERN,11767
VIHIGA,Urban,42,408,486,894,Vihiga,WESTERN,11768
VIHIGA,Urban,43,340,386,726,Vihiga,WESTERN,11769
VIHIGA,Urban,44,341,393,734,Vihiga,WESTERN,11770
VIHIGA,Urban,45,447,640,1087,Vihiga,WESTERN,11771
VIHIGA,Urban,46,328,475,803,Vihiga,WESTERN,11772
VIHIGA,Urban,47,308,399,707,Vihiga,WESTERN,11773
VIHIGA,Urban,48,323,434,757,Vihiga,WESTERN,11774
VIHIGA,Urban,49,367,497,864,Vihiga,WESTERN,11775
VIHIGA,Urban,50,437,653,1090,Vihiga,WESTERN,11776
VIHIGA,Urban,51,291,388,679,Vihiga,WESTERN,11777
VIHIGA,Urban,52,333,426,759,Vihiga,WESTERN,11778
VIHIGA,Urban,53,320,393,713,Vihiga,WESTERN,11779
VIHIGA,Urban,54,292,389,681,Vihiga,WESTERN,11780
VIHIGA,Urban,55,377,518,895,Vihiga,WESTERN,11781
VIHIGA,Urban,56,306,392,698,Vihiga,WESTERN,11782
VIHIGA,Urban,57,338,398,736,Vihiga,WESTERN,11783
VIHIGA,Urban,58,232,292,524,Vihiga,WESTERN,11784
VIHIGA,Urban,59,324,348,672,Vihiga,WESTERN,11785
VIHIGA,Urban,60,378,498,876,Vihiga,WESTERN,11786
VIHIGA,Urban,61,297,303,600,Vihiga,WESTERN,11787
VIHIGA,Urban,62,300,329,629,Vihiga,WESTERN,11788
VIHIGA,Urban,63,264,252,516,Vihiga,WESTERN,11789
VIHIGA,Urban,64,246,244,490,Vihiga,WESTERN,11790
VIHIGA,Urban,65,231,257,488,Vihiga,WESTERN,11791
VIHIGA,Urban,66,228,283,511,Vihiga,WESTERN,11792
VIHIGA,Urban,67,234,227,461,Vihiga,WESTERN,11793
VIHIGA,Urban,68,146,161,307,Vihiga,WESTERN,11794
VIHIGA,Urban,69,213,239,452,Vihiga,WESTERN,11795
VIHIGA,Urban,70,273,285,558,Vihiga,WESTERN,11796
VIHIGA,Urban,71,171,189,360,Vihiga,WESTERN,11797
VIHIGA,Urban,72,184,192,376,Vihiga,WESTERN,11798
VIHIGA,Urban,73,183,199,382,Vihiga,WESTERN,11799
VIHIGA,Urban,74,110,156,266,Vihiga,WESTERN,11800
VIHIGA,Urban,75,150,172,322,Vihiga,WESTERN,11801
VIHIGA,Urban,76,143,155,298,Vihiga,WESTERN,11802
VIHIGA,Urban,77,129,161,290,Vihiga,WESTERN,11803
VIHIGA,Urban,78,107,119,226,Vihiga,WESTERN,11804
VIHIGA,Urban,79,97,134,231,Vihiga,WESTERN,11805
VIHIGA,Urban,80+,819,1073,1892,Vihiga,WESTERN,11806
VIHIGA,Urban,Age NS,54,54,108,Vihiga,WESTERN,11807
EMUHAYA,Urban,0,867,875,1742,Vihiga,WESTERN,11808
EMUHAYA,Urban,1,775,722,1497,Vihiga,WESTERN,11809
EMUHAYA,Urban,2,827,865,1692,Vihiga,WESTERN,11810
EMUHAYA,Urban,3,818,827,1645,Vihiga,WESTERN,11811
EMUHAYA,Urban,4,734,706,1440,Vihiga,WESTERN,11812
EMUHAYA,Urban,5,786,766,1552,Vihiga,WESTERN,11813
EMUHAYA,Urban,6,722,705,1427,Vihiga,WESTERN,11814
EMUHAYA,Urban,7,682,712,1394,Vihiga,WESTERN,11815
EMUHAYA,Urban,8,623,687,1310,Vihiga,WESTERN,11816
EMUHAYA,Urban,9,711,706,1417,Vihiga,WESTERN,11817
EMUHAYA,Urban,10,724,725,1449,Vihiga,WESTERN,11818
EMUHAYA,Urban,11,555,546,1101,Vihiga,WESTERN,11819
EMUHAYA,Urban,12,735,715,1450,Vihiga,WESTERN,11820
EMUHAYA,Urban,13,682,664,1346,Vihiga,WESTERN,11821
EMUHAYA,Urban,14,580,593,1173,Vihiga,WESTERN,11822
EMUHAYA,Urban,15,529,632,1161,Vihiga,WESTERN,11823
EMUHAYA,Urban,16,518,507,1025,Vihiga,WESTERN,11824
EMUHAYA,Urban,17,515,561,1076,Vihiga,WESTERN,11825
EMUHAYA,Urban,18,505,493,998,Vihiga,WESTERN,11826
EMUHAYA,Urban,19,379,450,829,Vihiga,WESTERN,11827
EMUHAYA,Urban,20,442,570,1012,Vihiga,WESTERN,11828
EMUHAYA,Urban,21,328,448,776,Vihiga,WESTERN,11829
EMUHAYA,Urban,22,350,486,836,Vihiga,WESTERN,11830
EMUHAYA,Urban,23,335,453,788,Vihiga,WESTERN,11831
EMUHAYA,Urban,24,323,401,724,Vihiga,WESTERN,11832
EMUHAYA,Urban,25,374,498,872,Vihiga,WESTERN,11833
EMUHAYA,Urban,26,294,358,652,Vihiga,WESTERN,11834
EMUHAYA,Urban,27,313,370,683,Vihiga,WESTERN,11835
EMUHAYA,Urban,28,248,275,523,Vihiga,WESTERN,11836
EMUHAYA,Urban,29,282,297,579,Vihiga,WESTERN,11837
EMUHAYA,Urban,30,355,386,741,Vihiga,WESTERN,11838
EMUHAYA,Urban,31,238,282,520,Vihiga,WESTERN,11839
EMUHAYA,Urban,32,282,295,577,Vihiga,WESTERN,11840
EMUHAYA,Urban,33,221,198,419,Vihiga,WESTERN,11841
EMUHAYA,Urban,34,234,216,450,Vihiga,WESTERN,11842
EMUHAYA,Urban,35,334,343,677,Vihiga,WESTERN,11843
EMUHAYA,Urban,36,209,215,424,Vihiga,WESTERN,11844
EMUHAYA,Urban,37,196,208,404,Vihiga,WESTERN,11845
EMUHAYA,Urban,38,180,187,367,Vihiga,WESTERN,11846
EMUHAYA,Urban,39,199,145,344,Vihiga,WESTERN,11847
EMUHAYA,Urban,40,261,331,592,Vihiga,WESTERN,11848
EMUHAYA,Urban,41,172,187,359,Vihiga,WESTERN,11849
EMUHAYA,Urban,42,162,178,340,Vihiga,WESTERN,11850
EMUHAYA,Urban,43,145,128,273,Vihiga,WESTERN,11851
EMUHAYA,Urban,44,133,144,277,Vihiga,WESTERN,11852
EMUHAYA,Urban,45,222,272,494,Vihiga,WESTERN,11853
EMUHAYA,Urban,46,146,180,326,Vihiga,WESTERN,11854
EMUHAYA,Urban,47,123,185,308,Vihiga,WESTERN,11855
EMUHAYA,Urban,48,146,159,305,Vihiga,WESTERN,11856
EMUHAYA,Urban,49,160,165,325,Vihiga,WESTERN,11857
EMUHAYA,Urban,50,211,310,521,Vihiga,WESTERN,11858
EMUHAYA,Urban,51,143,130,273,Vihiga,WESTERN,11859
EMUHAYA,Urban,52,136,148,284,Vihiga,WESTERN,11860
EMUHAYA,Urban,53,138,143,281,Vihiga,WESTERN,11861
EMUHAYA,Urban,54,132,169,301,Vihiga,WESTERN,11862
EMUHAYA,Urban,55,167,169,336,Vihiga,WESTERN,11863
EMUHAYA,Urban,56,144,151,295,Vihiga,WESTERN,11864
EMUHAYA,Urban,57,169,151,320,Vihiga,WESTERN,11865
EMUHAYA,Urban,58,99,93,192,Vihiga,WESTERN,11866
EMUHAYA,Urban,59,95,125,220,Vihiga,WESTERN,11867
EMUHAYA,Urban,60,179,202,381,Vihiga,WESTERN,11868
EMUHAYA,Urban,61,96,87,183,Vihiga,WESTERN,11869
EMUHAYA,Urban,62,101,88,189,Vihiga,WESTERN,11870
EMUHAYA,Urban,63,74,85,159,Vihiga,WESTERN,11871
EMUHAYA,Urban,64,82,92,174,Vihiga,WESTERN,11872
EMUHAYA,Urban,65,86,117,203,Vihiga,WESTERN,11873
EMUHAYA,Urban,66,70,76,146,Vihiga,WESTERN,11874
EMUHAYA,Urban,67,78,70,148,Vihiga,WESTERN,11875
EMUHAYA,Urban,68,38,50,88,Vihiga,WESTERN,11876
EMUHAYA,Urban,69,71,72,143,Vihiga,WESTERN,11877
EMUHAYA,Urban,70,87,150,237,Vihiga,WESTERN,11878
EMUHAYA,Urban,71,41,56,97,Vihiga,WESTERN,11879
EMUHAYA,Urban,72,66,60,126,Vihiga,WESTERN,11880
EMUHAYA,Urban,73,59,65,124,Vihiga,WESTERN,11881
EMUHAYA,Urban,74,55,56,111,Vihiga,WESTERN,11882
EMUHAYA,Urban,75,44,89,133,Vihiga,WESTERN,11883
EMUHAYA,Urban,76,32,50,82,Vihiga,WESTERN,11884
EMUHAYA,Urban,77,38,62,100,Vihiga,WESTERN,11885
EMUHAYA,Urban,78,37,43,80,Vihiga,WESTERN,11886
EMUHAYA,Urban,79,36,55,91,Vihiga,WESTERN,11887
EMUHAYA,Urban,80+,245,368,613,Vihiga,WESTERN,11888
EMUHAYA,Urban,Age NS,11,13,24,Vihiga,WESTERN,11889
HAMISI,Urban,0,0,0,0,Vihiga,WESTERN,11890
HAMISI,Urban,1,0,0,0,Vihiga,WESTERN,11891
HAMISI,Urban,2,0,0,0,Vihiga,WESTERN,11892
HAMISI,Urban,3,0,0,0,Vihiga,WESTERN,11893
HAMISI,Urban,4,0,0,0,Vihiga,WESTERN,11894
HAMISI,Urban,5,0,0,0,Vihiga,WESTERN,11895
HAMISI,Urban,6,0,0,0,Vihiga,WESTERN,11896
HAMISI,Urban,7,0,0,0,Vihiga,WESTERN,11897
HAMISI,Urban,8,0,0,0,Vihiga,WESTERN,11898
HAMISI,Urban,9,0,0,0,Vihiga,WESTERN,11899
HAMISI,Urban,10,0,0,0,Vihiga,WESTERN,11900
HAMISI,Urban,11,0,0,0,Vihiga,WESTERN,11901
HAMISI,Urban,12,0,0,0,Vihiga,WESTERN,11902
HAMISI,Urban,13,0,0,0,Vihiga,WESTERN,11903
HAMISI,Urban,14,0,0,0,Vihiga,WESTERN,11904
HAMISI,Urban,15,0,0,0,Vihiga,WESTERN,11905
HAMISI,Urban,16,0,0,0,Vihiga,WESTERN,11906
HAMISI,Urban,17,0,0,0,Vihiga,WESTERN,11907
HAMISI,Urban,18,0,0,0,Vihiga,WESTERN,11908
HAMISI,Urban,19,0,0,0,Vihiga,WESTERN,11909
HAMISI,Urban,20,0,0,0,Vihiga,WESTERN,11910
HAMISI,Urban,21,0,0,0,Vihiga,WESTERN,11911
HAMISI,Urban,22,0,0,0,Vihiga,WESTERN,11912
HAMISI,Urban,23,0,0,0,Vihiga,WESTERN,11913
HAMISI,Urban,24,0,0,0,Vihiga,WESTERN,11914
HAMISI,Urban,25,0,0,0,Vihiga,WESTERN,11915
HAMISI,Urban,26,0,0,0,Vihiga,WESTERN,11916
HAMISI,Urban,27,0,0,0,Vihiga,WESTERN,11917
HAMISI,Urban,28,0,0,0,Vihiga,WESTERN,11918
HAMISI,Urban,29,0,0,0,Vihiga,WESTERN,11919
HAMISI,Urban,30,0,0,0,Vihiga,WESTERN,11920
HAMISI,Urban,31,0,0,0,Vihiga,WESTERN,11921
HAMISI,Urban,32,0,0,0,Vihiga,WESTERN,11922
HAMISI,Urban,33,0,0,0,Vihiga,WESTERN,11923
HAMISI,Urban,34,0,0,0,Vihiga,WESTERN,11924
HAMISI,Urban,35,0,0,0,Vihiga,WESTERN,11925
HAMISI,Urban,36,0,0,0,Vihiga,WESTERN,11926
HAMISI,Urban,37,0,0,0,Vihiga,WESTERN,11927
HAMISI,Urban,38,0,0,0,Vihiga,WESTERN,11928
HAMISI,Urban,39,0,0,0,Vihiga,WESTERN,11929
HAMISI,Urban,40,0,0,0,Vihiga,WESTERN,11930
HAMISI,Urban,41,0,0,0,Vihiga,WESTERN,11931
HAMISI,Urban,42,0,0,0,Vihiga,WESTERN,11932
HAMISI,Urban,43,0,0,0,Vihiga,WESTERN,11933
HAMISI,Urban,44,0,0,0,Vihiga,WESTERN,11934
HAMISI,Urban,45,0,0,0,Vihiga,WESTERN,11935
HAMISI,Urban,46,0,0,0,Vihiga,WESTERN,11936
HAMISI,Urban,47,0,0,0,Vihiga,WESTERN,11937
HAMISI,Urban,48,0,0,0,Vihiga,WESTERN,11938
HAMISI,Urban,49,0,0,0,Vihiga,WESTERN,11939
HAMISI,Urban,50,0,0,0,Vihiga,WESTERN,11940
HAMISI,Urban,51,0,0,0,Vihiga,WESTERN,11941
HAMISI,Urban,52,0,0,0,Vihiga,WESTERN,11942
HAMISI,Urban,53,0,0,0,Vihiga,WESTERN,11943
HAMISI,Urban,54,0,0,0,Vihiga,WESTERN,11944
HAMISI,Urban,55,0,0,0,Vihiga,WESTERN,11945
HAMISI,Urban,56,0,0,0,Vihiga,WESTERN,11946
HAMISI,Urban,57,0,0,0,Vihiga,WESTERN,11947
HAMISI,Urban,58,0,0,0,Vihiga,WESTERN,11948
HAMISI,Urban,59,0,0,0,Vihiga,WESTERN,11949
HAMISI,Urban,60,0,0,0,Vihiga,WESTERN,11950
HAMISI,Urban,61,0,0,0,Vihiga,WESTERN,11951
HAMISI,Urban,62,0,0,0,Vihiga,WESTERN,11952
HAMISI,Urban,63,0,0,0,Vihiga,WESTERN,11953
HAMISI,Urban,64,0,0,0,Vihiga,WESTERN,11954
HAMISI,Urban,65,0,0,0,Vihiga,WESTERN,11955
HAMISI,Urban,66,0,0,0,Vihiga,WESTERN,11956
HAMISI,Urban,67,0,0,0,Vihiga,WESTERN,11957
HAMISI,Urban,68,0,0,0,Vihiga,WESTERN,11958
HAMISI,Urban,69,0,0,0,Vihiga,WESTERN,11959
HAMISI,Urban,70,0,0,0,Vihiga,WESTERN,11960
HAMISI,Urban,71,0,0,0,Vihiga,WESTERN,11961
HAMISI,Urban,72,0,0,0,Vihiga,WESTERN,11962
HAMISI,Urban,73,0,0,0,Vihiga,WESTERN,11963
HAMISI,Urban,74,0,0,0,Vihiga,WESTERN,11964
HAMISI,Urban,75,0,0,0,Vihiga,WESTERN,11965
HAMISI,Urban,76,0,0,0,Vihiga,WESTERN,11966
HAMISI,Urban,77,0,0,0,Vihiga,WESTERN,11967
HAMISI,Urban,78,0,0,0,Vihiga,WESTERN,11968
HAMISI,Urban,79,0,0,0,Vihiga,WESTERN,11969
HAMISI,Urban,80+,0,0,0,Vihiga,WESTERN,11970
HAMISI,Urban,Age NS,0,0,0,Vihiga,WESTERN,11971
MUMIAS,Urban,0,2277,2293,4570,Kakamega,WESTERN,11972
MUMIAS,Urban,1,2009,2019,4028,Kakamega,WESTERN,11973
MUMIAS,Urban,2,2162,2216,4378,Kakamega,WESTERN,11974
MUMIAS,Urban,3,2157,2274,4431,Kakamega,WESTERN,11975
MUMIAS,Urban,4,1967,2053,4020,Kakamega,WESTERN,11976
MUMIAS,Urban,5,1982,2094,4076,Kakamega,WESTERN,11977
MUMIAS,Urban,6,1801,1837,3638,Kakamega,WESTERN,11978
MUMIAS,Urban,7,1675,1741,3416,Kakamega,WESTERN,11979
MUMIAS,Urban,8,1573,1638,3211,Kakamega,WESTERN,11980
MUMIAS,Urban,9,1734,1701,3435,Kakamega,WESTERN,11981
MUMIAS,Urban,10,1688,1704,3392,Kakamega,WESTERN,11982
MUMIAS,Urban,11,1323,1449,2772,Kakamega,WESTERN,11983
MUMIAS,Urban,12,1594,1500,3094,Kakamega,WESTERN,11984
MUMIAS,Urban,13,1570,1509,3079,Kakamega,WESTERN,11985
MUMIAS,Urban,14,1353,1379,2732,Kakamega,WESTERN,11986
MUMIAS,Urban,15,1302,1360,2662,Kakamega,WESTERN,11987
MUMIAS,Urban,16,1204,1349,2553,Kakamega,WESTERN,11988
MUMIAS,Urban,17,1315,1406,2721,Kakamega,WESTERN,11989
MUMIAS,Urban,18,1268,1254,2522,Kakamega,WESTERN,11990
MUMIAS,Urban,19,1073,1292,2365,Kakamega,WESTERN,11991
MUMIAS,Urban,20,1260,1568,2828,Kakamega,WESTERN,11992
MUMIAS,Urban,21,954,1270,2224,Kakamega,WESTERN,11993
MUMIAS,Urban,22,1128,1442,2570,Kakamega,WESTERN,11994
MUMIAS,Urban,23,1033,1369,2402,Kakamega,WESTERN,11995
MUMIAS,Urban,24,978,1179,2157,Kakamega,WESTERN,11996
MUMIAS,Urban,25,1173,1307,2480,Kakamega,WESTERN,11997
MUMIAS,Urban,26,954,1024,1978,Kakamega,WESTERN,11998
MUMIAS,Urban,27,1030,946,1976,Kakamega,WESTERN,11999
MUMIAS,Urban,28,796,836,1632,Kakamega,WESTERN,12000
MUMIAS,Urban,29,812,791,1603,Kakamega,WESTERN,12001
MUMIAS,Urban,30,984,1072,2056,Kakamega,WESTERN,12002
MUMIAS,Urban,31,709,662,1371,Kakamega,WESTERN,12003
MUMIAS,Urban,32,785,734,1519,Kakamega,WESTERN,12004
MUMIAS,Urban,33,606,575,1181,Kakamega,WESTERN,12005
MUMIAS,Urban,34,581,574,1155,Kakamega,WESTERN,12006
MUMIAS,Urban,35,772,812,1584,Kakamega,WESTERN,12007
MUMIAS,Urban,36,547,536,1083,Kakamega,WESTERN,12008
MUMIAS,Urban,37,503,481,984,Kakamega,WESTERN,12009
MUMIAS,Urban,38,450,415,865,Kakamega,WESTERN,12010
MUMIAS,Urban,39,432,430,862,Kakamega,WESTERN,12011
MUMIAS,Urban,40,664,737,1401,Kakamega,WESTERN,12012
MUMIAS,Urban,41,378,390,768,Kakamega,WESTERN,12013
MUMIAS,Urban,42,387,392,779,Kakamega,WESTERN,12014
MUMIAS,Urban,43,344,338,682,Kakamega,WESTERN,12015
MUMIAS,Urban,44,289,293,582,Kakamega,WESTERN,12016
MUMIAS,Urban,45,473,518,991,Kakamega,WESTERN,12017
MUMIAS,Urban,46,372,307,679,Kakamega,WESTERN,12018
MUMIAS,Urban,47,379,433,812,Kakamega,WESTERN,12019
MUMIAS,Urban,48,296,290,586,Kakamega,WESTERN,12020
MUMIAS,Urban,49,345,301,646,Kakamega,WESTERN,12021
MUMIAS,Urban,50,396,391,787,Kakamega,WESTERN,12022
MUMIAS,Urban,51,271,278,549,Kakamega,WESTERN,12023
MUMIAS,Urban,52,270,206,476,Kakamega,WESTERN,12024
MUMIAS,Urban,53,272,230,502,Kakamega,WESTERN,12025
MUMIAS,Urban,54,213,191,404,Kakamega,WESTERN,12026
MUMIAS,Urban,55,253,250,503,Kakamega,WESTERN,12027
MUMIAS,Urban,56,196,179,375,Kakamega,WESTERN,12028
MUMIAS,Urban,57,213,240,453,Kakamega,WESTERN,12029
MUMIAS,Urban,58,114,109,223,Kakamega,WESTERN,12030
MUMIAS,Urban,59,158,162,320,Kakamega,WESTERN,12031
MUMIAS,Urban,60,204,267,471,Kakamega,WESTERN,12032
MUMIAS,Urban,61,129,112,241,Kakamega,WESTERN,12033
MUMIAS,Urban,62,87,107,194,Kakamega,WESTERN,12034
MUMIAS,Urban,63,113,102,215,Kakamega,WESTERN,12035
MUMIAS,Urban,64,105,86,191,Kakamega,WESTERN,12036
MUMIAS,Urban,65,100,112,212,Kakamega,WESTERN,12037
MUMIAS,Urban,66,68,82,150,Kakamega,WESTERN,12038
MUMIAS,Urban,67,97,101,198,Kakamega,WESTERN,12039
MUMIAS,Urban,68,47,57,104,Kakamega,WESTERN,12040
MUMIAS,Urban,69,63,85,148,Kakamega,WESTERN,12041
MUMIAS,Urban,70,94,105,199,Kakamega,WESTERN,12042
MUMIAS,Urban,71,56,77,133,Kakamega,WESTERN,12043
MUMIAS,Urban,72,46,47,93,Kakamega,WESTERN,12044
MUMIAS,Urban,73,69,92,161,Kakamega,WESTERN,12045
MUMIAS,Urban,74,38,60,98,Kakamega,WESTERN,12046
MUMIAS,Urban,75,49,70,119,Kakamega,WESTERN,12047
MUMIAS,Urban,76,41,41,82,Kakamega,WESTERN,12048
MUMIAS,Urban,77,56,83,139,Kakamega,WESTERN,12049
MUMIAS,Urban,78,29,43,72,Kakamega,WESTERN,12050
MUMIAS,Urban,79,35,87,122,Kakamega,WESTERN,12051
MUMIAS,Urban,80+,328,432,760,Kakamega,WESTERN,12052
MUMIAS,Urban,Age NS,40,44,84,Kakamega,WESTERN,12053
BUTERE,Urban,0,209,208,417,Kakamega,WESTERN,12054
BUTERE,Urban,1,210,213,423,Kakamega,WESTERN,12055
BUTERE,Urban,2,209,229,438,Kakamega,WESTERN,12056
BUTERE,Urban,3,225,238,463,Kakamega,WESTERN,12057
BUTERE,Urban,4,203,203,406,Kakamega,WESTERN,12058
BUTERE,Urban,5,197,197,394,Kakamega,WESTERN,12059
BUTERE,Urban,6,170,225,395,Kakamega,WESTERN,12060
BUTERE,Urban,7,165,204,369,Kakamega,WESTERN,12061
BUTERE,Urban,8,177,190,367,Kakamega,WESTERN,12062
BUTERE,Urban,9,156,177,333,Kakamega,WESTERN,12063
BUTERE,Urban,10,165,177,342,Kakamega,WESTERN,12064
BUTERE,Urban,11,144,156,300,Kakamega,WESTERN,12065
BUTERE,Urban,12,152,199,351,Kakamega,WESTERN,12066
BUTERE,Urban,13,174,184,358,Kakamega,WESTERN,12067
BUTERE,Urban,14,163,158,321,Kakamega,WESTERN,12068
BUTERE,Urban,15,134,149,283,Kakamega,WESTERN,12069
BUTERE,Urban,16,169,169,338,Kakamega,WESTERN,12070
BUTERE,Urban,17,177,163,340,Kakamega,WESTERN,12071
BUTERE,Urban,18,173,143,316,Kakamega,WESTERN,12072
BUTERE,Urban,19,117,112,229,Kakamega,WESTERN,12073
BUTERE,Urban,20,131,162,293,Kakamega,WESTERN,12074
BUTERE,Urban,21,84,122,206,Kakamega,WESTERN,12075
BUTERE,Urban,22,100,145,245,Kakamega,WESTERN,12076
BUTERE,Urban,23,68,123,191,Kakamega,WESTERN,12077
BUTERE,Urban,24,94,125,219,Kakamega,WESTERN,12078
BUTERE,Urban,25,79,115,194,Kakamega,WESTERN,12079
BUTERE,Urban,26,84,108,192,Kakamega,WESTERN,12080
BUTERE,Urban,27,73,121,194,Kakamega,WESTERN,12081
BUTERE,Urban,28,68,96,164,Kakamega,WESTERN,12082
BUTERE,Urban,29,70,70,140,Kakamega,WESTERN,12083
BUTERE,Urban,30,94,115,209,Kakamega,WESTERN,12084
BUTERE,Urban,31,60,68,128,Kakamega,WESTERN,12085
BUTERE,Urban,32,56,93,149,Kakamega,WESTERN,12086
BUTERE,Urban,33,65,51,116,Kakamega,WESTERN,12087
BUTERE,Urban,34,52,80,132,Kakamega,WESTERN,12088
BUTERE,Urban,35,81,98,179,Kakamega,WESTERN,12089
BUTERE,Urban,36,50,54,104,Kakamega,WESTERN,12090
BUTERE,Urban,37,56,58,114,Kakamega,WESTERN,12091
BUTERE,Urban,38,51,57,108,Kakamega,WESTERN,12092
BUTERE,Urban,39,48,69,117,Kakamega,WESTERN,12093
BUTERE,Urban,40,83,114,197,Kakamega,WESTERN,12094
BUTERE,Urban,41,45,48,93,Kakamega,WESTERN,12095
BUTERE,Urban,42,55,33,88,Kakamega,WESTERN,12096
BUTERE,Urban,43,49,38,87,Kakamega,WESTERN,12097
BUTERE,Urban,44,47,49,96,Kakamega,WESTERN,12098
BUTERE,Urban,45,54,75,129,Kakamega,WESTERN,12099
BUTERE,Urban,46,52,43,95,Kakamega,WESTERN,12100
BUTERE,Urban,47,39,53,92,Kakamega,WESTERN,12101
BUTERE,Urban,48,39,42,81,Kakamega,WESTERN,12102
BUTERE,Urban,49,48,41,89,Kakamega,WESTERN,12103
BUTERE,Urban,50,36,54,90,Kakamega,WESTERN,12104
BUTERE,Urban,51,35,34,69,Kakamega,WESTERN,12105
BUTERE,Urban,52,38,26,64,Kakamega,WESTERN,12106
BUTERE,Urban,53,34,27,61,Kakamega,WESTERN,12107
BUTERE,Urban,54,31,29,60,Kakamega,WESTERN,12108
BUTERE,Urban,55,35,35,70,Kakamega,WESTERN,12109
BUTERE,Urban,56,19,20,39,Kakamega,WESTERN,12110
BUTERE,Urban,57,27,20,47,Kakamega,WESTERN,12111
BUTERE,Urban,58,8,14,22,Kakamega,WESTERN,12112
BUTERE,Urban,59,17,15,32,Kakamega,WESTERN,12113
BUTERE,Urban,60,21,28,49,Kakamega,WESTERN,12114
BUTERE,Urban,61,11,18,29,Kakamega,WESTERN,12115
BUTERE,Urban,62,22,15,37,Kakamega,WESTERN,12116
BUTERE,Urban,63,12,11,23,Kakamega,WESTERN,12117
BUTERE,Urban,64,13,24,37,Kakamega,WESTERN,12118
BUTERE,Urban,65,12,17,29,Kakamega,WESTERN,12119
BUTERE,Urban,66,15,24,39,Kakamega,WESTERN,12120
BUTERE,Urban,67,15,9,24,Kakamega,WESTERN,12121
BUTERE,Urban,68,12,10,22,Kakamega,WESTERN,12122
BUTERE,Urban,69,2,13,15,Kakamega,WESTERN,12123
BUTERE,Urban,70,12,29,41,Kakamega,WESTERN,12124
BUTERE,Urban,71,12,9,21,Kakamega,WESTERN,12125
BUTERE,Urban,72,9,9,18,Kakamega,WESTERN,12126
BUTERE,Urban,73,9,13,22,Kakamega,WESTERN,12127
BUTERE,Urban,74,6,4,10,Kakamega,WESTERN,12128
BUTERE,Urban,75,15,9,24,Kakamega,WESTERN,12129
BUTERE,Urban,76,6,9,15,Kakamega,WESTERN,12130
BUTERE,Urban,77,7,16,23,Kakamega,WESTERN,12131
BUTERE,Urban,78,8,5,13,Kakamega,WESTERN,12132
BUTERE,Urban,79,4,16,20,Kakamega,WESTERN,12133
BUTERE,Urban,80+,30,60,90,Kakamega,WESTERN,12134
BUTERE,Urban,Age NS,1,0,1,Kakamega,WESTERN,12135
BUNGOMA SOUTH,Urban,0,1611,1511,3122,Bungoma,WESTERN,12136
BUNGOMA SOUTH,Urban,1,1395,1323,2718,Bungoma,WESTERN,12137
BUNGOMA SOUTH,Urban,2,1511,1454,2965,Bungoma,WESTERN,12138
BUNGOMA SOUTH,Urban,3,1483,1484,2967,Bungoma,WESTERN,12139
BUNGOMA SOUTH,Urban,4,1389,1406,2795,Bungoma,WESTERN,12140
BUNGOMA SOUTH,Urban,5,1422,1409,2831,Bungoma,WESTERN,12141
BUNGOMA SOUTH,Urban,6,1267,1335,2602,Bungoma,WESTERN,12142
BUNGOMA SOUTH,Urban,7,1228,1243,2471,Bungoma,WESTERN,12143
BUNGOMA SOUTH,Urban,8,1163,1303,2466,Bungoma,WESTERN,12144
BUNGOMA SOUTH,Urban,9,1227,1359,2586,Bungoma,WESTERN,12145
BUNGOMA SOUTH,Urban,10,1308,1327,2635,Bungoma,WESTERN,12146
BUNGOMA SOUTH,Urban,11,1113,1177,2290,Bungoma,WESTERN,12147
BUNGOMA SOUTH,Urban,12,1234,1326,2560,Bungoma,WESTERN,12148
BUNGOMA SOUTH,Urban,13,1238,1261,2499,Bungoma,WESTERN,12149
BUNGOMA SOUTH,Urban,14,1085,1124,2209,Bungoma,WESTERN,12150
BUNGOMA SOUTH,Urban,15,1074,1177,2251,Bungoma,WESTERN,12151
BUNGOMA SOUTH,Urban,16,1007,1059,2066,Bungoma,WESTERN,12152
BUNGOMA SOUTH,Urban,17,1235,1185,2420,Bungoma,WESTERN,12153
BUNGOMA SOUTH,Urban,18,1106,1081,2187,Bungoma,WESTERN,12154
BUNGOMA SOUTH,Urban,19,996,1072,2068,Bungoma,WESTERN,12155
BUNGOMA SOUTH,Urban,20,1042,1361,2403,Bungoma,WESTERN,12156
BUNGOMA SOUTH,Urban,21,909,1025,1934,Bungoma,WESTERN,12157
BUNGOMA SOUTH,Urban,22,983,1281,2264,Bungoma,WESTERN,12158
BUNGOMA SOUTH,Urban,23,984,1164,2148,Bungoma,WESTERN,12159
BUNGOMA SOUTH,Urban,24,904,1103,2007,Bungoma,WESTERN,12160
BUNGOMA SOUTH,Urban,25,1064,1222,2286,Bungoma,WESTERN,12161
BUNGOMA SOUTH,Urban,26,887,905,1792,Bungoma,WESTERN,12162
BUNGOMA SOUTH,Urban,27,875,870,1745,Bungoma,WESTERN,12163
BUNGOMA SOUTH,Urban,28,855,870,1725,Bungoma,WESTERN,12164
BUNGOMA SOUTH,Urban,29,737,634,1371,Bungoma,WESTERN,12165
BUNGOMA SOUTH,Urban,30,938,952,1890,Bungoma,WESTERN,12166
BUNGOMA SOUTH,Urban,31,610,524,1134,Bungoma,WESTERN,12167
BUNGOMA SOUTH,Urban,32,751,688,1439,Bungoma,WESTERN,12168
BUNGOMA SOUTH,Urban,33,542,464,1006,Bungoma,WESTERN,12169
BUNGOMA SOUTH,Urban,34,508,487,995,Bungoma,WESTERN,12170
BUNGOMA SOUTH,Urban,35,715,732,1447,Bungoma,WESTERN,12171
BUNGOMA SOUTH,Urban,36,487,435,922,Bungoma,WESTERN,12172
BUNGOMA SOUTH,Urban,37,506,451,957,Bungoma,WESTERN,12173
BUNGOMA SOUTH,Urban,38,400,426,826,Bungoma,WESTERN,12174
BUNGOMA SOUTH,Urban,39,430,358,788,Bungoma,WESTERN,12175
BUNGOMA SOUTH,Urban,40,561,541,1102,Bungoma,WESTERN,12176
BUNGOMA SOUTH,Urban,41,320,276,596,Bungoma,WESTERN,12177
BUNGOMA SOUTH,Urban,42,377,324,701,Bungoma,WESTERN,12178
BUNGOMA SOUTH,Urban,43,311,288,599,Bungoma,WESTERN,12179
BUNGOMA SOUTH,Urban,44,242,227,469,Bungoma,WESTERN,12180
BUNGOMA SOUTH,Urban,45,398,354,752,Bungoma,WESTERN,12181
BUNGOMA SOUTH,Urban,46,288,267,555,Bungoma,WESTERN,12182
BUNGOMA SOUTH,Urban,47,234,233,467,Bungoma,WESTERN,12183
BUNGOMA SOUTH,Urban,48,219,271,490,Bungoma,WESTERN,12184
BUNGOMA SOUTH,Urban,49,252,251,503,Bungoma,WESTERN,12185
BUNGOMA SOUTH,Urban,50,290,291,581,Bungoma,WESTERN,12186
BUNGOMA SOUTH,Urban,51,208,200,408,Bungoma,WESTERN,12187
BUNGOMA SOUTH,Urban,52,215,172,387,Bungoma,WESTERN,12188
BUNGOMA SOUTH,Urban,53,168,168,336,Bungoma,WESTERN,12189
BUNGOMA SOUTH,Urban,54,164,155,319,Bungoma,WESTERN,12190
BUNGOMA SOUTH,Urban,55,187,222,409,Bungoma,WESTERN,12191
BUNGOMA SOUTH,Urban,56,127,141,268,Bungoma,WESTERN,12192
BUNGOMA SOUTH,Urban,57,153,178,331,Bungoma,WESTERN,12193
BUNGOMA SOUTH,Urban,58,98,89,187,Bungoma,WESTERN,12194
BUNGOMA SOUTH,Urban,59,120,123,243,Bungoma,WESTERN,12195
BUNGOMA SOUTH,Urban,60,127,132,259,Bungoma,WESTERN,12196
BUNGOMA SOUTH,Urban,61,103,101,204,Bungoma,WESTERN,12197
BUNGOMA SOUTH,Urban,62,86,75,161,Bungoma,WESTERN,12198
BUNGOMA SOUTH,Urban,63,83,63,146,Bungoma,WESTERN,12199
BUNGOMA SOUTH,Urban,64,83,81,164,Bungoma,WESTERN,12200
BUNGOMA SOUTH,Urban,65,89,91,180,Bungoma,WESTERN,12201
BUNGOMA SOUTH,Urban,66,43,58,101,Bungoma,WESTERN,12202
BUNGOMA SOUTH,Urban,67,74,85,159,Bungoma,WESTERN,12203
BUNGOMA SOUTH,Urban,68,47,45,92,Bungoma,WESTERN,12204
BUNGOMA SOUTH,Urban,69,46,60,106,Bungoma,WESTERN,12205
BUNGOMA SOUTH,Urban,70,82,81,163,Bungoma,WESTERN,12206
BUNGOMA SOUTH,Urban,71,32,40,72,Bungoma,WESTERN,12207
BUNGOMA SOUTH,Urban,72,46,30,76,Bungoma,WESTERN,12208
BUNGOMA SOUTH,Urban,73,45,63,108,Bungoma,WESTERN,12209
BUNGOMA SOUTH,Urban,74,25,30,55,Bungoma,WESTERN,12210
BUNGOMA SOUTH,Urban,75,36,35,71,Bungoma,WESTERN,12211
BUNGOMA SOUTH,Urban,76,24,33,57,Bungoma,WESTERN,12212
BUNGOMA SOUTH,Urban,77,47,54,101,Bungoma,WESTERN,12213
BUNGOMA SOUTH,Urban,78,21,25,46,Bungoma,WESTERN,12214
BUNGOMA SOUTH,Urban,79,36,51,87,Bungoma,WESTERN,12215
BUNGOMA SOUTH,Urban,80+,170,284,454,Bungoma,WESTERN,12216
BUNGOMA SOUTH,Urban,Age NS,60,41,101,Bungoma,WESTERN,12217
BUNGOMA NORTH,Urban,0,1912,1836,3748,Bungoma,WESTERN,12218
BUNGOMA NORTH,Urban,1,1617,1655,3272,Bungoma,WESTERN,12219
BUNGOMA NORTH,Urban,2,1824,1964,3788,Bungoma,WESTERN,12220
BUNGOMA NORTH,Urban,3,1785,1825,3610,Bungoma,WESTERN,12221
BUNGOMA NORTH,Urban,4,1721,1709,3430,Bungoma,WESTERN,12222
BUNGOMA NORTH,Urban,5,1776,1675,3451,Bungoma,WESTERN,12223
BUNGOMA NORTH,Urban,6,1660,1670,3330,Bungoma,WESTERN,12224
BUNGOMA NORTH,Urban,7,1543,1574,3117,Bungoma,WESTERN,12225
BUNGOMA NORTH,Urban,8,1561,1518,3079,Bungoma,WESTERN,12226
BUNGOMA NORTH,Urban,9,1500,1519,3019,Bungoma,WESTERN,12227
BUNGOMA NORTH,Urban,10,1585,1567,3152,Bungoma,WESTERN,12228
BUNGOMA NORTH,Urban,11,1256,1171,2427,Bungoma,WESTERN,12229
BUNGOMA NORTH,Urban,12,1489,1497,2986,Bungoma,WESTERN,12230
BUNGOMA NORTH,Urban,13,1323,1322,2645,Bungoma,WESTERN,12231
BUNGOMA NORTH,Urban,14,1196,1231,2427,Bungoma,WESTERN,12232
BUNGOMA NORTH,Urban,15,1112,1198,2310,Bungoma,WESTERN,12233
BUNGOMA NORTH,Urban,16,1031,1145,2176,Bungoma,WESTERN,12234
BUNGOMA NORTH,Urban,17,1109,1076,2185,Bungoma,WESTERN,12235
BUNGOMA NORTH,Urban,18,1013,1048,2061,Bungoma,WESTERN,12236
BUNGOMA NORTH,Urban,19,919,962,1881,Bungoma,WESTERN,12237
BUNGOMA NORTH,Urban,20,945,1019,1964,Bungoma,WESTERN,12238
BUNGOMA NORTH,Urban,21,775,900,1675,Bungoma,WESTERN,12239
BUNGOMA NORTH,Urban,22,753,966,1719,Bungoma,WESTERN,12240
BUNGOMA NORTH,Urban,23,709,928,1637,Bungoma,WESTERN,12241
BUNGOMA NORTH,Urban,24,695,819,1514,Bungoma,WESTERN,12242
BUNGOMA NORTH,Urban,25,782,896,1678,Bungoma,WESTERN,12243
BUNGOMA NORTH,Urban,26,579,732,1311,Bungoma,WESTERN,12244
BUNGOMA NORTH,Urban,27,570,638,1208,Bungoma,WESTERN,12245
BUNGOMA NORTH,Urban,28,527,605,1132,Bungoma,WESTERN,12246
BUNGOMA NORTH,Urban,29,497,608,1105,Bungoma,WESTERN,12247
BUNGOMA NORTH,Urban,30,695,715,1410,Bungoma,WESTERN,12248
BUNGOMA NORTH,Urban,31,439,550,989,Bungoma,WESTERN,12249
BUNGOMA NORTH,Urban,32,523,599,1122,Bungoma,WESTERN,12250
BUNGOMA NORTH,Urban,33,459,553,1012,Bungoma,WESTERN,12251
BUNGOMA EAST,Urban,48,164,194,358,Bungoma,WESTERN,12252
BUNGOMA NORTH,Urban,34,417,481,898,Bungoma,WESTERN,12253
BUNGOMA NORTH,Urban,35,609,656,1265,Bungoma,WESTERN,12254
BUNGOMA NORTH,Urban,36,428,424,852,Bungoma,WESTERN,12255
BUNGOMA NORTH,Urban,37,406,399,805,Bungoma,WESTERN,12256
BUNGOMA NORTH,Urban,38,353,405,758,Bungoma,WESTERN,12257
BUNGOMA NORTH,Urban,39,361,412,773,Bungoma,WESTERN,12258
BUNGOMA NORTH,Urban,40,441,504,945,Bungoma,WESTERN,12259
BUNGOMA NORTH,Urban,41,320,321,641,Bungoma,WESTERN,12260
BUNGOMA NORTH,Urban,42,297,331,628,Bungoma,WESTERN,12261
BUNGOMA NORTH,Urban,43,261,317,578,Bungoma,WESTERN,12262
BUNGOMA NORTH,Urban,44,224,290,514,Bungoma,WESTERN,12263
BUNGOMA NORTH,Urban,45,346,415,761,Bungoma,WESTERN,12264
BUNGOMA NORTH,Urban,46,293,354,647,Bungoma,WESTERN,12265
BUNGOMA NORTH,Urban,47,304,325,629,Bungoma,WESTERN,12266
BUNGOMA NORTH,Urban,48,251,288,539,Bungoma,WESTERN,12267
BUNGOMA NORTH,Urban,49,306,275,581,Bungoma,WESTERN,12268
BUNGOMA NORTH,Urban,50,311,315,626,Bungoma,WESTERN,12269
BUNGOMA NORTH,Urban,51,204,243,447,Bungoma,WESTERN,12270
BUNGOMA NORTH,Urban,52,190,231,421,Bungoma,WESTERN,12271
BUNGOMA NORTH,Urban,53,229,228,457,Bungoma,WESTERN,12272
BUNGOMA NORTH,Urban,54,199,210,409,Bungoma,WESTERN,12273
BUNGOMA NORTH,Urban,55,197,225,422,Bungoma,WESTERN,12274
BUNGOMA NORTH,Urban,56,153,180,333,Bungoma,WESTERN,12275
BUNGOMA NORTH,Urban,57,162,182,344,Bungoma,WESTERN,12276
BUNGOMA NORTH,Urban,58,128,129,257,Bungoma,WESTERN,12277
BUNGOMA NORTH,Urban,59,148,151,299,Bungoma,WESTERN,12278
BUNGOMA NORTH,Urban,60,153,174,327,Bungoma,WESTERN,12279
BUNGOMA NORTH,Urban,61,139,140,279,Bungoma,WESTERN,12280
BUNGOMA NORTH,Urban,62,105,133,238,Bungoma,WESTERN,12281
BUNGOMA NORTH,Urban,63,131,127,258,Bungoma,WESTERN,12282
BUNGOMA NORTH,Urban,64,97,118,215,Bungoma,WESTERN,12283
BUNGOMA NORTH,Urban,65,114,124,238,Bungoma,WESTERN,12284
BUNGOMA NORTH,Urban,66,89,100,189,Bungoma,WESTERN,12285
BUNGOMA NORTH,Urban,67,96,125,221,Bungoma,WESTERN,12286
BUNGOMA NORTH,Urban,68,84,74,158,Bungoma,WESTERN,12287
BUNGOMA NORTH,Urban,69,63,75,138,Bungoma,WESTERN,12288
BUNGOMA NORTH,Urban,70,86,118,204,Bungoma,WESTERN,12289
BUNGOMA NORTH,Urban,71,58,65,123,Bungoma,WESTERN,12290
BUNGOMA NORTH,Urban,72,79,88,167,Bungoma,WESTERN,12291
BUNGOMA NORTH,Urban,73,67,98,165,Bungoma,WESTERN,12292
BUNGOMA NORTH,Urban,74,53,61,114,Bungoma,WESTERN,12293
BUNGOMA NORTH,Urban,75,64,64,128,Bungoma,WESTERN,12294
BUNGOMA NORTH,Urban,76,48,74,122,Bungoma,WESTERN,12295
BUNGOMA NORTH,Urban,77,50,65,115,Bungoma,WESTERN,12296
BUNGOMA NORTH,Urban,78,40,41,81,Bungoma,WESTERN,12297
BUNGOMA NORTH,Urban,79,41,60,101,Bungoma,WESTERN,12298
BUNGOMA NORTH,Urban,80+,268,463,731,Bungoma,WESTERN,12299
BUNGOMA NORTH,Urban,Age NS,11,5,16,Bungoma,WESTERN,12300
BUNGOMA EAST,Urban,0,1065,1044,2109,Bungoma,WESTERN,12301
BUNGOMA EAST,Urban,1,1043,978,2021,Bungoma,WESTERN,12302
BUNGOMA EAST,Urban,2,1044,960,2004,Bungoma,WESTERN,12303
BUNGOMA EAST,Urban,3,1009,1039,2048,Bungoma,WESTERN,12304
BUNGOMA EAST,Urban,4,968,985,1953,Bungoma,WESTERN,12305
BUNGOMA EAST,Urban,5,946,1095,2041,Bungoma,WESTERN,12306
BUNGOMA EAST,Urban,6,863,934,1797,Bungoma,WESTERN,12307
BUNGOMA EAST,Urban,7,976,924,1900,Bungoma,WESTERN,12308
BUNGOMA EAST,Urban,8,906,827,1733,Bungoma,WESTERN,12309
BUNGOMA EAST,Urban,9,918,911,1829,Bungoma,WESTERN,12310
BUNGOMA EAST,Urban,10,923,874,1797,Bungoma,WESTERN,12311
BUNGOMA EAST,Urban,11,727,743,1470,Bungoma,WESTERN,12312
BUNGOMA EAST,Urban,12,859,809,1668,Bungoma,WESTERN,12313
BUNGOMA EAST,Urban,13,774,827,1601,Bungoma,WESTERN,12314
BUNGOMA EAST,Urban,14,730,771,1501,Bungoma,WESTERN,12315
BUNGOMA EAST,Urban,15,744,745,1489,Bungoma,WESTERN,12316
BUNGOMA EAST,Urban,16,714,702,1416,Bungoma,WESTERN,12317
BUNGOMA EAST,Urban,17,713,711,1424,Bungoma,WESTERN,12318
BUNGOMA EAST,Urban,18,675,725,1400,Bungoma,WESTERN,12319
BUNGOMA EAST,Urban,19,621,651,1272,Bungoma,WESTERN,12320
BUNGOMA EAST,Urban,20,649,834,1483,Bungoma,WESTERN,12321
BUNGOMA EAST,Urban,21,518,651,1169,Bungoma,WESTERN,12322
BUNGOMA EAST,Urban,22,577,735,1312,Bungoma,WESTERN,12323
BUNGOMA EAST,Urban,23,577,663,1240,Bungoma,WESTERN,12324
BUNGOMA EAST,Urban,24,470,583,1053,Bungoma,WESTERN,12325
BUNGOMA EAST,Urban,25,559,718,1277,Bungoma,WESTERN,12326
BUNGOMA EAST,Urban,26,490,554,1044,Bungoma,WESTERN,12327
BUNGOMA EAST,Urban,27,502,574,1076,Bungoma,WESTERN,12328
BUNGOMA EAST,Urban,28,447,528,975,Bungoma,WESTERN,12329
BUNGOMA EAST,Urban,29,439,472,911,Bungoma,WESTERN,12330
BUNGOMA EAST,Urban,30,530,641,1171,Bungoma,WESTERN,12331
BUNGOMA EAST,Urban,31,370,357,727,Bungoma,WESTERN,12332
BUNGOMA EAST,Urban,32,436,443,879,Bungoma,WESTERN,12333
BUNGOMA EAST,Urban,33,308,289,597,Bungoma,WESTERN,12334
BUNGOMA EAST,Urban,34,282,297,579,Bungoma,WESTERN,12335
BUNGOMA EAST,Urban,35,493,457,950,Bungoma,WESTERN,12336
BUNGOMA EAST,Urban,36,261,258,519,Bungoma,WESTERN,12337
BUNGOMA EAST,Urban,37,307,255,562,Bungoma,WESTERN,12338
BUNGOMA EAST,Urban,38,247,301,548,Bungoma,WESTERN,12339
BUNGOMA EAST,Urban,39,275,244,519,Bungoma,WESTERN,12340
BUNGOMA EAST,Urban,40,347,387,734,Bungoma,WESTERN,12341
BUNGOMA EAST,Urban,41,202,188,390,Bungoma,WESTERN,12342
BUNGOMA EAST,Urban,42,224,218,442,Bungoma,WESTERN,12343
BUNGOMA EAST,Urban,43,181,189,370,Bungoma,WESTERN,12344
BUNGOMA EAST,Urban,44,173,182,355,Bungoma,WESTERN,12345
BUNGOMA EAST,Urban,45,281,267,548,Bungoma,WESTERN,12346
BUNGOMA EAST,Urban,46,206,181,387,Bungoma,WESTERN,12347
BUNGOMA EAST,Urban,47,226,189,415,Bungoma,WESTERN,12348
BUNGOMA EAST,Urban,49,224,195,419,Bungoma,WESTERN,12349
BUNGOMA EAST,Urban,50,193,208,401,Bungoma,WESTERN,12350
BUNGOMA EAST,Urban,51,147,145,292,Bungoma,WESTERN,12351
BUNGOMA EAST,Urban,52,150,143,293,Bungoma,WESTERN,12352
BUNGOMA EAST,Urban,53,152,140,292,Bungoma,WESTERN,12353
BUNGOMA EAST,Urban,54,112,98,210,Bungoma,WESTERN,12354
BUNGOMA EAST,Urban,55,152,141,293,Bungoma,WESTERN,12355
BUNGOMA EAST,Urban,56,99,94,193,Bungoma,WESTERN,12356
BUNGOMA EAST,Urban,57,129,101,230,Bungoma,WESTERN,12357
BUNGOMA EAST,Urban,58,80,64,144,Bungoma,WESTERN,12358
BUNGOMA EAST,Urban,59,75,100,175,Bungoma,WESTERN,12359
BUNGOMA EAST,Urban,60,101,91,192,Bungoma,WESTERN,12360
BUNGOMA EAST,Urban,61,75,76,151,Bungoma,WESTERN,12361
BUNGOMA EAST,Urban,62,63,71,134,Bungoma,WESTERN,12362
BUNGOMA EAST,Urban,63,63,66,129,Bungoma,WESTERN,12363
BUNGOMA EAST,Urban,64,70,47,117,Bungoma,WESTERN,12364
BUNGOMA EAST,Urban,65,57,55,112,Bungoma,WESTERN,12365
BUNGOMA EAST,Urban,66,34,49,83,Bungoma,WESTERN,12366
BUNGOMA EAST,Urban,67,47,72,119,Bungoma,WESTERN,12367
BUNGOMA EAST,Urban,68,37,32,69,Bungoma,WESTERN,12368
BUNGOMA EAST,Urban,69,31,44,75,Bungoma,WESTERN,12369
BUNGOMA EAST,Urban,70,45,58,103,Bungoma,WESTERN,12370
BUNGOMA EAST,Urban,71,27,36,63,Bungoma,WESTERN,12371
BUNGOMA EAST,Urban,72,32,32,64,Bungoma,WESTERN,12372
BUNGOMA EAST,Urban,73,40,39,79,Bungoma,WESTERN,12373
BUNGOMA EAST,Urban,74,19,23,42,Bungoma,WESTERN,12374
BUNGOMA EAST,Urban,75,34,34,68,Bungoma,WESTERN,12375
BUNGOMA EAST,Urban,76,15,15,30,Bungoma,WESTERN,12376
BUNGOMA EAST,Urban,77,33,34,67,Bungoma,WESTERN,12377
BUNGOMA EAST,Urban,78,25,15,40,Bungoma,WESTERN,12378
BUNGOMA EAST,Urban,79,29,35,64,Bungoma,WESTERN,12379
BUNGOMA EAST,Urban,80+,151,207,358,Bungoma,WESTERN,12380
BUNGOMA EAST,Urban,Age NS,16,10,26,Bungoma,WESTERN,12381
BUNGOMA WEST,Urban,0,646,682,1328,Bungoma,WESTERN,12382
BUNGOMA WEST,Urban,1,606,570,1176,Bungoma,WESTERN,12383
BUNGOMA WEST,Urban,2,688,635,1323,Bungoma,WESTERN,12384
BUNGOMA WEST,Urban,3,609,660,1269,Bungoma,WESTERN,12385
BUNGOMA WEST,Urban,4,608,595,1203,Bungoma,WESTERN,12386
BUNGOMA WEST,Urban,5,587,614,1201,Bungoma,WESTERN,12387
BUNGOMA WEST,Urban,6,554,570,1124,Bungoma,WESTERN,12388
BUNGOMA WEST,Urban,7,532,534,1066,Bungoma,WESTERN,12389
BUNGOMA WEST,Urban,8,471,502,973,Bungoma,WESTERN,12390
BUNGOMA WEST,Urban,9,488,512,1000,Bungoma,WESTERN,12391
BUNGOMA WEST,Urban,10,483,498,981,Bungoma,WESTERN,12392
BUNGOMA WEST,Urban,11,412,379,791,Bungoma,WESTERN,12393
BUNGOMA WEST,Urban,12,460,486,946,Bungoma,WESTERN,12394
BUNGOMA WEST,Urban,13,431,431,862,Bungoma,WESTERN,12395
BUNGOMA WEST,Urban,14,374,429,803,Bungoma,WESTERN,12396
BUNGOMA WEST,Urban,15,411,430,841,Bungoma,WESTERN,12397
BUNGOMA WEST,Urban,16,358,381,739,Bungoma,WESTERN,12398
BUNGOMA WEST,Urban,17,405,405,810,Bungoma,WESTERN,12399
BUNGOMA WEST,Urban,18,313,386,699,Bungoma,WESTERN,12400
BUNGOMA WEST,Urban,19,273,381,654,Bungoma,WESTERN,12401
BUNGOMA WEST,Urban,20,337,421,758,Bungoma,WESTERN,12402
BUNGOMA WEST,Urban,21,259,337,596,Bungoma,WESTERN,12403
BUNGOMA WEST,Urban,22,294,375,669,Bungoma,WESTERN,12404
BUNGOMA WEST,Urban,23,289,376,665,Bungoma,WESTERN,12405
BUNGOMA WEST,Urban,24,264,332,596,Bungoma,WESTERN,12406
BUNGOMA WEST,Urban,25,282,357,639,Bungoma,WESTERN,12407
BUNGOMA WEST,Urban,26,217,295,512,Bungoma,WESTERN,12408
BUNGOMA WEST,Urban,27,229,284,513,Bungoma,WESTERN,12409
BUNGOMA WEST,Urban,28,200,230,430,Bungoma,WESTERN,12410
BUNGOMA WEST,Urban,29,219,202,421,Bungoma,WESTERN,12411
BUNGOMA WEST,Urban,30,269,303,572,Bungoma,WESTERN,12412
BUNGOMA WEST,Urban,31,199,167,366,Bungoma,WESTERN,12413
BUNGOMA WEST,Urban,32,214,261,475,Bungoma,WESTERN,12414
BUNGOMA WEST,Urban,33,168,173,341,Bungoma,WESTERN,12415
BUNGOMA WEST,Urban,34,138,161,299,Bungoma,WESTERN,12416
BUNGOMA WEST,Urban,35,229,216,445,Bungoma,WESTERN,12417
BUNGOMA WEST,Urban,36,142,141,283,Bungoma,WESTERN,12418
BUNGOMA WEST,Urban,37,137,163,300,Bungoma,WESTERN,12419
BUNGOMA WEST,Urban,38,161,145,306,Bungoma,WESTERN,12420
BUNGOMA WEST,Urban,39,115,128,243,Bungoma,WESTERN,12421
BUNGOMA WEST,Urban,40,152,175,327,Bungoma,WESTERN,12422
BUNGOMA WEST,Urban,41,92,104,196,Bungoma,WESTERN,12423
BUNGOMA WEST,Urban,42,92,112,204,Bungoma,WESTERN,12424
BUNGOMA WEST,Urban,43,98,107,205,Bungoma,WESTERN,12425
BUNGOMA WEST,Urban,44,90,105,195,Bungoma,WESTERN,12426
BUNGOMA WEST,Urban,45,137,156,293,Bungoma,WESTERN,12427
BUNGOMA WEST,Urban,46,99,98,197,Bungoma,WESTERN,12428
BUNGOMA WEST,Urban,47,98,98,196,Bungoma,WESTERN,12429
BUNGOMA WEST,Urban,48,75,95,170,Bungoma,WESTERN,12430
BUNGOMA WEST,Urban,49,112,104,216,Bungoma,WESTERN,12431
BUNGOMA WEST,Urban,50,108,90,198,Bungoma,WESTERN,12432
BUNGOMA WEST,Urban,51,61,83,144,Bungoma,WESTERN,12433
BUNGOMA WEST,Urban,52,76,86,162,Bungoma,WESTERN,12434
BUNGOMA WEST,Urban,53,59,91,150,Bungoma,WESTERN,12435
BUNGOMA WEST,Urban,54,60,51,111,Bungoma,WESTERN,12436
BUNGOMA WEST,Urban,55,75,85,160,Bungoma,WESTERN,12437
BUNGOMA WEST,Urban,56,67,66,133,Bungoma,WESTERN,12438
BUNGOMA WEST,Urban,57,57,71,128,Bungoma,WESTERN,12439
BUNGOMA WEST,Urban,58,37,25,62,Bungoma,WESTERN,12440
BUNGOMA WEST,Urban,59,46,62,108,Bungoma,WESTERN,12441
BUNGOMA WEST,Urban,60,56,60,116,Bungoma,WESTERN,12442
BUNGOMA WEST,Urban,61,48,70,118,Bungoma,WESTERN,12443
BUNGOMA WEST,Urban,62,35,35,70,Bungoma,WESTERN,12444
BUNGOMA WEST,Urban,63,47,45,92,Bungoma,WESTERN,12445
BUNGOMA WEST,Urban,64,30,27,57,Bungoma,WESTERN,12446
BUNGOMA WEST,Urban,65,36,52,88,Bungoma,WESTERN,12447
BUNGOMA WEST,Urban,66,19,15,34,Bungoma,WESTERN,12448
BUNGOMA WEST,Urban,67,25,40,65,Bungoma,WESTERN,12449
BUNGOMA WEST,Urban,68,16,12,28,Bungoma,WESTERN,12450
BUNGOMA WEST,Urban,69,21,33,54,Bungoma,WESTERN,12451
BUNGOMA WEST,Urban,70,40,52,92,Bungoma,WESTERN,12452
BUNGOMA WEST,Urban,71,31,25,56,Bungoma,WESTERN,12453
BUNGOMA WEST,Urban,72,16,24,40,Bungoma,WESTERN,12454
BUNGOMA WEST,Urban,73,31,21,52,Bungoma,WESTERN,12455
BUNGOMA WEST,Urban,74,19,22,41,Bungoma,WESTERN,12456
BUNGOMA WEST,Urban,75,26,26,52,Bungoma,WESTERN,12457
BUNGOMA WEST,Urban,76,12,25,37,Bungoma,WESTERN,12458
BUNGOMA WEST,Urban,77,30,25,55,Bungoma,WESTERN,12459
BUNGOMA WEST,Urban,78,11,18,29,Bungoma,WESTERN,12460
BUNGOMA WEST,Urban,79,15,28,43,Bungoma,WESTERN,12461
BUNGOMA WEST,Urban,80+,109,142,251,Bungoma,WESTERN,12462
BUNGOMA WEST,Urban,Age NS,4,2,6,Bungoma,WESTERN,12463
MT. ELGON,Urban,0,211,184,395,Bungoma,WESTERN,12464
MT. ELGON,Urban,1,153,145,298,Bungoma,WESTERN,12465
MT. ELGON,Urban,2,170,163,333,Bungoma,WESTERN,12466
MT. ELGON,Urban,3,154,171,325,Bungoma,WESTERN,12467
MT. ELGON,Urban,4,149,173,322,Bungoma,WESTERN,12468
MT. ELGON,Urban,5,181,170,351,Bungoma,WESTERN,12469
MT. ELGON,Urban,6,176,154,330,Bungoma,WESTERN,12470
MT. ELGON,Urban,7,147,151,298,Bungoma,WESTERN,12471
MT. ELGON,Urban,8,156,149,305,Bungoma,WESTERN,12472
MT. ELGON,Urban,9,136,142,278,Bungoma,WESTERN,12473
MT. ELGON,Urban,10,165,137,302,Bungoma,WESTERN,12474
MT. ELGON,Urban,11,108,137,245,Bungoma,WESTERN,12475
MT. ELGON,Urban,12,157,164,321,Bungoma,WESTERN,12476
MT. ELGON,Urban,13,114,151,265,Bungoma,WESTERN,12477
MT. ELGON,Urban,14,118,129,247,Bungoma,WESTERN,12478
MT. ELGON,Urban,15,128,129,257,Bungoma,WESTERN,12479
MT. ELGON,Urban,16,98,119,217,Bungoma,WESTERN,12480
MT. ELGON,Urban,17,114,112,226,Bungoma,WESTERN,12481
MT. ELGON,Urban,18,86,99,185,Bungoma,WESTERN,12482
MT. ELGON,Urban,19,97,99,196,Bungoma,WESTERN,12483
MT. ELGON,Urban,20,89,144,233,Bungoma,WESTERN,12484
MT. ELGON,Urban,21,95,113,208,Bungoma,WESTERN,12485
MT. ELGON,Urban,22,94,141,235,Bungoma,WESTERN,12486
MT. ELGON,Urban,23,102,110,212,Bungoma,WESTERN,12487
MT. ELGON,Urban,24,72,112,184,Bungoma,WESTERN,12488
MT. ELGON,Urban,25,106,104,210,Bungoma,WESTERN,12489
MT. ELGON,Urban,26,79,92,171,Bungoma,WESTERN,12490
MT. ELGON,Urban,27,78,98,176,Bungoma,WESTERN,12491
MT. ELGON,Urban,28,52,68,120,Bungoma,WESTERN,12492
MT. ELGON,Urban,29,73,57,130,Bungoma,WESTERN,12493
MT. ELGON,Urban,30,58,86,144,Bungoma,WESTERN,12494
MT. ELGON,Urban,31,64,51,115,Bungoma,WESTERN,12495
MT. ELGON,Urban,32,52,68,120,Bungoma,WESTERN,12496
MT. ELGON,Urban,33,45,57,102,Bungoma,WESTERN,12497
MT. ELGON,Urban,34,60,51,111,Bungoma,WESTERN,12498
MT. ELGON,Urban,35,80,80,160,Bungoma,WESTERN,12499
MT. ELGON,Urban,36,49,57,106,Bungoma,WESTERN,12500
MT. ELGON,Urban,37,54,45,99,Bungoma,WESTERN,12501
MT. ELGON,Urban,38,34,43,77,Bungoma,WESTERN,12502
MT. ELGON,Urban,39,36,42,78,Bungoma,WESTERN,12503
MT. ELGON,Urban,40,54,63,117,Bungoma,WESTERN,12504
MT. ELGON,Urban,41,40,29,69,Bungoma,WESTERN,12505
MT. ELGON,Urban,42,31,28,59,Bungoma,WESTERN,12506
MT. ELGON,Urban,43,23,34,57,Bungoma,WESTERN,12507
MT. ELGON,Urban,44,31,25,56,Bungoma,WESTERN,12508
MT. ELGON,Urban,45,49,38,87,Bungoma,WESTERN,12509
MT. ELGON,Urban,46,46,38,84,Bungoma,WESTERN,12510
MT. ELGON,Urban,47,32,29,61,Bungoma,WESTERN,12511
MT. ELGON,Urban,48,33,23,56,Bungoma,WESTERN,12512
MT. ELGON,Urban,49,27,35,62,Bungoma,WESTERN,12513
MT. ELGON,Urban,50,33,27,60,Bungoma,WESTERN,12514
MT. ELGON,Urban,51,19,21,40,Bungoma,WESTERN,12515
MT. ELGON,Urban,52,19,19,38,Bungoma,WESTERN,12516
MT. ELGON,Urban,53,20,13,33,Bungoma,WESTERN,12517
MT. ELGON,Urban,54,13,11,24,Bungoma,WESTERN,12518
MT. ELGON,Urban,55,23,20,43,Bungoma,WESTERN,12519
MT. ELGON,Urban,56,18,14,32,Bungoma,WESTERN,12520
MT. ELGON,Urban,57,14,17,31,Bungoma,WESTERN,12521
MT. ELGON,Urban,58,6,10,16,Bungoma,WESTERN,12522
MT. ELGON,Urban,59,15,14,29,Bungoma,WESTERN,12523
MT. ELGON,Urban,60,20,8,28,Bungoma,WESTERN,12524
MT. ELGON,Urban,61,12,8,20,Bungoma,WESTERN,12525
MT. ELGON,Urban,62,12,12,24,Bungoma,WESTERN,12526
MT. ELGON,Urban,63,7,7,14,Bungoma,WESTERN,12527
MT. ELGON,Urban,64,4,4,8,Bungoma,WESTERN,12528
MT. ELGON,Urban,65,10,10,20,Bungoma,WESTERN,12529
MT. ELGON,Urban,66,5,6,11,Bungoma,WESTERN,12530
MT. ELGON,Urban,67,5,8,13,Bungoma,WESTERN,12531
MT. ELGON,Urban,68,3,3,6,Bungoma,WESTERN,12532
MT. ELGON,Urban,69,3,6,9,Bungoma,WESTERN,12533
MT. ELGON,Urban,70,11,6,17,Bungoma,WESTERN,12534
MT. ELGON,Urban,71,3,8,11,Bungoma,WESTERN,12535
MT. ELGON,Urban,72,6,7,13,Bungoma,WESTERN,12536
MT. ELGON,Urban,73,5,7,12,Bungoma,WESTERN,12537
MT. ELGON,Urban,74,3,2,5,Bungoma,WESTERN,12538
MT. ELGON,Urban,75,4,10,14,Bungoma,WESTERN,12539
MT. ELGON,Urban,76,0,5,5,Bungoma,WESTERN,12540
MT. ELGON,Urban,77,6,9,15,Bungoma,WESTERN,12541
MT. ELGON,Urban,78,0,2,2,Bungoma,WESTERN,12542
MT. ELGON,Urban,79,5,3,8,Bungoma,WESTERN,12543
MT. ELGON,Urban,80+,24,54,78,Bungoma,WESTERN,12544
MT. ELGON,Urban,Age NS,3,0,3,Bungoma,WESTERN,12545
BUSIA,Urban,0,790,843,1633,Busia,WESTERN,12546
BUSIA,Urban,1,679,649,1328,Busia,WESTERN,12547
BUSIA,Urban,2,715,725,1440,Busia,WESTERN,12548
BUSIA,Urban,3,709,699,1408,Busia,WESTERN,12549
BUSIA,Urban,4,675,655,1330,Busia,WESTERN,12550
BUSIA,Urban,5,599,608,1207,Busia,WESTERN,12551
BUSIA,Urban,6,629,643,1272,Busia,WESTERN,12552
BUSIA,Urban,7,613,612,1225,Busia,WESTERN,12553
BUSIA,Urban,8,558,571,1129,Busia,WESTERN,12554
BUSIA,Urban,9,565,622,1187,Busia,WESTERN,12555
BUSIA,Urban,10,587,675,1262,Busia,WESTERN,12556
BUSIA,Urban,11,472,480,952,Busia,WESTERN,12557
BUSIA,Urban,12,590,683,1273,Busia,WESTERN,12558
BUSIA,Urban,13,547,624,1171,Busia,WESTERN,12559
BUSIA,Urban,14,550,621,1171,Busia,WESTERN,12560
BUSIA,Urban,15,501,561,1062,Busia,WESTERN,12561
BUSIA,Urban,16,451,512,963,Busia,WESTERN,12562
BUSIA,Urban,17,477,547,1024,Busia,WESTERN,12563
BUSIA,Urban,18,486,591,1077,Busia,WESTERN,12564
BUSIA,Urban,19,378,479,857,Busia,WESTERN,12565
BUSIA,Urban,20,556,766,1322,Busia,WESTERN,12566
BUSIA,Urban,21,360,470,830,Busia,WESTERN,12567
BUSIA,Urban,22,463,643,1106,Busia,WESTERN,12568
BUSIA,Urban,23,454,549,1003,Busia,WESTERN,12569
BUSIA,Urban,24,422,500,922,Busia,WESTERN,12570
BUSIA,Urban,25,590,652,1242,Busia,WESTERN,12571
BUSIA,Urban,26,369,447,816,Busia,WESTERN,12572
BUSIA,Urban,27,410,377,787,Busia,WESTERN,12573
BUSIA,Urban,28,412,440,852,Busia,WESTERN,12574
BUSIA,Urban,29,310,311,621,Busia,WESTERN,12575
BUSIA,Urban,30,518,558,1076,Busia,WESTERN,12576
BUSIA,Urban,31,203,199,402,Busia,WESTERN,12577
BUSIA,Urban,32,391,282,673,Busia,WESTERN,12578
BUSIA,Urban,33,183,174,357,Busia,WESTERN,12579
BUSIA,Urban,34,231,198,429,Busia,WESTERN,12580
BUSIA,Urban,35,434,376,810,Busia,WESTERN,12581
BUSIA,Urban,36,190,178,368,Busia,WESTERN,12582
BUSIA,Urban,37,184,165,349,Busia,WESTERN,12583
BUSIA,Urban,38,196,208,404,Busia,WESTERN,12584
BUSIA,Urban,39,159,176,335,Busia,WESTERN,12585
BUSIA,Urban,40,297,323,620,Busia,WESTERN,12586
BUSIA,Urban,41,98,103,201,Busia,WESTERN,12587
BUSIA,Urban,42,173,164,337,Busia,WESTERN,12588
BUSIA,Urban,43,105,101,206,Busia,WESTERN,12589
BUSIA,Urban,44,98,99,197,Busia,WESTERN,12590
BUSIA,Urban,45,204,228,432,Busia,WESTERN,12591
BUSIA,Urban,46,111,96,207,Busia,WESTERN,12592
BUSIA,Urban,47,125,107,232,Busia,WESTERN,12593
BUSIA,Urban,48,102,136,238,Busia,WESTERN,12594
BUSIA,Urban,49,97,75,172,Busia,WESTERN,12595
BUSIA,Urban,50,175,195,370,Busia,WESTERN,12596
BUSIA,Urban,51,82,52,134,Busia,WESTERN,12597
BUSIA,Urban,52,78,60,138,Busia,WESTERN,12598
BUSIA,Urban,53,52,52,104,Busia,WESTERN,12599
BUSIA,Urban,54,74,66,140,Busia,WESTERN,12600
BUSIA,Urban,55,83,90,173,Busia,WESTERN,12601
BUSIA,Urban,56,61,55,116,Busia,WESTERN,12602
BUSIA,Urban,57,70,66,136,Busia,WESTERN,12603
BUSIA,Urban,58,34,36,70,Busia,WESTERN,12604
BUSIA,Urban,59,31,40,71,Busia,WESTERN,12605
BUSIA,Urban,60,74,107,181,Busia,WESTERN,12606
BUSIA,Urban,61,27,28,55,Busia,WESTERN,12607
BUSIA,Urban,62,32,32,64,Busia,WESTERN,12608
BUSIA,Urban,63,31,29,60,Busia,WESTERN,12609
BUSIA,Urban,64,16,25,41,Busia,WESTERN,12610
BUSIA,Urban,65,49,50,99,Busia,WESTERN,12611
BUSIA,Urban,66,15,26,41,Busia,WESTERN,12612
BUSIA,Urban,67,36,31,67,Busia,WESTERN,12613
BUSIA,Urban,68,22,30,52,Busia,WESTERN,12614
BUSIA,Urban,69,17,26,43,Busia,WESTERN,12615
BUSIA,Urban,70,51,61,112,Busia,WESTERN,12616
BUSIA,Urban,71,21,20,41,Busia,WESTERN,12617
BUSIA,Urban,72,18,15,33,Busia,WESTERN,12618
BUSIA,Urban,73,19,13,32,Busia,WESTERN,12619
BUSIA,Urban,74,16,18,34,Busia,WESTERN,12620
BUSIA,Urban,75,20,16,36,Busia,WESTERN,12621
BUSIA,Urban,76,17,12,29,Busia,WESTERN,12622
BUSIA,Urban,77,10,12,22,Busia,WESTERN,12623
BUSIA,Urban,78,11,10,21,Busia,WESTERN,12624
BUSIA,Urban,79,8,18,26,Busia,WESTERN,12625
BUSIA,Urban,80+,95,149,244,Busia,WESTERN,12626
BUSIA,Urban,Age NS,24,12,36,Busia,WESTERN,12627
TESO NORTH,Urban,0,824,865,1689,Busia,WESTERN,12628
TESO NORTH,Urban,1,791,824,1615,Busia,WESTERN,12629
TESO NORTH,Urban,2,795,782,1577,Busia,WESTERN,12630
TESO NORTH,Urban,3,760,760,1520,Busia,WESTERN,12631
TESO NORTH,Urban,4,755,782,1537,Busia,WESTERN,12632
TESO NORTH,Urban,5,732,695,1427,Busia,WESTERN,12633
TESO NORTH,Urban,6,678,708,1386,Busia,WESTERN,12634
TESO NORTH,Urban,7,680,670,1350,Busia,WESTERN,12635
TESO NORTH,Urban,8,597,632,1229,Busia,WESTERN,12636
TESO NORTH,Urban,9,669,682,1351,Busia,WESTERN,12637
TESO NORTH,Urban,10,691,610,1301,Busia,WESTERN,12638
TESO NORTH,Urban,11,482,508,990,Busia,WESTERN,12639
TESO NORTH,Urban,12,604,611,1215,Busia,WESTERN,12640
TESO NORTH,Urban,13,550,542,1092,Busia,WESTERN,12641
TESO NORTH,Urban,14,512,546,1058,Busia,WESTERN,12642
TESO NORTH,Urban,15,502,554,1056,Busia,WESTERN,12643
TESO NORTH,Urban,16,435,489,924,Busia,WESTERN,12644
TESO NORTH,Urban,17,473,523,996,Busia,WESTERN,12645
TESO NORTH,Urban,18,472,516,988,Busia,WESTERN,12646
TESO NORTH,Urban,19,411,521,932,Busia,WESTERN,12647
TESO NORTH,Urban,20,474,649,1123,Busia,WESTERN,12648
TESO NORTH,Urban,21,368,476,844,Busia,WESTERN,12649
TESO NORTH,Urban,22,457,561,1018,Busia,WESTERN,12650
TESO NORTH,Urban,23,454,542,996,Busia,WESTERN,12651
TESO NORTH,Urban,24,380,452,832,Busia,WESTERN,12652
TESO NORTH,Urban,25,458,537,995,Busia,WESTERN,12653
TESO NORTH,Urban,26,377,398,775,Busia,WESTERN,12654
TESO NORTH,Urban,27,351,352,703,Busia,WESTERN,12655
TESO NORTH,Urban,28,315,373,688,Busia,WESTERN,12656
TESO NORTH,Urban,29,325,286,611,Busia,WESTERN,12657
TESO NORTH,Urban,30,426,442,868,Busia,WESTERN,12658
TESO NORTH,Urban,31,265,241,506,Busia,WESTERN,12659
TESO NORTH,Urban,32,328,300,628,Busia,WESTERN,12660
TESO NORTH,Urban,33,243,230,473,Busia,WESTERN,12661
TESO NORTH,Urban,34,225,230,455,Busia,WESTERN,12662
TESO NORTH,Urban,35,338,333,671,Busia,WESTERN,12663
TESO NORTH,Urban,36,209,193,402,Busia,WESTERN,12664
TESO NORTH,Urban,37,186,187,373,Busia,WESTERN,12665
TESO NORTH,Urban,38,182,216,398,Busia,WESTERN,12666
TESO NORTH,Urban,39,171,184,355,Busia,WESTERN,12667
TESO NORTH,Urban,40,250,264,514,Busia,WESTERN,12668
TESO NORTH,Urban,41,139,131,270,Busia,WESTERN,12669
TESO NORTH,Urban,42,174,132,306,Busia,WESTERN,12670
TESO NORTH,Urban,43,124,117,241,Busia,WESTERN,12671
TESO NORTH,Urban,44,117,113,230,Busia,WESTERN,12672
TESO NORTH,Urban,45,189,163,352,Busia,WESTERN,12673
TESO NORTH,Urban,46,140,134,274,Busia,WESTERN,12674
TESO NORTH,Urban,47,146,148,294,Busia,WESTERN,12675
TESO NORTH,Urban,48,101,122,223,Busia,WESTERN,12676
TESO NORTH,Urban,49,113,120,233,Busia,WESTERN,12677
TESO NORTH,Urban,50,144,138,282,Busia,WESTERN,12678
TESO NORTH,Urban,51,99,108,207,Busia,WESTERN,12679
TESO NORTH,Urban,52,91,90,181,Busia,WESTERN,12680
TESO NORTH,Urban,53,64,77,141,Busia,WESTERN,12681
TESO NORTH,Urban,54,87,73,160,Busia,WESTERN,12682
TESO NORTH,Urban,55,81,86,167,Busia,WESTERN,12683
TESO NORTH,Urban,56,64,57,121,Busia,WESTERN,12684
TESO NORTH,Urban,57,74,76,150,Busia,WESTERN,12685
TESO NORTH,Urban,58,43,38,81,Busia,WESTERN,12686
TESO NORTH,Urban,59,71,74,145,Busia,WESTERN,12687
TESO NORTH,Urban,60,66,96,162,Busia,WESTERN,12688
TESO NORTH,Urban,61,55,64,119,Busia,WESTERN,12689
TESO NORTH,Urban,62,51,26,77,Busia,WESTERN,12690
TESO NORTH,Urban,63,41,33,74,Busia,WESTERN,12691
TESO NORTH,Urban,64,35,44,79,Busia,WESTERN,12692
TESO NORTH,Urban,65,44,30,74,Busia,WESTERN,12693
TESO NORTH,Urban,66,34,18,52,Busia,WESTERN,12694
TESO NORTH,Urban,67,49,77,126,Busia,WESTERN,12695
TESO NORTH,Urban,68,15,22,37,Busia,WESTERN,12696
TESO NORTH,Urban,69,25,40,65,Busia,WESTERN,12697
TESO NORTH,Urban,70,24,40,64,Busia,WESTERN,12698
TESO NORTH,Urban,71,29,22,51,Busia,WESTERN,12699
TESO NORTH,Urban,72,23,24,47,Busia,WESTERN,12700
TESO NORTH,Urban,73,27,27,54,Busia,WESTERN,12701
TESO NORTH,Urban,74,20,25,45,Busia,WESTERN,12702
TESO NORTH,Urban,75,29,22,51,Busia,WESTERN,12703
TESO NORTH,Urban,76,20,21,41,Busia,WESTERN,12704
TESO NORTH,Urban,77,24,30,54,Busia,WESTERN,12705
TESO NORTH,Urban,78,7,7,14,Busia,WESTERN,12706
TESO NORTH,Urban,79,11,28,39,Busia,WESTERN,12707
TESO NORTH,Urban,80+,109,141,250,Busia,WESTERN,12708
TESO NORTH,Urban,Age NS,21,14,35,Busia,WESTERN,12709
SAMIA,Urban,0,0,0,0,Busia,WESTERN,12710
SAMIA,Urban,1,0,0,0,Busia,WESTERN,12711
SAMIA,Urban,2,0,0,0,Busia,WESTERN,12712
SAMIA,Urban,3,0,0,0,Busia,WESTERN,12713
SAMIA,Urban,4,0,0,0,Busia,WESTERN,12714
SAMIA,Urban,5,0,0,0,Busia,WESTERN,12715
SAMIA,Urban,6,0,0,0,Busia,WESTERN,12716
SAMIA,Urban,7,0,0,0,Busia,WESTERN,12717
SAMIA,Urban,8,0,0,0,Busia,WESTERN,12718
SAMIA,Urban,9,0,0,0,Busia,WESTERN,12719
SAMIA,Urban,10,0,0,0,Busia,WESTERN,12720
SAMIA,Urban,11,0,0,0,Busia,WESTERN,12721
SAMIA,Urban,12,0,0,0,Busia,WESTERN,12722
SAMIA,Urban,13,0,0,0,Busia,WESTERN,12723
SAMIA,Urban,14,0,0,0,Busia,WESTERN,12724
SAMIA,Urban,15,0,0,0,Busia,WESTERN,12725
SAMIA,Urban,16,0,0,0,Busia,WESTERN,12726
SAMIA,Urban,17,0,0,0,Busia,WESTERN,12727
SAMIA,Urban,18,0,0,0,Busia,WESTERN,12728
SAMIA,Urban,19,0,0,0,Busia,WESTERN,12729
SAMIA,Urban,20,0,0,0,Busia,WESTERN,12730
SAMIA,Urban,21,0,0,0,Busia,WESTERN,12731
SAMIA,Urban,22,0,0,0,Busia,WESTERN,12732
SAMIA,Urban,23,0,0,0,Busia,WESTERN,12733
SAMIA,Urban,24,0,0,0,Busia,WESTERN,12734
SAMIA,Urban,25,0,0,0,Busia,WESTERN,12735
SAMIA,Urban,26,0,0,0,Busia,WESTERN,12736
SAMIA,Urban,27,0,0,0,Busia,WESTERN,12737
SAMIA,Urban,28,0,0,0,Busia,WESTERN,12738
SAMIA,Urban,29,0,0,0,Busia,WESTERN,12739
SAMIA,Urban,30,0,0,0,Busia,WESTERN,12740
SAMIA,Urban,31,0,0,0,Busia,WESTERN,12741
SAMIA,Urban,32,0,0,0,Busia,WESTERN,12742
SAMIA,Urban,33,0,0,0,Busia,WESTERN,12743
SAMIA,Urban,34,0,0,0,Busia,WESTERN,12744
SAMIA,Urban,35,0,0,0,Busia,WESTERN,12745
SAMIA,Urban,36,0,0,0,Busia,WESTERN,12746
SAMIA,Urban,37,0,0,0,Busia,WESTERN,12747
SAMIA,Urban,38,0,0,0,Busia,WESTERN,12748
SAMIA,Urban,39,0,0,0,Busia,WESTERN,12749
SAMIA,Urban,40,0,0,0,Busia,WESTERN,12750
SAMIA,Urban,41,0,0,0,Busia,WESTERN,12751
SAMIA,Urban,42,0,0,0,Busia,WESTERN,12752
SAMIA,Urban,43,0,0,0,Busia,WESTERN,12753
SAMIA,Urban,44,0,0,0,Busia,WESTERN,12754
SAMIA,Urban,45,0,0,0,Busia,WESTERN,12755
SAMIA,Urban,46,0,0,0,Busia,WESTERN,12756
SAMIA,Urban,47,0,0,0,Busia,WESTERN,12757
SAMIA,Urban,48,0,0,0,Busia,WESTERN,12758
SAMIA,Urban,49,0,0,0,Busia,WESTERN,12759
SAMIA,Urban,50,0,0,0,Busia,WESTERN,12760
SAMIA,Urban,51,0,0,0,Busia,WESTERN,12761
SAMIA,Urban,52,0,0,0,Busia,WESTERN,12762
SAMIA,Urban,53,0,0,0,Busia,WESTERN,12763
SAMIA,Urban,54,0,0,0,Busia,WESTERN,12764
SAMIA,Urban,55,0,0,0,Busia,WESTERN,12765
SAMIA,Urban,56,0,0,0,Busia,WESTERN,12766
SAMIA,Urban,57,0,0,0,Busia,WESTERN,12767
SAMIA,Urban,58,0,0,0,Busia,WESTERN,12768
SAMIA,Urban,59,0,0,0,Busia,WESTERN,12769
SAMIA,Urban,60,0,0,0,Busia,WESTERN,12770
SAMIA,Urban,61,0,0,0,Busia,WESTERN,12771
SAMIA,Urban,62,0,0,0,Busia,WESTERN,12772
SAMIA,Urban,63,0,0,0,Busia,WESTERN,12773
SAMIA,Urban,64,0,0,0,Busia,WESTERN,12774
SAMIA,Urban,65,0,0,0,Busia,WESTERN,12775
SAMIA,Urban,66,0,0,0,Busia,WESTERN,12776
SAMIA,Urban,67,0,0,0,Busia,WESTERN,12777
SAMIA,Urban,68,0,0,0,Busia,WESTERN,12778
SAMIA,Urban,69,0,0,0,Busia,WESTERN,12779
SAMIA,Urban,70,0,0,0,Busia,WESTERN,12780
SAMIA,Urban,71,0,0,0,Busia,WESTERN,12781
SAMIA,Urban,72,0,0,0,Busia,WESTERN,12782
SAMIA,Urban,73,0,0,0,Busia,WESTERN,12783
SAMIA,Urban,74,0,0,0,Busia,WESTERN,12784
SAMIA,Urban,75,0,0,0,Busia,WESTERN,12785
SAMIA,Urban,76,0,0,0,Busia,WESTERN,12786
SAMIA,Urban,77,0,0,0,Busia,WESTERN,12787
SAMIA,Urban,78,0,0,0,Busia,WESTERN,12788
SAMIA,Urban,79,0,0,0,Busia,WESTERN,12789
SAMIA,Urban,80+,0,0,0,Busia,WESTERN,12790
SAMIA,Urban,Age NS,0,0,0,Busia,WESTERN,12791
BUNYALA,Urban,0,117,136,253,Busia,WESTERN,12792
BUNYALA,Urban,1,124,101,225,Busia,WESTERN,12793
BUNYALA,Urban,2,131,116,247,Busia,WESTERN,12794
BUNYALA,Urban,3,107,109,216,Busia,WESTERN,12795
BUNYALA,Urban,4,101,113,214,Busia,WESTERN,12796
BUNYALA,Urban,5,106,121,227,Busia,WESTERN,12797
BUNYALA,Urban,6,86,107,193,Busia,WESTERN,12798
BUNYALA,Urban,7,83,100,183,Busia,WESTERN,12799
BUNYALA,Urban,8,85,92,177,Busia,WESTERN,12800
BUNYALA,Urban,9,93,77,170,Busia,WESTERN,12801
BUNYALA,Urban,10,103,104,207,Busia,WESTERN,12802
BUNYALA,Urban,11,53,81,134,Busia,WESTERN,12803
BUNYALA,Urban,12,88,102,190,Busia,WESTERN,12804
BUNYALA,Urban,13,70,74,144,Busia,WESTERN,12805
BUNYALA,Urban,14,65,53,118,Busia,WESTERN,12806
BUNYALA,Urban,15,62,79,141,Busia,WESTERN,12807
BUNYALA,Urban,16,71,74,145,Busia,WESTERN,12808
BUNYALA,Urban,17,74,76,150,Busia,WESTERN,12809
BUNYALA,Urban,18,48,84,132,Busia,WESTERN,12810
BUNYALA,Urban,19,54,80,134,Busia,WESTERN,12811
BUNYALA,Urban,20,76,102,178,Busia,WESTERN,12812
BUNYALA,Urban,21,39,73,112,Busia,WESTERN,12813
BUNYALA,Urban,22,82,105,187,Busia,WESTERN,12814
BUNYALA,Urban,23,66,79,145,Busia,WESTERN,12815
BUNYALA,Urban,24,74,58,132,Busia,WESTERN,12816
BUNYALA,Urban,25,83,86,169,Busia,WESTERN,12817
BUNYALA,Urban,26,62,50,112,Busia,WESTERN,12818
BUNYALA,Urban,27,56,56,112,Busia,WESTERN,12819
BUNYALA,Urban,28,54,67,121,Busia,WESTERN,12820
BUNYALA,Urban,29,60,49,109,Busia,WESTERN,12821
BUNYALA,Urban,30,63,59,122,Busia,WESTERN,12822
BUNYALA,Urban,31,32,35,67,Busia,WESTERN,12823
BUNYALA,Urban,32,60,43,103,Busia,WESTERN,12824
BUNYALA,Urban,33,32,37,69,Busia,WESTERN,12825
BUNYALA,Urban,34,23,34,57,Busia,WESTERN,12826
BUNYALA,Urban,35,42,53,95,Busia,WESTERN,12827
BUNYALA,Urban,36,22,25,47,Busia,WESTERN,12828
BUNYALA,Urban,37,23,29,52,Busia,WESTERN,12829
BUNYALA,Urban,38,17,36,53,Busia,WESTERN,12830
BUNYALA,Urban,39,16,22,38,Busia,WESTERN,12831
BUNYALA,Urban,40,42,45,87,Busia,WESTERN,12832
BUNYALA,Urban,41,28,16,44,Busia,WESTERN,12833
BUNYALA,Urban,42,17,26,43,Busia,WESTERN,12834
BUNYALA,Urban,43,20,21,41,Busia,WESTERN,12835
BUNYALA,Urban,44,11,16,27,Busia,WESTERN,12836
BUNYALA,Urban,45,29,22,51,Busia,WESTERN,12837
BUNYALA,Urban,46,15,16,31,Busia,WESTERN,12838
BUNYALA,Urban,47,13,13,26,Busia,WESTERN,12839
BUNYALA,Urban,48,17,14,31,Busia,WESTERN,12840
BUNYALA,Urban,49,14,24,38,Busia,WESTERN,12841
BUNYALA,Urban,50,22,33,55,Busia,WESTERN,12842
BUNYALA,Urban,51,9,19,28,Busia,WESTERN,12843
BUNYALA,Urban,52,11,12,23,Busia,WESTERN,12844
BUNYALA,Urban,53,6,9,15,Busia,WESTERN,12845
BUNYALA,Urban,54,8,9,17,Busia,WESTERN,12846
BUNYALA,Urban,55,4,12,16,Busia,WESTERN,12847
BUNYALA,Urban,56,8,6,14,Busia,WESTERN,12848
BUNYALA,Urban,57,10,8,18,Busia,WESTERN,12849
BUNYALA,Urban,58,6,7,13,Busia,WESTERN,12850
BUNYALA,Urban,59,8,10,18,Busia,WESTERN,12851
BUNYALA,Urban,60,6,17,23,Busia,WESTERN,12852
BUNYALA,Urban,61,3,8,11,Busia,WESTERN,12853
BUNYALA,Urban,62,5,4,9,Busia,WESTERN,12854
BUNYALA,Urban,63,7,5,12,Busia,WESTERN,12855
BUNYALA,Urban,64,3,5,8,Busia,WESTERN,12856
BUNYALA,Urban,65,2,11,13,Busia,WESTERN,12857
BUNYALA,Urban,66,4,1,5,Busia,WESTERN,12858
BUNYALA,Urban,67,4,7,11,Busia,WESTERN,12859
BUNYALA,Urban,68,6,5,11,Busia,WESTERN,12860
BUNYALA,Urban,69,4,5,9,Busia,WESTERN,12861
BUNYALA,Urban,70,6,6,12,Busia,WESTERN,12862
BUNYALA,Urban,71,3,2,5,Busia,WESTERN,12863
BUNYALA,Urban,72,3,3,6,Busia,WESTERN,12864
BUNYALA,Urban,73,3,0,3,Busia,WESTERN,12865
BUNYALA,Urban,74,10,10,20,Busia,WESTERN,12866
BUNYALA,Urban,75,3,4,7,Busia,WESTERN,12867
BUNYALA,Urban,76,3,1,4,Busia,WESTERN,12868
BUNYALA,Urban,77,8,2,10,Busia,WESTERN,12869
BUNYALA,Urban,78,1,4,5,Busia,WESTERN,12870
BUNYALA,Urban,79,2,4,6,Busia,WESTERN,12871
BUNYALA,Urban,80+,14,40,54,Busia,WESTERN,12872
BUNYALA,Urban,Age NS,0,1,1,Busia,WESTERN,12873
TESO SOUTH,Urban,0,489,482,971,Busia,WESTERN,12874
TESO SOUTH,Urban,1,395,387,782,Busia,WESTERN,12875
TESO SOUTH,Urban,2,402,400,802,Busia,WESTERN,12876
TESO SOUTH,Urban,3,407,445,852,Busia,WESTERN,12877
TESO SOUTH,Urban,4,347,403,750,Busia,WESTERN,12878
TESO SOUTH,Urban,5,375,414,789,Busia,WESTERN,12879
TESO SOUTH,Urban,6,372,335,707,Busia,WESTERN,12880
TESO SOUTH,Urban,7,344,362,706,Busia,WESTERN,12881
TESO SOUTH,Urban,8,331,326,657,Busia,WESTERN,12882
TESO SOUTH,Urban,9,315,349,664,Busia,WESTERN,12883
TESO SOUTH,Urban,10,374,408,782,Busia,WESTERN,12884
TESO SOUTH,Urban,11,287,276,563,Busia,WESTERN,12885
TESO SOUTH,Urban,12,376,357,733,Busia,WESTERN,12886
TESO SOUTH,Urban,13,313,312,625,Busia,WESTERN,12887
TESO SOUTH,Urban,14,271,348,619,Busia,WESTERN,12888
TESO SOUTH,Urban,15,290,316,606,Busia,WESTERN,12889
TESO SOUTH,Urban,16,262,349,611,Busia,WESTERN,12890
TESO SOUTH,Urban,17,293,330,623,Busia,WESTERN,12891
TESO SOUTH,Urban,18,287,336,623,Busia,WESTERN,12892
TESO SOUTH,Urban,19,248,335,583,Busia,WESTERN,12893
TESO SOUTH,Urban,20,302,446,748,Busia,WESTERN,12894
TESO SOUTH,Urban,21,234,282,516,Busia,WESTERN,12895
TESO SOUTH,Urban,22,293,395,688,Busia,WESTERN,12896
TESO SOUTH,Urban,23,271,338,609,Busia,WESTERN,12897
TESO SOUTH,Urban,24,243,293,536,Busia,WESTERN,12898
TESO SOUTH,Urban,25,310,328,638,Busia,WESTERN,12899
TESO SOUTH,Urban,26,228,257,485,Busia,WESTERN,12900
TESO SOUTH,Urban,27,264,246,510,Busia,WESTERN,12901
TESO SOUTH,Urban,28,233,234,467,Busia,WESTERN,12902
TESO SOUTH,Urban,29,186,213,399,Busia,WESTERN,12903
TESO SOUTH,Urban,30,302,284,586,Busia,WESTERN,12904
TESO SOUTH,Urban,31,141,94,235,Busia,WESTERN,12905
TESO SOUTH,Urban,32,223,187,410,Busia,WESTERN,12906
TESO SOUTH,Urban,33,126,121,247,Busia,WESTERN,12907
TESO SOUTH,Urban,34,137,102,239,Busia,WESTERN,12908
TESO SOUTH,Urban,35,243,227,470,Busia,WESTERN,12909
TESO SOUTH,Urban,36,100,112,212,Busia,WESTERN,12910
TESO SOUTH,Urban,37,117,96,213,Busia,WESTERN,12911
TESO SOUTH,Urban,38,88,134,222,Busia,WESTERN,12912
TESO SOUTH,Urban,39,113,100,213,Busia,WESTERN,12913
TESO SOUTH,Urban,40,189,191,380,Busia,WESTERN,12914
TESO SOUTH,Urban,41,94,74,168,Busia,WESTERN,12915
TESO SOUTH,Urban,42,103,115,218,Busia,WESTERN,12916
TESO SOUTH,Urban,43,87,85,172,Busia,WESTERN,12917
TESO SOUTH,Urban,44,69,47,116,Busia,WESTERN,12918
TESO SOUTH,Urban,45,123,137,260,Busia,WESTERN,12919
TESO SOUTH,Urban,46,84,72,156,Busia,WESTERN,12920
TESO SOUTH,Urban,47,92,67,159,Busia,WESTERN,12921
TESO SOUTH,Urban,48,57,72,129,Busia,WESTERN,12922
TESO SOUTH,Urban,49,74,64,138,Busia,WESTERN,12923
TESO SOUTH,Urban,50,78,94,172,Busia,WESTERN,12924
TESO SOUTH,Urban,51,37,50,87,Busia,WESTERN,12925
TESO SOUTH,Urban,52,64,46,110,Busia,WESTERN,12926
TESO SOUTH,Urban,53,52,43,95,Busia,WESTERN,12927
TESO SOUTH,Urban,54,43,31,74,Busia,WESTERN,12928
TESO SOUTH,Urban,55,50,62,112,Busia,WESTERN,12929
TESO SOUTH,Urban,56,47,29,76,Busia,WESTERN,12930
TESO SOUTH,Urban,57,24,26,50,Busia,WESTERN,12931
TESO SOUTH,Urban,58,32,25,57,Busia,WESTERN,12932
TESO SOUTH,Urban,59,28,19,47,Busia,WESTERN,12933
TESO SOUTH,Urban,60,47,49,96,Busia,WESTERN,12934
TESO SOUTH,Urban,61,25,13,38,Busia,WESTERN,12935
TESO SOUTH,Urban,62,26,17,43,Busia,WESTERN,12936
TESO SOUTH,Urban,63,7,18,25,Busia,WESTERN,12937
TESO SOUTH,Urban,64,23,12,35,Busia,WESTERN,12938
TESO SOUTH,Urban,65,13,33,46,Busia,WESTERN,12939
TESO SOUTH,Urban,66,6,10,16,Busia,WESTERN,12940
TESO SOUTH,Urban,67,27,19,46,Busia,WESTERN,12941
TESO SOUTH,Urban,68,17,8,25,Busia,WESTERN,12942
TESO SOUTH,Urban,69,16,12,28,Busia,WESTERN,12943
TESO SOUTH,Urban,70,14,24,38,Busia,WESTERN,12944
TESO SOUTH,Urban,71,7,10,17,Busia,WESTERN,12945
TESO SOUTH,Urban,72,12,9,21,Busia,WESTERN,12946
TESO SOUTH,Urban,73,14,5,19,Busia,WESTERN,12947
TESO SOUTH,Urban,74,8,5,13,Busia,WESTERN,12948
TESO SOUTH,Urban,75,10,12,22,Busia,WESTERN,12949
TESO SOUTH,Urban,76,7,14,21,Busia,WESTERN,12950
TESO SOUTH,Urban,77,9,9,18,Busia,WESTERN,12951
TESO SOUTH,Urban,78,3,2,5,Busia,WESTERN,12952
TESO SOUTH,Urban,79,8,12,20,Busia,WESTERN,12953
TESO SOUTH,Urban,80+,33,57,90,Busia,WESTERN,12954
TESO SOUTH,Urban,Age NS,9,4,13,Busia,WESTERN,12955
NYANDARUA NORTH,Rural,0,2853,2745,5598,Nyandarua,CENTRAL,12956
NYANDARUA NORTH,Rural,1,2683,2556,5239,Nyandarua,CENTRAL,12957
NYANDARUA NORTH,Rural,2,2953,2799,5752,Nyandarua,CENTRAL,12958
NYANDARUA NORTH,Rural,3,3183,3139,6322,Nyandarua,CENTRAL,12959
NYANDARUA NORTH,Rural,4,3502,3186,6688,Nyandarua,CENTRAL,12960
NYANDARUA NORTH,Rural,5,3479,3146,6625,Nyandarua,CENTRAL,12961
NYANDARUA NORTH,Rural,6,3186,3072,6258,Nyandarua,CENTRAL,12962
NYANDARUA NORTH,Rural,7,3227,3149,6376,Nyandarua,CENTRAL,12963
NYANDARUA NORTH,Rural,8,3048,3094,6142,Nyandarua,CENTRAL,12964
NYANDARUA NORTH,Rural,9,3383,3196,6579,Nyandarua,CENTRAL,12965
NYANDARUA NORTH,Rural,10,3508,3288,6796,Nyandarua,CENTRAL,12966
NYANDARUA NORTH,Rural,11,2675,2564,5239,Nyandarua,CENTRAL,12967
NYANDARUA NORTH,Rural,12,3347,3096,6443,Nyandarua,CENTRAL,12968
NYANDARUA NORTH,Rural,13,3115,3076,6191,Nyandarua,CENTRAL,12969
NYANDARUA NORTH,Rural,14,2898,2767,5665,Nyandarua,CENTRAL,12970
NYANDARUA NORTH,Rural,15,2778,2671,5449,Nyandarua,CENTRAL,12971
NYANDARUA NORTH,Rural,16,2481,2260,4741,Nyandarua,CENTRAL,12972
NYANDARUA NORTH,Rural,17,2550,2062,4612,Nyandarua,CENTRAL,12973
NYANDARUA NORTH,Rural,18,2393,1951,4344,Nyandarua,CENTRAL,12974
NYANDARUA NORTH,Rural,19,1965,1579,3544,Nyandarua,CENTRAL,12975
NYANDARUA NORTH,Rural,20,2038,1964,4002,Nyandarua,CENTRAL,12976
NYANDARUA NORTH,Rural,21,1509,1517,3026,Nyandarua,CENTRAL,12977
NYANDARUA NORTH,Rural,22,1628,1727,3355,Nyandarua,CENTRAL,12978
NYANDARUA NORTH,Rural,23,1448,1616,3064,Nyandarua,CENTRAL,12979
NYANDARUA NORTH,Rural,24,1335,1646,2981,Nyandarua,CENTRAL,12980
NYANDARUA NORTH,Rural,25,1708,2067,3775,Nyandarua,CENTRAL,12981
NYANDARUA NORTH,Rural,26,1166,1560,2726,Nyandarua,CENTRAL,12982
NYANDARUA NORTH,Rural,27,1380,1574,2954,Nyandarua,CENTRAL,12983
NYANDARUA NORTH,Rural,28,1221,1558,2779,Nyandarua,CENTRAL,12984
NYANDARUA NORTH,Rural,29,1173,1401,2574,Nyandarua,CENTRAL,12985
NYANDARUA NORTH,Rural,30,1838,2234,4072,Nyandarua,CENTRAL,12986
NYANDARUA NORTH,Rural,31,1107,1204,2311,Nyandarua,CENTRAL,12987
NYANDARUA NORTH,Rural,32,1235,1521,2756,Nyandarua,CENTRAL,12988
NYANDARUA NORTH,Rural,33,898,1083,1981,Nyandarua,CENTRAL,12989
NYANDARUA NORTH,Rural,34,1096,1174,2270,Nyandarua,CENTRAL,12990
NYANDARUA NORTH,Rural,35,1684,2119,3803,Nyandarua,CENTRAL,12991
NYANDARUA NORTH,Rural,36,1000,1143,2143,Nyandarua,CENTRAL,12992
NYANDARUA NORTH,Rural,37,1038,1099,2137,Nyandarua,CENTRAL,12993
NYANDARUA NORTH,Rural,38,1040,1365,2405,Nyandarua,CENTRAL,12994
NYANDARUA NORTH,Rural,39,964,1053,2017,Nyandarua,CENTRAL,12995
NYANDARUA NORTH,Rural,40,1501,1777,3278,Nyandarua,CENTRAL,12996
NYANDARUA NORTH,Rural,41,774,775,1549,Nyandarua,CENTRAL,12997
NYANDARUA NORTH,Rural,42,903,1046,1949,Nyandarua,CENTRAL,12998
NYANDARUA NORTH,Rural,43,699,880,1579,Nyandarua,CENTRAL,12999
NYANDARUA NORTH,Rural,44,690,778,1468,Nyandarua,CENTRAL,13000
NYANDARUA NORTH,Rural,45,1267,1525,2792,Nyandarua,CENTRAL,13001
NYANDARUA NORTH,Rural,46,807,901,1708,Nyandarua,CENTRAL,13002
NYANDARUA NORTH,Rural,47,699,765,1464,Nyandarua,CENTRAL,13003
NYANDARUA NORTH,Rural,48,675,835,1510,Nyandarua,CENTRAL,13004
NYANDARUA NORTH,Rural,49,646,784,1430,Nyandarua,CENTRAL,13005
NYANDARUA NORTH,Rural,50,918,1189,2107,Nyandarua,CENTRAL,13006
NYANDARUA NORTH,Rural,51,486,499,985,Nyandarua,CENTRAL,13007
NYANDARUA NORTH,Rural,52,512,577,1089,Nyandarua,CENTRAL,13008
NYANDARUA NORTH,Rural,53,386,393,779,Nyandarua,CENTRAL,13009
NYANDARUA NORTH,Rural,54,380,418,798,Nyandarua,CENTRAL,13010
NYANDARUA NORTH,Rural,55,612,718,1330,Nyandarua,CENTRAL,13011
NYANDARUA NORTH,Rural,56,440,487,927,Nyandarua,CENTRAL,13012
NYANDARUA NORTH,Rural,57,554,572,1126,Nyandarua,CENTRAL,13013
NYANDARUA NORTH,Rural,58,320,367,687,Nyandarua,CENTRAL,13014
NYANDARUA NORTH,Rural,59,414,415,829,Nyandarua,CENTRAL,13015
NYANDARUA NORTH,Rural,60,741,883,1624,Nyandarua,CENTRAL,13016
NYANDARUA NORTH,Rural,61,336,371,707,Nyandarua,CENTRAL,13017
NYANDARUA NORTH,Rural,62,349,353,702,Nyandarua,CENTRAL,13018
NYANDARUA NORTH,Rural,63,318,312,630,Nyandarua,CENTRAL,13019
NYANDARUA NORTH,Rural,64,343,331,674,Nyandarua,CENTRAL,13020
NYANDARUA NORTH,Rural,65,454,529,983,Nyandarua,CENTRAL,13021
NYANDARUA NORTH,Rural,66,312,586,898,Nyandarua,CENTRAL,13022
NYANDARUA NORTH,Rural,67,263,345,608,Nyandarua,CENTRAL,13023
NYANDARUA NORTH,Rural,68,204,232,436,Nyandarua,CENTRAL,13024
NYANDARUA NORTH,Rural,69,239,297,536,Nyandarua,CENTRAL,13025
NYANDARUA NORTH,Rural,70,461,509,970,Nyandarua,CENTRAL,13026
NYANDARUA NORTH,Rural,71,186,199,385,Nyandarua,CENTRAL,13027
NYANDARUA NORTH,Rural,72,206,187,393,Nyandarua,CENTRAL,13028
NYANDARUA NORTH,Rural,73,184,164,348,Nyandarua,CENTRAL,13029
NYANDARUA NORTH,Rural,74,196,236,432,Nyandarua,CENTRAL,13030
NYANDARUA NORTH,Rural,75,206,269,475,Nyandarua,CENTRAL,13031
NYANDARUA NORTH,Rural,76,154,175,329,Nyandarua,CENTRAL,13032
NYANDARUA NORTH,Rural,77,131,118,249,Nyandarua,CENTRAL,13033
NYANDARUA NORTH,Rural,78,134,131,265,Nyandarua,CENTRAL,13034
NYANDARUA NORTH,Rural,79,156,177,333,Nyandarua,CENTRAL,13035
NYANDARUA NORTH,Rural,80+,1113,1634,2747,Nyandarua,CENTRAL,13036
NYANDARUA NORTH,Rural,Age NS,29,25,54,Nyandarua,CENTRAL,13037
NYANDARUA SOUTH,Rural,0,3751,3607,7358,Nyandarua,CENTRAL,13038
NYANDARUA SOUTH,Rural,1,3462,3364,6826,Nyandarua,CENTRAL,13039
NYANDARUA SOUTH,Rural,2,3872,3623,7495,Nyandarua,CENTRAL,13040
NYANDARUA SOUTH,Rural,3,4035,4080,8115,Nyandarua,CENTRAL,13041
NYANDARUA SOUTH,Rural,4,4482,4287,8769,Nyandarua,CENTRAL,13042
NYANDARUA SOUTH,Rural,5,4486,4180,8666,Nyandarua,CENTRAL,13043
NYANDARUA SOUTH,Rural,6,4225,4132,8357,Nyandarua,CENTRAL,13044
NYANDARUA SOUTH,Rural,7,4328,4150,8478,Nyandarua,CENTRAL,13045
NYANDARUA SOUTH,Rural,8,4032,4091,8123,Nyandarua,CENTRAL,13046
NYANDARUA SOUTH,Rural,9,4389,4362,8751,Nyandarua,CENTRAL,13047
NYANDARUA SOUTH,Rural,10,4398,4177,8575,Nyandarua,CENTRAL,13048
NYANDARUA SOUTH,Rural,11,3524,3452,6976,Nyandarua,CENTRAL,13049
NYANDARUA SOUTH,Rural,12,4125,4142,8267,Nyandarua,CENTRAL,13050
NYANDARUA SOUTH,Rural,13,4061,3887,7948,Nyandarua,CENTRAL,13051
NYANDARUA SOUTH,Rural,14,3743,3585,7328,Nyandarua,CENTRAL,13052
NYANDARUA SOUTH,Rural,15,3352,3226,6578,Nyandarua,CENTRAL,13053
NYANDARUA SOUTH,Rural,16,3043,2923,5966,Nyandarua,CENTRAL,13054
NYANDARUA SOUTH,Rural,17,3003,2643,5646,Nyandarua,CENTRAL,13055
NYANDARUA SOUTH,Rural,18,2883,2422,5305,Nyandarua,CENTRAL,13056
NYANDARUA SOUTH,Rural,19,2376,2055,4431,Nyandarua,CENTRAL,13057
NYANDARUA SOUTH,Rural,20,2553,2612,5165,Nyandarua,CENTRAL,13058
NYANDARUA SOUTH,Rural,21,1842,1872,3714,Nyandarua,CENTRAL,13059
NYANDARUA SOUTH,Rural,22,1928,2216,4144,Nyandarua,CENTRAL,13060
NYANDARUA SOUTH,Rural,23,1821,2050,3871,Nyandarua,CENTRAL,13061
NYANDARUA SOUTH,Rural,24,1808,2043,3851,Nyandarua,CENTRAL,13062
NYANDARUA SOUTH,Rural,25,2172,2667,4839,Nyandarua,CENTRAL,13063
NYANDARUA SOUTH,Rural,26,1630,1855,3485,Nyandarua,CENTRAL,13064
NYANDARUA SOUTH,Rural,27,1642,1825,3467,Nyandarua,CENTRAL,13065
NYANDARUA SOUTH,Rural,28,1625,2069,3694,Nyandarua,CENTRAL,13066
NYANDARUA SOUTH,Rural,29,1476,1696,3172,Nyandarua,CENTRAL,13067
NYANDARUA SOUTH,Rural,30,2284,2915,5199,Nyandarua,CENTRAL,13068
NYANDARUA SOUTH,Rural,31,1317,1499,2816,Nyandarua,CENTRAL,13069
NYANDARUA SOUTH,Rural,32,1575,1885,3460,Nyandarua,CENTRAL,13070
NYANDARUA SOUTH,Rural,33,1206,1300,2506,Nyandarua,CENTRAL,13071
NYANDARUA SOUTH,Rural,34,1290,1478,2768,Nyandarua,CENTRAL,13072
NYANDARUA SOUTH,Rural,35,2082,2570,4652,Nyandarua,CENTRAL,13073
NYANDARUA SOUTH,Rural,36,1272,1441,2713,Nyandarua,CENTRAL,13074
NYANDARUA SOUTH,Rural,37,1202,1379,2581,Nyandarua,CENTRAL,13075
NYANDARUA SOUTH,Rural,38,1311,1654,2965,Nyandarua,CENTRAL,13076
NYANDARUA SOUTH,Rural,39,1132,1389,2521,Nyandarua,CENTRAL,13077
NYANDARUA SOUTH,Rural,40,1846,2204,4050,Nyandarua,CENTRAL,13078
NYANDARUA SOUTH,Rural,41,942,981,1923,Nyandarua,CENTRAL,13079
NYANDARUA SOUTH,Rural,42,1150,1246,2396,Nyandarua,CENTRAL,13080
NYANDARUA SOUTH,Rural,43,888,1129,2017,Nyandarua,CENTRAL,13081
NYANDARUA SOUTH,Rural,44,818,940,1758,Nyandarua,CENTRAL,13082
NYANDARUA SOUTH,Rural,45,1556,1883,3439,Nyandarua,CENTRAL,13083
NYANDARUA SOUTH,Rural,46,932,1033,1965,Nyandarua,CENTRAL,13084
NYANDARUA SOUTH,Rural,47,743,872,1615,Nyandarua,CENTRAL,13085
NYANDARUA SOUTH,Rural,48,733,887,1620,Nyandarua,CENTRAL,13086
NYANDARUA SOUTH,Rural,49,756,776,1532,Nyandarua,CENTRAL,13087
NYANDARUA SOUTH,Rural,50,1115,1265,2380,Nyandarua,CENTRAL,13088
NYANDARUA SOUTH,Rural,51,523,536,1059,Nyandarua,CENTRAL,13089
NYANDARUA SOUTH,Rural,52,629,573,1202,Nyandarua,CENTRAL,13090
NYANDARUA SOUTH,Rural,53,354,401,755,Nyandarua,CENTRAL,13091
NYANDARUA SOUTH,Rural,54,408,428,836,Nyandarua,CENTRAL,13092
NYANDARUA SOUTH,Rural,55,650,748,1398,Nyandarua,CENTRAL,13093
NYANDARUA SOUTH,Rural,56,490,491,981,Nyandarua,CENTRAL,13094
NYANDARUA SOUTH,Rural,57,489,538,1027,Nyandarua,CENTRAL,13095
NYANDARUA SOUTH,Rural,58,331,435,766,Nyandarua,CENTRAL,13096
NYANDARUA SOUTH,Rural,59,391,482,873,Nyandarua,CENTRAL,13097
NYANDARUA SOUTH,Rural,60,750,992,1742,Nyandarua,CENTRAL,13098
NYANDARUA SOUTH,Rural,61,342,386,728,Nyandarua,CENTRAL,13099
NYANDARUA SOUTH,Rural,62,363,419,782,Nyandarua,CENTRAL,13100
NYANDARUA SOUTH,Rural,63,284,391,675,Nyandarua,CENTRAL,13101
NYANDARUA SOUTH,Rural,64,291,376,667,Nyandarua,CENTRAL,13102
NYANDARUA SOUTH,Rural,65,473,768,1241,Nyandarua,CENTRAL,13103
NYANDARUA SOUTH,Rural,66,326,665,991,Nyandarua,CENTRAL,13104
NYANDARUA SOUTH,Rural,67,309,353,662,Nyandarua,CENTRAL,13105
NYANDARUA SOUTH,Rural,68,229,325,554,Nyandarua,CENTRAL,13106
NYANDARUA SOUTH,Rural,69,260,359,619,Nyandarua,CENTRAL,13107
NYANDARUA SOUTH,Rural,70,494,642,1136,Nyandarua,CENTRAL,13108
NYANDARUA SOUTH,Rural,71,188,183,371,Nyandarua,CENTRAL,13109
NYANDARUA SOUTH,Rural,72,257,229,486,Nyandarua,CENTRAL,13110
NYANDARUA SOUTH,Rural,73,238,215,453,Nyandarua,CENTRAL,13111
NYANDARUA SOUTH,Rural,74,231,234,465,Nyandarua,CENTRAL,13112
NYANDARUA SOUTH,Rural,75,245,340,585,Nyandarua,CENTRAL,13113
NYANDARUA SOUTH,Rural,76,178,221,399,Nyandarua,CENTRAL,13114
NYANDARUA SOUTH,Rural,77,140,137,277,Nyandarua,CENTRAL,13115
NYANDARUA SOUTH,Rural,78,172,176,348,Nyandarua,CENTRAL,13116
NYANDARUA SOUTH,Rural,79,154,172,326,Nyandarua,CENTRAL,13117
NYANDARUA SOUTH,Rural,80+,1398,1690,3088,Nyandarua,CENTRAL,13118
NYANDARUA SOUTH,Rural,Age NS,68,58,126,Nyandarua,CENTRAL,13119
NYERI NORTH,Rural,0,3160,3063,6223,Nyeri,CENTRAL,13120
NYERI NORTH,Rural,1,2985,2849,5834,Nyeri,CENTRAL,13121
NYERI NORTH,Rural,2,3286,3096,6382,Nyeri,CENTRAL,13122
NYERI NORTH,Rural,3,3341,3170,6511,Nyeri,CENTRAL,13123
NYERI NORTH,Rural,4,3535,3236,6771,Nyeri,CENTRAL,13124
NYERI NORTH,Rural,5,3523,3448,6971,Nyeri,CENTRAL,13125
NYERI NORTH,Rural,6,3395,3408,6803,Nyeri,CENTRAL,13126
NYERI NORTH,Rural,7,3360,3241,6601,Nyeri,CENTRAL,13127
NYERI NORTH,Rural,8,3266,3221,6487,Nyeri,CENTRAL,13128
NYERI NORTH,Rural,9,3722,3436,7158,Nyeri,CENTRAL,13129
NYERI NORTH,Rural,10,3614,3510,7124,Nyeri,CENTRAL,13130
NYERI NORTH,Rural,11,3085,2902,5987,Nyeri,CENTRAL,13131
NYERI NORTH,Rural,12,3701,3597,7298,Nyeri,CENTRAL,13132
NYERI NORTH,Rural,13,3505,3374,6879,Nyeri,CENTRAL,13133
NYERI NORTH,Rural,14,3289,3127,6416,Nyeri,CENTRAL,13134
NYERI NORTH,Rural,15,3063,2859,5922,Nyeri,CENTRAL,13135
NYERI NORTH,Rural,16,2952,2880,5832,Nyeri,CENTRAL,13136
NYERI NORTH,Rural,17,3081,2808,5889,Nyeri,CENTRAL,13137
NYERI NORTH,Rural,18,2802,2590,5392,Nyeri,CENTRAL,13138
NYERI NORTH,Rural,19,2599,2205,4804,Nyeri,CENTRAL,13139
NYERI NORTH,Rural,20,2905,2525,5430,Nyeri,CENTRAL,13140
NYERI NORTH,Rural,21,2219,2043,4262,Nyeri,CENTRAL,13141
NYERI NORTH,Rural,22,2539,2293,4832,Nyeri,CENTRAL,13142
NYERI NORTH,Rural,23,2300,2236,4536,Nyeri,CENTRAL,13143
NYERI NORTH,Rural,24,2047,2154,4201,Nyeri,CENTRAL,13144
NYERI NORTH,Rural,25,2724,2786,5510,Nyeri,CENTRAL,13145
NYERI NORTH,Rural,26,1948,2164,4112,Nyeri,CENTRAL,13146
NYERI NORTH,Rural,27,2091,2082,4173,Nyeri,CENTRAL,13147
NYERI NORTH,Rural,28,1967,2194,4161,Nyeri,CENTRAL,13148
NYERI NORTH,Rural,29,2009,2121,4130,Nyeri,CENTRAL,13149
NYERI NORTH,Rural,30,2914,3158,6072,Nyeri,CENTRAL,13150
NYERI NORTH,Rural,31,1729,1649,3378,Nyeri,CENTRAL,13151
NYERI NORTH,Rural,32,1975,2149,4124,Nyeri,CENTRAL,13152
NYERI NORTH,Rural,33,1610,1720,3330,Nyeri,CENTRAL,13153
NYERI NORTH,Rural,34,1751,1865,3616,Nyeri,CENTRAL,13154
NYERI NORTH,Rural,35,2600,2810,5410,Nyeri,CENTRAL,13155
NYERI NORTH,Rural,36,1584,1793,3377,Nyeri,CENTRAL,13156
NYERI NORTH,Rural,37,1572,1618,3190,Nyeri,CENTRAL,13157
NYERI NORTH,Rural,38,1697,1883,3580,Nyeri,CENTRAL,13158
NYERI NORTH,Rural,39,1590,1635,3225,Nyeri,CENTRAL,13159
NYERI NORTH,Rural,40,2482,2667,5149,Nyeri,CENTRAL,13160
NYERI NORTH,Rural,41,1297,1321,2618,Nyeri,CENTRAL,13161
NYERI NORTH,Rural,42,1489,1561,3050,Nyeri,CENTRAL,13162
NYERI NORTH,Rural,43,1197,1373,2570,Nyeri,CENTRAL,13163
NYERI NORTH,Rural,44,1165,1275,2440,Nyeri,CENTRAL,13164
NYERI NORTH,Rural,45,2043,2093,4136,Nyeri,CENTRAL,13165
NYERI NORTH,Rural,46,1315,1315,2630,Nyeri,CENTRAL,13166
NYERI NORTH,Rural,47,1177,1231,2408,Nyeri,CENTRAL,13167
NYERI NORTH,Rural,48,1091,1182,2273,Nyeri,CENTRAL,13168
NYERI NORTH,Rural,49,1178,1146,2324,Nyeri,CENTRAL,13169
NYERI NORTH,Rural,50,1447,1965,3412,Nyeri,CENTRAL,13170
NYERI NORTH,Rural,51,782,830,1612,Nyeri,CENTRAL,13171
NYERI NORTH,Rural,52,815,859,1674,Nyeri,CENTRAL,13172
NYERI NORTH,Rural,53,590,672,1262,Nyeri,CENTRAL,13173
NYERI NORTH,Rural,54,621,653,1274,Nyeri,CENTRAL,13174
NYERI NORTH,Rural,55,908,1072,1980,Nyeri,CENTRAL,13175
NYERI NORTH,Rural,56,728,769,1497,Nyeri,CENTRAL,13176
NYERI NORTH,Rural,57,874,986,1860,Nyeri,CENTRAL,13177
NYERI NORTH,Rural,58,544,595,1139,Nyeri,CENTRAL,13178
NYERI NORTH,Rural,59,646,717,1363,Nyeri,CENTRAL,13179
NYERI NORTH,Rural,60,1301,1550,2851,Nyeri,CENTRAL,13180
NYERI NORTH,Rural,61,685,729,1414,Nyeri,CENTRAL,13181
NYERI NORTH,Rural,62,696,623,1319,Nyeri,CENTRAL,13182
NYERI NORTH,Rural,63,598,603,1201,Nyeri,CENTRAL,13183
NYERI NORTH,Rural,64,537,616,1153,Nyeri,CENTRAL,13184
NYERI NORTH,Rural,65,703,941,1644,Nyeri,CENTRAL,13185
NYERI NORTH,Rural,66,475,766,1241,Nyeri,CENTRAL,13186
NYERI NORTH,Rural,67,529,598,1127,Nyeri,CENTRAL,13187
NYERI NORTH,Rural,68,375,401,776,Nyeri,CENTRAL,13188
NYERI NORTH,Rural,69,419,502,921,Nyeri,CENTRAL,13189
NYERI NORTH,Rural,70,864,1105,1969,Nyeri,CENTRAL,13190
NYERI NORTH,Rural,71,315,339,654,Nyeri,CENTRAL,13191
NYERI NORTH,Rural,72,367,373,740,Nyeri,CENTRAL,13192
NYERI NORTH,Rural,73,353,373,726,Nyeri,CENTRAL,13193
NYERI NORTH,Rural,74,298,379,677,Nyeri,CENTRAL,13194
NYERI NORTH,Rural,75,377,442,819,Nyeri,CENTRAL,13195
NYERI NORTH,Rural,76,271,294,565,Nyeri,CENTRAL,13196
NYERI NORTH,Rural,77,207,227,434,Nyeri,CENTRAL,13197
NYERI NORTH,Rural,78,189,218,407,Nyeri,CENTRAL,13198
NYERI NORTH,Rural,79,228,350,578,Nyeri,CENTRAL,13199
NYERI NORTH,Rural,80+,2183,3342,5525,Nyeri,CENTRAL,13200
NYERI NORTH,Rural,Age NS,29,20,49,Nyeri,CENTRAL,13201
NYERI SOUTH,Rural,0,2528,2412,4940,Nyeri,CENTRAL,13202
NYERI SOUTH,Rural,1,2370,2257,4627,Nyeri,CENTRAL,13203
NYERI SOUTH,Rural,2,2588,2419,5007,Nyeri,CENTRAL,13204
NYERI SOUTH,Rural,3,2731,2631,5362,Nyeri,CENTRAL,13205
NYERI SOUTH,Rural,4,2861,2595,5456,Nyeri,CENTRAL,13206
NYERI SOUTH,Rural,5,2874,2749,5623,Nyeri,CENTRAL,13207
NYERI SOUTH,Rural,6,2704,2613,5317,Nyeri,CENTRAL,13208
NYERI SOUTH,Rural,7,2760,2680,5440,Nyeri,CENTRAL,13209
NYERI SOUTH,Rural,8,2642,2602,5244,Nyeri,CENTRAL,13210
NYERI SOUTH,Rural,9,3025,3090,6115,Nyeri,CENTRAL,13211
NYERI SOUTH,Rural,10,2971,2937,5908,Nyeri,CENTRAL,13212
NYERI SOUTH,Rural,11,2584,2585,5169,Nyeri,CENTRAL,13213
NYERI SOUTH,Rural,12,3043,2962,6005,Nyeri,CENTRAL,13214
NYERI SOUTH,Rural,13,3016,2816,5832,Nyeri,CENTRAL,13215
NYERI SOUTH,Rural,14,2693,2592,5285,Nyeri,CENTRAL,13216
NYERI SOUTH,Rural,15,2596,2457,5053,Nyeri,CENTRAL,13217
NYERI SOUTH,Rural,16,2420,2444,4864,Nyeri,CENTRAL,13218
NYERI SOUTH,Rural,17,2672,2387,5059,Nyeri,CENTRAL,13219
NYERI SOUTH,Rural,18,2663,2188,4851,Nyeri,CENTRAL,13220
NYERI SOUTH,Rural,19,2422,1987,4409,Nyeri,CENTRAL,13221
NYERI SOUTH,Rural,20,2406,2090,4496,Nyeri,CENTRAL,13222
NYERI SOUTH,Rural,21,1807,1633,3440,Nyeri,CENTRAL,13223
NYERI SOUTH,Rural,22,1887,1805,3692,Nyeri,CENTRAL,13224
NYERI SOUTH,Rural,23,1698,1745,3443,Nyeri,CENTRAL,13225
NYERI SOUTH,Rural,24,1554,1704,3258,Nyeri,CENTRAL,13226
NYERI SOUTH,Rural,25,1943,2083,4026,Nyeri,CENTRAL,13227
NYERI SOUTH,Rural,26,1392,1627,3019,Nyeri,CENTRAL,13228
NYERI SOUTH,Rural,27,1415,1689,3104,Nyeri,CENTRAL,13229
NYERI SOUTH,Rural,28,1377,1715,3092,Nyeri,CENTRAL,13230
NYERI SOUTH,Rural,29,1256,1607,2863,Nyeri,CENTRAL,13231
NYERI SOUTH,Rural,30,1923,2403,4326,Nyeri,CENTRAL,13232
NYERI SOUTH,Rural,31,1229,1294,2523,Nyeri,CENTRAL,13233
NYERI SOUTH,Rural,32,1307,1620,2927,Nyeri,CENTRAL,13234
NYERI SOUTH,Rural,33,1170,1409,2579,Nyeri,CENTRAL,13235
NYERI SOUTH,Rural,34,1251,1531,2782,Nyeri,CENTRAL,13236
NYERI SOUTH,Rural,35,1807,2135,3942,Nyeri,CENTRAL,13237
NYERI SOUTH,Rural,36,1170,1425,2595,Nyeri,CENTRAL,13238
NYERI SOUTH,Rural,37,1134,1366,2500,Nyeri,CENTRAL,13239
NYERI SOUTH,Rural,38,1196,1505,2701,Nyeri,CENTRAL,13240
NYERI SOUTH,Rural,39,1120,1424,2544,Nyeri,CENTRAL,13241
NYERI SOUTH,Rural,40,1705,2257,3962,Nyeri,CENTRAL,13242
NYERI SOUTH,Rural,41,925,1085,2010,Nyeri,CENTRAL,13243
NYERI SOUTH,Rural,42,1047,1337,2384,Nyeri,CENTRAL,13244
NYERI SOUTH,Rural,43,881,1221,2102,Nyeri,CENTRAL,13245
NYERI SOUTH,Rural,44,923,1191,2114,Nyeri,CENTRAL,13246
NYERI SOUTH,Rural,45,1547,2004,3551,Nyeri,CENTRAL,13247
NYERI SOUTH,Rural,46,1064,1226,2290,Nyeri,CENTRAL,13248
NYERI SOUTH,Rural,47,928,1176,2104,Nyeri,CENTRAL,13249
NYERI SOUTH,Rural,48,879,1121,2000,Nyeri,CENTRAL,13250
NYERI SOUTH,Rural,49,988,1138,2126,Nyeri,CENTRAL,13251
NYERI SOUTH,Rural,50,1221,1910,3131,Nyeri,CENTRAL,13252
NYERI SOUTH,Rural,51,747,806,1553,Nyeri,CENTRAL,13253
NYERI SOUTH,Rural,52,737,865,1602,Nyeri,CENTRAL,13254
NYERI SOUTH,Rural,53,512,616,1128,Nyeri,CENTRAL,13255
NYERI SOUTH,Rural,54,486,656,1142,Nyeri,CENTRAL,13256
NYERI SOUTH,Rural,55,831,1128,1959,Nyeri,CENTRAL,13257
NYERI SOUTH,Rural,56,652,759,1411,Nyeri,CENTRAL,13258
NYERI SOUTH,Rural,57,921,977,1898,Nyeri,CENTRAL,13259
NYERI SOUTH,Rural,58,541,581,1122,Nyeri,CENTRAL,13260
NYERI SOUTH,Rural,59,699,774,1473,Nyeri,CENTRAL,13261
NYERI SOUTH,Rural,60,1251,1718,2969,Nyeri,CENTRAL,13262
NYERI SOUTH,Rural,61,704,714,1418,Nyeri,CENTRAL,13263
NYERI SOUTH,Rural,62,660,602,1262,Nyeri,CENTRAL,13264
NYERI SOUTH,Rural,63,588,542,1130,Nyeri,CENTRAL,13265
NYERI SOUTH,Rural,64,553,634,1187,Nyeri,CENTRAL,13266
NYERI SOUTH,Rural,65,763,957,1720,Nyeri,CENTRAL,13267
NYERI SOUTH,Rural,66,610,899,1509,Nyeri,CENTRAL,13268
NYERI SOUTH,Rural,67,475,541,1016,Nyeri,CENTRAL,13269
NYERI SOUTH,Rural,68,333,409,742,Nyeri,CENTRAL,13270
NYERI SOUTH,Rural,69,404,517,921,Nyeri,CENTRAL,13271
NYERI SOUTH,Rural,70,825,1172,1997,Nyeri,CENTRAL,13272
NYERI SOUTH,Rural,71,327,382,709,Nyeri,CENTRAL,13273
NYERI SOUTH,Rural,72,324,351,675,Nyeri,CENTRAL,13274
NYERI SOUTH,Rural,73,356,394,750,Nyeri,CENTRAL,13275
NYERI SOUTH,Rural,74,289,381,670,Nyeri,CENTRAL,13276
NYERI SOUTH,Rural,75,390,578,968,Nyeri,CENTRAL,13277
NYERI SOUTH,Rural,76,286,375,661,Nyeri,CENTRAL,13278
NYERI SOUTH,Rural,77,198,263,461,Nyeri,CENTRAL,13279
NYERI SOUTH,Rural,78,208,279,487,Nyeri,CENTRAL,13280
NYERI SOUTH,Rural,79,278,465,743,Nyeri,CENTRAL,13281
NYERI SOUTH,Rural,80+,2254,3732,5986,Nyeri,CENTRAL,13282
NYERI SOUTH,Rural,Age NS,42,44,86,Nyeri,CENTRAL,13283
KIRINYAGA,Rural,0,4949,4949,9898,Kirinyaga,CENTRAL,13284
KIRINYAGA,Rural,1,4463,4368,8831,Kirinyaga,CENTRAL,13285
KIRINYAGA,Rural,2,4882,4793,9675,Kirinyaga,CENTRAL,13286
KIRINYAGA,Rural,3,4992,4812,9804,Kirinyaga,CENTRAL,13287
KIRINYAGA,Rural,4,5192,5155,10347,Kirinyaga,CENTRAL,13288
KIRINYAGA,Rural,5,5515,5515,11030,Kirinyaga,CENTRAL,13289
KIRINYAGA,Rural,6,5307,5196,10503,Kirinyaga,CENTRAL,13290
KIRINYAGA,Rural,7,5244,5122,10366,Kirinyaga,CENTRAL,13291
KIRINYAGA,Rural,8,4847,4871,9718,Kirinyaga,CENTRAL,13292
KIRINYAGA,Rural,9,5430,5243,10673,Kirinyaga,CENTRAL,13293
KIRINYAGA,Rural,10,5173,5124,10297,Kirinyaga,CENTRAL,13294
KIRINYAGA,Rural,11,4096,4124,8220,Kirinyaga,CENTRAL,13295
KIRINYAGA,Rural,12,5097,5087,10184,Kirinyaga,CENTRAL,13296
KIRINYAGA,Rural,13,4887,5098,9985,Kirinyaga,CENTRAL,13297
KIRINYAGA,Rural,14,4328,4081,8409,Kirinyaga,CENTRAL,13298
KIRINYAGA,Rural,15,4381,3913,8294,Kirinyaga,CENTRAL,13299
KIRINYAGA,Rural,16,3805,3662,7467,Kirinyaga,CENTRAL,13300
KIRINYAGA,Rural,17,4137,3631,7768,Kirinyaga,CENTRAL,13301
KIRINYAGA,Rural,18,4275,3649,7924,Kirinyaga,CENTRAL,13302
KIRINYAGA,Rural,19,3716,3381,7097,Kirinyaga,CENTRAL,13303
KIRINYAGA,Rural,20,4552,4519,9071,Kirinyaga,CENTRAL,13304
KIRINYAGA,Rural,21,3416,3451,6867,Kirinyaga,CENTRAL,13305
KIRINYAGA,Rural,22,3992,4207,8199,Kirinyaga,CENTRAL,13306
KIRINYAGA,Rural,23,3996,4183,8179,Kirinyaga,CENTRAL,13307
KIRINYAGA,Rural,24,3657,4017,7674,Kirinyaga,CENTRAL,13308
KIRINYAGA,Rural,25,5084,5360,10444,Kirinyaga,CENTRAL,13309
KIRINYAGA,Rural,26,3682,3941,7623,Kirinyaga,CENTRAL,13310
KIRINYAGA,Rural,27,3984,3903,7887,Kirinyaga,CENTRAL,13311
KIRINYAGA,Rural,28,3615,3996,7611,Kirinyaga,CENTRAL,13312
KIRINYAGA,Rural,29,3793,3791,7584,Kirinyaga,CENTRAL,13313
KIRINYAGA,Rural,30,5568,5926,11494,Kirinyaga,CENTRAL,13314
KIRINYAGA,Rural,31,3254,2839,6093,Kirinyaga,CENTRAL,13315
KIRINYAGA,Rural,32,3421,3488,6909,Kirinyaga,CENTRAL,13316
KIRINYAGA,Rural,33,2818,2733,5551,Kirinyaga,CENTRAL,13317
KIRINYAGA,Rural,34,3152,3044,6196,Kirinyaga,CENTRAL,13318
KIRINYAGA,Rural,35,4714,4914,9628,Kirinyaga,CENTRAL,13319
KIRINYAGA,Rural,36,2698,2660,5358,Kirinyaga,CENTRAL,13320
KIRINYAGA,Rural,37,2810,2485,5295,Kirinyaga,CENTRAL,13321
KIRINYAGA,Rural,38,2674,2854,5528,Kirinyaga,CENTRAL,13322
KIRINYAGA,Rural,39,2554,2495,5049,Kirinyaga,CENTRAL,13323
KIRINYAGA,Rural,40,4321,4356,8677,Kirinyaga,CENTRAL,13324
KIRINYAGA,Rural,41,2183,2015,4198,Kirinyaga,CENTRAL,13325
KIRINYAGA,Rural,42,2225,2167,4392,Kirinyaga,CENTRAL,13326
KIRINYAGA,Rural,43,1861,1832,3693,Kirinyaga,CENTRAL,13327
KIRINYAGA,Rural,44,1885,1735,3620,Kirinyaga,CENTRAL,13328
KIRINYAGA,Rural,45,3227,3467,6694,Kirinyaga,CENTRAL,13329
KIRINYAGA,Rural,46,2427,2212,4639,Kirinyaga,CENTRAL,13330
KIRINYAGA,Rural,47,1858,1737,3595,Kirinyaga,CENTRAL,13331
KIRINYAGA,Rural,48,1623,1755,3378,Kirinyaga,CENTRAL,13332
KIRINYAGA,Rural,49,1808,1867,3675,Kirinyaga,CENTRAL,13333
KIRINYAGA,Rural,50,2675,3211,5886,Kirinyaga,CENTRAL,13334
KIRINYAGA,Rural,51,1414,1214,2628,Kirinyaga,CENTRAL,13335
KIRINYAGA,Rural,52,1358,1276,2634,Kirinyaga,CENTRAL,13336
KIRINYAGA,Rural,53,928,972,1900,Kirinyaga,CENTRAL,13337
KIRINYAGA,Rural,54,881,916,1797,Kirinyaga,CENTRAL,13338
KIRINYAGA,Rural,55,1576,1867,3443,Kirinyaga,CENTRAL,13339
KIRINYAGA,Rural,56,1067,1020,2087,Kirinyaga,CENTRAL,13340
KIRINYAGA,Rural,57,1445,1306,2751,Kirinyaga,CENTRAL,13341
KIRINYAGA,Rural,58,860,806,1666,Kirinyaga,CENTRAL,13342
KIRINYAGA,Rural,59,1023,1032,2055,Kirinyaga,CENTRAL,13343
KIRINYAGA,Rural,60,1942,2588,4530,Kirinyaga,CENTRAL,13344
KIRINYAGA,Rural,61,822,950,1772,Kirinyaga,CENTRAL,13345
KIRINYAGA,Rural,62,769,653,1422,Kirinyaga,CENTRAL,13346
KIRINYAGA,Rural,63,707,645,1352,Kirinyaga,CENTRAL,13347
KIRINYAGA,Rural,64,687,795,1482,Kirinyaga,CENTRAL,13348
KIRINYAGA,Rural,65,938,1222,2160,Kirinyaga,CENTRAL,13349
KIRINYAGA,Rural,66,445,544,989,Kirinyaga,CENTRAL,13350
KIRINYAGA,Rural,67,669,651,1320,Kirinyaga,CENTRAL,13351
KIRINYAGA,Rural,68,446,469,915,Kirinyaga,CENTRAL,13352
KIRINYAGA,Rural,69,565,728,1293,Kirinyaga,CENTRAL,13353
KIRINYAGA,Rural,70,1215,1808,3023,Kirinyaga,CENTRAL,13354
KIRINYAGA,Rural,71,333,469,802,Kirinyaga,CENTRAL,13355
KIRINYAGA,Rural,72,393,402,795,Kirinyaga,CENTRAL,13356
KIRINYAGA,Rural,73,380,431,811,Kirinyaga,CENTRAL,13357
KIRINYAGA,Rural,74,387,514,901,Kirinyaga,CENTRAL,13358
KIRINYAGA,Rural,75,534,689,1223,Kirinyaga,CENTRAL,13359
KIRINYAGA,Rural,76,309,327,636,Kirinyaga,CENTRAL,13360
KIRINYAGA,Rural,77,290,284,574,Kirinyaga,CENTRAL,13361
KIRINYAGA,Rural,78,276,281,557,Kirinyaga,CENTRAL,13362
KIRINYAGA,Rural,79,337,590,927,Kirinyaga,CENTRAL,13363
KIRINYAGA,Rural,80+,3175,5708,8883,Kirinyaga,CENTRAL,13364
KIRINYAGA,Rural,Age NS,80,65,145,Kirinyaga,CENTRAL,13365
MURANGA NORTH,Rural,0,3375,3464,6839,Murang'a,CENTRAL,13366
MURANGA NORTH,Rural,1,3387,3218,6605,Murang'a,CENTRAL,13367
MURANGA NORTH,Rural,2,3618,3449,7067,Murang'a,CENTRAL,13368
MURANGA NORTH,Rural,3,3743,3606,7349,Murang'a,CENTRAL,13369
MURANGA NORTH,Rural,4,3946,3709,7655,Murang'a,CENTRAL,13370
MURANGA NORTH,Rural,5,3988,3917,7905,Murang'a,CENTRAL,13371
MURANGA NORTH,Rural,6,3799,3715,7514,Murang'a,CENTRAL,13372
MURANGA NORTH,Rural,7,3851,3771,7622,Murang'a,CENTRAL,13373
MURANGA NORTH,Rural,8,3738,3566,7304,Murang'a,CENTRAL,13374
MURANGA NORTH,Rural,9,4141,4071,8212,Murang'a,CENTRAL,13375
MURANGA NORTH,Rural,10,4135,3989,8124,Murang'a,CENTRAL,13376
MURANGA NORTH,Rural,11,3552,3528,7080,Murang'a,CENTRAL,13377
MURANGA NORTH,Rural,12,4233,4178,8411,Murang'a,CENTRAL,13378
MURANGA NORTH,Rural,13,4265,4078,8343,Murang'a,CENTRAL,13379
MURANGA NORTH,Rural,14,3946,3722,7668,Murang'a,CENTRAL,13380
KIKUYU,Rural,4,7,9,16,Kiambu,CENTRAL,13381
MURANGA NORTH,Rural,15,3505,3319,6824,Murang'a,CENTRAL,13382
MURANGA NORTH,Rural,16,3377,3190,6567,Murang'a,CENTRAL,13383
MURANGA NORTH,Rural,17,3653,3223,6876,Murang'a,CENTRAL,13384
MURANGA NORTH,Rural,18,3306,2817,6123,Murang'a,CENTRAL,13385
MURANGA NORTH,Rural,19,2861,2649,5510,Murang'a,CENTRAL,13386
MURANGA NORTH,Rural,20,2849,2656,5505,Murang'a,CENTRAL,13387
MURANGA NORTH,Rural,21,2327,2117,4444,Murang'a,CENTRAL,13388
MURANGA NORTH,Rural,22,2264,2279,4543,Murang'a,CENTRAL,13389
MURANGA NORTH,Rural,23,2095,2289,4384,Murang'a,CENTRAL,13390
MURANGA NORTH,Rural,24,1907,2215,4122,Murang'a,CENTRAL,13391
MURANGA NORTH,Rural,25,2358,2709,5067,Murang'a,CENTRAL,13392
MURANGA NORTH,Rural,26,1829,2248,4077,Murang'a,CENTRAL,13393
MURANGA NORTH,Rural,27,1867,2123,3990,Murang'a,CENTRAL,13394
MURANGA NORTH,Rural,28,1745,2134,3879,Murang'a,CENTRAL,13395
MURANGA NORTH,Rural,29,1809,2120,3929,Murang'a,CENTRAL,13396
MURANGA NORTH,Rural,30,2462,2971,5433,Murang'a,CENTRAL,13397
MURANGA NORTH,Rural,31,1639,1795,3434,Murang'a,CENTRAL,13398
MURANGA NORTH,Rural,32,1675,2063,3738,Murang'a,CENTRAL,13399
MURANGA NORTH,Rural,33,1400,1682,3082,Murang'a,CENTRAL,13400
MURANGA NORTH,Rural,34,1669,1855,3524,Murang'a,CENTRAL,13401
MURANGA NORTH,Rural,35,2231,2700,4931,Murang'a,CENTRAL,13402
MURANGA NORTH,Rural,36,1507,1783,3290,Murang'a,CENTRAL,13403
MURANGA NORTH,Rural,37,1429,1656,3085,Murang'a,CENTRAL,13404
MURANGA NORTH,Rural,38,1423,1789,3212,Murang'a,CENTRAL,13405
MURANGA NORTH,Rural,39,1458,1618,3076,Murang'a,CENTRAL,13406
MURANGA NORTH,Rural,40,1963,2604,4567,Murang'a,CENTRAL,13407
MURANGA NORTH,Rural,41,1203,1313,2516,Murang'a,CENTRAL,13408
MURANGA NORTH,Rural,42,1209,1498,2707,Murang'a,CENTRAL,13409
MURANGA NORTH,Rural,43,1110,1417,2527,Murang'a,CENTRAL,13410
MURANGA NORTH,Rural,44,1102,1412,2514,Murang'a,CENTRAL,13411
MURANGA NORTH,Rural,45,1789,2470,4259,Murang'a,CENTRAL,13412
MURANGA NORTH,Rural,46,1419,1654,3073,Murang'a,CENTRAL,13413
MURANGA NORTH,Rural,47,1103,1486,2589,Murang'a,CENTRAL,13414
MURANGA NORTH,Rural,48,1010,1412,2422,Murang'a,CENTRAL,13415
MURANGA NORTH,Rural,49,1176,1441,2617,Murang'a,CENTRAL,13416
MURANGA NORTH,Rural,50,1566,2441,4007,Murang'a,CENTRAL,13417
MURANGA NORTH,Rural,51,939,1123,2062,Murang'a,CENTRAL,13418
MURANGA NORTH,Rural,52,977,1145,2122,Murang'a,CENTRAL,13419
MURANGA NORTH,Rural,53,752,838,1590,Murang'a,CENTRAL,13420
MURANGA NORTH,Rural,54,707,886,1593,Murang'a,CENTRAL,13421
MURANGA NORTH,Rural,55,1184,1490,2674,Murang'a,CENTRAL,13422
MURANGA NORTH,Rural,56,947,1121,2068,Murang'a,CENTRAL,13423
MURANGA NORTH,Rural,57,1235,1394,2629,Murang'a,CENTRAL,13424
MURANGA NORTH,Rural,58,673,776,1449,Murang'a,CENTRAL,13425
MURANGA NORTH,Rural,59,935,1028,1963,Murang'a,CENTRAL,13426
MURANGA NORTH,Rural,60,1498,2118,3616,Murang'a,CENTRAL,13427
MURANGA NORTH,Rural,61,903,1023,1926,Murang'a,CENTRAL,13428
MURANGA NORTH,Rural,62,894,755,1649,Murang'a,CENTRAL,13429
MURANGA NORTH,Rural,63,797,711,1508,Murang'a,CENTRAL,13430
MURANGA NORTH,Rural,64,812,855,1667,Murang'a,CENTRAL,13431
MURANGA NORTH,Rural,65,973,1219,2192,Murang'a,CENTRAL,13432
MURANGA NORTH,Rural,66,713,1019,1732,Murang'a,CENTRAL,13433
MURANGA NORTH,Rural,67,721,758,1479,Murang'a,CENTRAL,13434
MURANGA NORTH,Rural,68,465,523,988,Murang'a,CENTRAL,13435
MURANGA NORTH,Rural,69,543,782,1325,Murang'a,CENTRAL,13436
MURANGA NORTH,Rural,70,955,1465,2420,Murang'a,CENTRAL,13437
MURANGA NORTH,Rural,71,371,515,886,Murang'a,CENTRAL,13438
MURANGA NORTH,Rural,72,401,452,853,Murang'a,CENTRAL,13439
MURANGA NORTH,Rural,73,443,510,953,Murang'a,CENTRAL,13440
MURANGA NORTH,Rural,74,450,567,1017,Murang'a,CENTRAL,13441
MURANGA NORTH,Rural,75,562,777,1339,Murang'a,CENTRAL,13442
MURANGA NORTH,Rural,76,365,380,745,Murang'a,CENTRAL,13443
MURANGA NORTH,Rural,77,346,403,749,Murang'a,CENTRAL,13444
MURANGA NORTH,Rural,78,301,375,676,Murang'a,CENTRAL,13445
MURANGA NORTH,Rural,79,311,584,895,Murang'a,CENTRAL,13446
MURANGA NORTH,Rural,80+,2791,4604,7395,Murang'a,CENTRAL,13447
MURANGA NORTH,Rural,Age NS,57,50,107,Murang'a,CENTRAL,13448
MURANGA SOUTH,Rural,0,3917,3793,7710,Murang'a,CENTRAL,13449
MURANGA SOUTH,Rural,1,3667,3572,7239,Murang'a,CENTRAL,13450
MURANGA SOUTH,Rural,2,4058,3983,8041,Murang'a,CENTRAL,13451
MURANGA SOUTH,Rural,3,4285,4122,8407,Murang'a,CENTRAL,13452
MURANGA SOUTH,Rural,4,4309,4315,8624,Murang'a,CENTRAL,13453
MURANGA SOUTH,Rural,5,4357,4275,8632,Murang'a,CENTRAL,13454
MURANGA SOUTH,Rural,6,4226,4054,8280,Murang'a,CENTRAL,13455
MURANGA SOUTH,Rural,7,4163,4046,8209,Murang'a,CENTRAL,13456
MURANGA SOUTH,Rural,8,4059,3915,7974,Murang'a,CENTRAL,13457
MURANGA SOUTH,Rural,9,4681,4397,9078,Murang'a,CENTRAL,13458
MURANGA SOUTH,Rural,10,4437,4260,8697,Murang'a,CENTRAL,13459
MURANGA SOUTH,Rural,11,3644,3701,7345,Murang'a,CENTRAL,13460
MURANGA SOUTH,Rural,12,4379,4246,8625,Murang'a,CENTRAL,13461
MURANGA SOUTH,Rural,13,4283,4219,8502,Murang'a,CENTRAL,13462
MURANGA SOUTH,Rural,14,3896,3694,7590,Murang'a,CENTRAL,13463
MURANGA SOUTH,Rural,15,3638,3472,7110,Murang'a,CENTRAL,13464
MURANGA SOUTH,Rural,16,3459,3300,6759,Murang'a,CENTRAL,13465
MURANGA SOUTH,Rural,17,3732,3200,6932,Murang'a,CENTRAL,13466
MURANGA SOUTH,Rural,18,3473,2888,6361,Murang'a,CENTRAL,13467
MURANGA SOUTH,Rural,19,3115,2553,5668,Murang'a,CENTRAL,13468
MURANGA SOUTH,Rural,20,3019,2918,5937,Murang'a,CENTRAL,13469
MURANGA SOUTH,Rural,21,2363,2192,4555,Murang'a,CENTRAL,13470
MURANGA SOUTH,Rural,22,2468,2599,5067,Murang'a,CENTRAL,13471
MURANGA SOUTH,Rural,23,2098,2469,4567,Murang'a,CENTRAL,13472
MURANGA SOUTH,Rural,24,2022,2229,4251,Murang'a,CENTRAL,13473
MURANGA SOUTH,Rural,25,2635,2940,5575,Murang'a,CENTRAL,13474
MURANGA SOUTH,Rural,26,1968,2280,4248,Murang'a,CENTRAL,13475
MURANGA SOUTH,Rural,27,1985,2196,4181,Murang'a,CENTRAL,13476
MURANGA SOUTH,Rural,28,1870,2356,4226,Murang'a,CENTRAL,13477
MURANGA SOUTH,Rural,29,1841,2152,3993,Murang'a,CENTRAL,13478
MURANGA SOUTH,Rural,30,2780,3298,6078,Murang'a,CENTRAL,13479
MURANGA SOUTH,Rural,31,1693,1798,3491,Murang'a,CENTRAL,13480
MURANGA SOUTH,Rural,32,1811,2208,4019,Murang'a,CENTRAL,13481
MURANGA SOUTH,Rural,33,1488,1671,3159,Murang'a,CENTRAL,13482
MURANGA SOUTH,Rural,34,1634,1818,3452,Murang'a,CENTRAL,13483
MURANGA SOUTH,Rural,35,2363,2868,5231,Murang'a,CENTRAL,13484
MURANGA SOUTH,Rural,36,1528,1818,3346,Murang'a,CENTRAL,13485
MURANGA SOUTH,Rural,37,1553,1639,3192,Murang'a,CENTRAL,13486
MURANGA SOUTH,Rural,38,1487,1822,3309,Murang'a,CENTRAL,13487
MURANGA SOUTH,Rural,39,1377,1616,2993,Murang'a,CENTRAL,13488
MURANGA SOUTH,Rural,40,2334,2724,5058,Murang'a,CENTRAL,13489
MURANGA SOUTH,Rural,41,1138,1255,2393,Murang'a,CENTRAL,13490
MURANGA SOUTH,Rural,42,1302,1547,2849,Murang'a,CENTRAL,13491
MURANGA SOUTH,Rural,43,1053,1267,2320,Murang'a,CENTRAL,13492
MURANGA SOUTH,Rural,44,1059,1271,2330,Murang'a,CENTRAL,13493
MURANGA SOUTH,Rural,45,1786,2422,4208,Murang'a,CENTRAL,13494
MURANGA SOUTH,Rural,46,1360,1511,2871,Murang'a,CENTRAL,13495
MURANGA SOUTH,Rural,47,1100,1290,2390,Murang'a,CENTRAL,13496
MURANGA SOUTH,Rural,48,1010,1286,2296,Murang'a,CENTRAL,13497
MURANGA SOUTH,Rural,49,1118,1288,2406,Murang'a,CENTRAL,13498
MURANGA SOUTH,Rural,50,1539,2191,3730,Murang'a,CENTRAL,13499
MURANGA SOUTH,Rural,51,923,973,1896,Murang'a,CENTRAL,13500
MURANGA SOUTH,Rural,52,891,1021,1912,Murang'a,CENTRAL,13501
MURANGA SOUTH,Rural,53,666,778,1444,Murang'a,CENTRAL,13502
MURANGA SOUTH,Rural,54,737,821,1558,Murang'a,CENTRAL,13503
MURANGA SOUTH,Rural,55,1121,1425,2546,Murang'a,CENTRAL,13504
MURANGA SOUTH,Rural,56,831,877,1708,Murang'a,CENTRAL,13505
MURANGA SOUTH,Rural,57,1126,1202,2328,Murang'a,CENTRAL,13506
MURANGA SOUTH,Rural,58,598,693,1291,Murang'a,CENTRAL,13507
MURANGA SOUTH,Rural,59,771,863,1634,Murang'a,CENTRAL,13508
MURANGA SOUTH,Rural,60,1513,1820,3333,Murang'a,CENTRAL,13509
MURANGA SOUTH,Rural,61,843,727,1570,Murang'a,CENTRAL,13510
MURANGA SOUTH,Rural,62,775,675,1450,Murang'a,CENTRAL,13511
MURANGA SOUTH,Rural,63,697,594,1291,Murang'a,CENTRAL,13512
MURANGA SOUTH,Rural,64,577,695,1272,Murang'a,CENTRAL,13513
MURANGA SOUTH,Rural,65,820,1038,1858,Murang'a,CENTRAL,13514
MURANGA SOUTH,Rural,66,667,1109,1776,Murang'a,CENTRAL,13515
MURANGA SOUTH,Rural,67,588,599,1187,Murang'a,CENTRAL,13516
MURANGA SOUTH,Rural,68,430,444,874,Murang'a,CENTRAL,13517
MURANGA SOUTH,Rural,69,519,651,1170,Murang'a,CENTRAL,13518
MURANGA SOUTH,Rural,70,894,1260,2154,Murang'a,CENTRAL,13519
MURANGA SOUTH,Rural,71,288,360,648,Murang'a,CENTRAL,13520
MURANGA SOUTH,Rural,72,396,390,786,Murang'a,CENTRAL,13521
MURANGA SOUTH,Rural,73,426,413,839,Murang'a,CENTRAL,13522
MURANGA SOUTH,Rural,74,430,540,970,Murang'a,CENTRAL,13523
MURANGA SOUTH,Rural,75,458,588,1046,Murang'a,CENTRAL,13524
MURANGA SOUTH,Rural,76,281,346,627,Murang'a,CENTRAL,13525
MURANGA SOUTH,Rural,77,269,313,582,Murang'a,CENTRAL,13526
MURANGA SOUTH,Rural,78,246,304,550,Murang'a,CENTRAL,13527
MURANGA SOUTH,Rural,79,302,488,790,Murang'a,CENTRAL,13528
MURANGA SOUTH,Rural,80+,2350,4143,6493,Murang'a,CENTRAL,13529
MURANGA SOUTH,Rural,Age NS,122,101,223,Murang'a,CENTRAL,13530
KIAMBU EAST(KIAMBAA),Rural,0,582,544,1126,Kiambu,CENTRAL,13531
KIAMBU EAST(KIAMBAA),Rural,1,526,546,1072,Kiambu,CENTRAL,13532
KIAMBU EAST(KIAMBAA),Rural,2,588,552,1140,Kiambu,CENTRAL,13533
KIAMBU EAST(KIAMBAA),Rural,3,582,578,1160,Kiambu,CENTRAL,13534
KIAMBU EAST(KIAMBAA),Rural,4,588,559,1147,Kiambu,CENTRAL,13535
KIAMBU EAST(KIAMBAA),Rural,5,607,541,1148,Kiambu,CENTRAL,13536
KIAMBU EAST(KIAMBAA),Rural,6,532,524,1056,Kiambu,CENTRAL,13537
KIAMBU EAST(KIAMBAA),Rural,7,481,484,965,Kiambu,CENTRAL,13538
KIAMBU EAST(KIAMBAA),Rural,8,481,546,1027,Kiambu,CENTRAL,13539
KIAMBU EAST(KIAMBAA),Rural,9,578,526,1104,Kiambu,CENTRAL,13540
KIAMBU EAST(KIAMBAA),Rural,10,524,527,1051,Kiambu,CENTRAL,13541
KIAMBU EAST(KIAMBAA),Rural,11,425,484,909,Kiambu,CENTRAL,13542
KIAMBU EAST(KIAMBAA),Rural,12,497,491,988,Kiambu,CENTRAL,13543
KIAMBU EAST(KIAMBAA),Rural,13,465,511,976,Kiambu,CENTRAL,13544
KIAMBU EAST(KIAMBAA),Rural,14,409,427,836,Kiambu,CENTRAL,13545
KIAMBU EAST(KIAMBAA),Rural,15,396,420,816,Kiambu,CENTRAL,13546
KIAMBU EAST(KIAMBAA),Rural,16,411,420,831,Kiambu,CENTRAL,13547
KIAMBU EAST(KIAMBAA),Rural,17,423,442,865,Kiambu,CENTRAL,13548
KIAMBU EAST(KIAMBAA),Rural,18,411,411,822,Kiambu,CENTRAL,13549
KIAMBU EAST(KIAMBAA),Rural,19,369,398,767,Kiambu,CENTRAL,13550
KIAMBU EAST(KIAMBAA),Rural,20,462,520,982,Kiambu,CENTRAL,13551
KIAMBU EAST(KIAMBAA),Rural,21,445,378,823,Kiambu,CENTRAL,13552
KIAMBU EAST(KIAMBAA),Rural,22,438,469,907,Kiambu,CENTRAL,13553
KIAMBU EAST(KIAMBAA),Rural,23,470,440,910,Kiambu,CENTRAL,13554
KIAMBU EAST(KIAMBAA),Rural,24,442,432,874,Kiambu,CENTRAL,13555
KIAMBU EAST(KIAMBAA),Rural,25,544,527,1071,Kiambu,CENTRAL,13556
KIAMBU EAST(KIAMBAA),Rural,26,426,404,830,Kiambu,CENTRAL,13557
KIAMBU EAST(KIAMBAA),Rural,27,416,362,778,Kiambu,CENTRAL,13558
KIAMBU EAST(KIAMBAA),Rural,28,413,397,810,Kiambu,CENTRAL,13559
KIAMBU EAST(KIAMBAA),Rural,29,411,405,816,Kiambu,CENTRAL,13560
KIAMBU EAST(KIAMBAA),Rural,30,527,509,1036,Kiambu,CENTRAL,13561
KIAMBU EAST(KIAMBAA),Rural,31,347,285,632,Kiambu,CENTRAL,13562
KIAMBU EAST(KIAMBAA),Rural,32,380,390,770,Kiambu,CENTRAL,13563
KIAMBU EAST(KIAMBAA),Rural,33,285,282,567,Kiambu,CENTRAL,13564
KIAMBU EAST(KIAMBAA),Rural,34,359,314,673,Kiambu,CENTRAL,13565
KIAMBU EAST(KIAMBAA),Rural,35,467,424,891,Kiambu,CENTRAL,13566
KIAMBU EAST(KIAMBAA),Rural,36,300,268,568,Kiambu,CENTRAL,13567
KIAMBU EAST(KIAMBAA),Rural,37,303,255,558,Kiambu,CENTRAL,13568
KIAMBU EAST(KIAMBAA),Rural,38,285,275,560,Kiambu,CENTRAL,13569
KIAMBU EAST(KIAMBAA),Rural,39,273,209,482,Kiambu,CENTRAL,13570
KIAMBU EAST(KIAMBAA),Rural,40,403,343,746,Kiambu,CENTRAL,13571
KIAMBU EAST(KIAMBAA),Rural,41,257,190,447,Kiambu,CENTRAL,13572
KIAMBU EAST(KIAMBAA),Rural,42,254,246,500,Kiambu,CENTRAL,13573
KIAMBU EAST(KIAMBAA),Rural,43,186,224,410,Kiambu,CENTRAL,13574
KIAMBU EAST(KIAMBAA),Rural,44,181,162,343,Kiambu,CENTRAL,13575
KIAMBU EAST(KIAMBAA),Rural,45,310,278,588,Kiambu,CENTRAL,13576
KIAMBU EAST(KIAMBAA),Rural,46,246,187,433,Kiambu,CENTRAL,13577
KIAMBU EAST(KIAMBAA),Rural,47,214,164,378,Kiambu,CENTRAL,13578
KIAMBU EAST(KIAMBAA),Rural,48,186,159,345,Kiambu,CENTRAL,13579
KIAMBU EAST(KIAMBAA),Rural,49,165,153,318,Kiambu,CENTRAL,13580
KIAMBU EAST(KIAMBAA),Rural,50,206,240,446,Kiambu,CENTRAL,13581
KIAMBU EAST(KIAMBAA),Rural,51,132,104,236,Kiambu,CENTRAL,13582
KIAMBU EAST(KIAMBAA),Rural,52,134,122,256,Kiambu,CENTRAL,13583
KIAMBU EAST(KIAMBAA),Rural,53,93,81,174,Kiambu,CENTRAL,13584
KIAMBU EAST(KIAMBAA),Rural,54,106,101,207,Kiambu,CENTRAL,13585
KIAMBU EAST(KIAMBAA),Rural,55,142,140,282,Kiambu,CENTRAL,13586
KIAMBU EAST(KIAMBAA),Rural,56,89,98,187,Kiambu,CENTRAL,13587
KIAMBU EAST(KIAMBAA),Rural,57,133,126,259,Kiambu,CENTRAL,13588
KIAMBU EAST(KIAMBAA),Rural,58,67,60,127,Kiambu,CENTRAL,13589
KIAMBU EAST(KIAMBAA),Rural,59,98,88,186,Kiambu,CENTRAL,13590
KIAMBU EAST(KIAMBAA),Rural,60,127,137,264,Kiambu,CENTRAL,13591
KIAMBU EAST(KIAMBAA),Rural,61,75,85,160,Kiambu,CENTRAL,13592
KIAMBU EAST(KIAMBAA),Rural,62,87,57,144,Kiambu,CENTRAL,13593
KIAMBU EAST(KIAMBAA),Rural,63,76,52,128,Kiambu,CENTRAL,13594
KIAMBU EAST(KIAMBAA),Rural,64,61,68,129,Kiambu,CENTRAL,13595
KIAMBU EAST(KIAMBAA),Rural,65,96,95,191,Kiambu,CENTRAL,13596
KIAMBU EAST(KIAMBAA),Rural,66,66,80,146,Kiambu,CENTRAL,13597
KIAMBU EAST(KIAMBAA),Rural,67,72,56,128,Kiambu,CENTRAL,13598
KIAMBU EAST(KIAMBAA),Rural,68,41,46,87,Kiambu,CENTRAL,13599
KIAMBU EAST(KIAMBAA),Rural,69,44,51,95,Kiambu,CENTRAL,13600
KIAMBU EAST(KIAMBAA),Rural,70,64,134,198,Kiambu,CENTRAL,13601
KIAMBU EAST(KIAMBAA),Rural,71,46,34,80,Kiambu,CENTRAL,13602
KIAMBU EAST(KIAMBAA),Rural,72,45,37,82,Kiambu,CENTRAL,13603
KIAMBU EAST(KIAMBAA),Rural,73,27,38,65,Kiambu,CENTRAL,13604
KIAMBU EAST(KIAMBAA),Rural,74,35,45,80,Kiambu,CENTRAL,13605
KIAMBU EAST(KIAMBAA),Rural,75,35,52,87,Kiambu,CENTRAL,13606
KIAMBU EAST(KIAMBAA),Rural,76,19,32,51,Kiambu,CENTRAL,13607
KIAMBU EAST(KIAMBAA),Rural,77,26,28,54,Kiambu,CENTRAL,13608
KIAMBU EAST(KIAMBAA),Rural,78,22,25,47,Kiambu,CENTRAL,13609
KIAMBU EAST(KIAMBAA),Rural,79,23,37,60,Kiambu,CENTRAL,13610
KIAMBU EAST(KIAMBAA),Rural,80+,188,357,545,Kiambu,CENTRAL,13611
KIAMBU EAST(KIAMBAA),Rural,Age NS,23,18,41,Kiambu,CENTRAL,13612
KIKUYU,Rural,0,5,9,14,Kiambu,CENTRAL,13613
KIKUYU,Rural,1,6,7,13,Kiambu,CENTRAL,13614
KIKUYU,Rural,2,5,7,12,Kiambu,CENTRAL,13615
KIKUYU,Rural,3,9,10,19,Kiambu,CENTRAL,13616
KIKUYU,Rural,5,10,14,24,Kiambu,CENTRAL,13617
KIKUYU,Rural,6,5,8,13,Kiambu,CENTRAL,13618
KIKUYU,Rural,7,7,8,15,Kiambu,CENTRAL,13619
KIKUYU,Rural,8,8,8,16,Kiambu,CENTRAL,13620
KIKUYU,Rural,9,5,8,13,Kiambu,CENTRAL,13621
KIKUYU,Rural,10,8,8,16,Kiambu,CENTRAL,13622
KIKUYU,Rural,11,7,11,18,Kiambu,CENTRAL,13623
KIKUYU,Rural,12,10,6,16,Kiambu,CENTRAL,13624
KIKUYU,Rural,13,12,12,24,Kiambu,CENTRAL,13625
KIKUYU,Rural,14,4,12,16,Kiambu,CENTRAL,13626
KIKUYU,Rural,15,9,10,19,Kiambu,CENTRAL,13627
KIKUYU,Rural,16,3,9,12,Kiambu,CENTRAL,13628
KIKUYU,Rural,17,13,10,23,Kiambu,CENTRAL,13629
KIKUYU,Rural,18,9,9,18,Kiambu,CENTRAL,13630
KIKUYU,Rural,19,5,12,17,Kiambu,CENTRAL,13631
KIKUYU,Rural,20,9,11,20,Kiambu,CENTRAL,13632
KIKUYU,Rural,21,10,7,17,Kiambu,CENTRAL,13633
KIKUYU,Rural,22,13,7,20,Kiambu,CENTRAL,13634
KIKUYU,Rural,23,10,12,22,Kiambu,CENTRAL,13635
KIKUYU,Rural,24,10,5,15,Kiambu,CENTRAL,13636
KIKUYU,Rural,25,22,11,33,Kiambu,CENTRAL,13637
KIKUYU,Rural,26,5,7,12,Kiambu,CENTRAL,13638
KIKUYU,Rural,27,17,7,24,Kiambu,CENTRAL,13639
KIKUYU,Rural,28,8,4,12,Kiambu,CENTRAL,13640
KIKUYU,Rural,29,11,9,20,Kiambu,CENTRAL,13641
KIKUYU,Rural,30,14,7,21,Kiambu,CENTRAL,13642
KIKUYU,Rural,31,5,0,5,Kiambu,CENTRAL,13643
KIKUYU,Rural,32,11,3,14,Kiambu,CENTRAL,13644
KIKUYU,Rural,33,6,3,9,Kiambu,CENTRAL,13645
KIKUYU,Rural,34,5,5,10,Kiambu,CENTRAL,13646
KIKUYU,Rural,35,5,5,10,Kiambu,CENTRAL,13647
KIKUYU,Rural,36,3,5,8,Kiambu,CENTRAL,13648
KIKUYU,Rural,37,2,7,9,Kiambu,CENTRAL,13649
KIKUYU,Rural,38,6,5,11,Kiambu,CENTRAL,13650
KIKUYU,Rural,39,4,9,13,Kiambu,CENTRAL,13651
KIKUYU,Rural,40,6,5,11,Kiambu,CENTRAL,13652
KIKUYU,Rural,41,8,9,17,Kiambu,CENTRAL,13653
KIKUYU,Rural,42,5,9,14,Kiambu,CENTRAL,13654
KIKUYU,Rural,43,4,4,8,Kiambu,CENTRAL,13655
KIKUYU,Rural,44,2,1,3,Kiambu,CENTRAL,13656
KIKUYU,Rural,45,4,4,8,Kiambu,CENTRAL,13657
KIKUYU,Rural,46,8,6,14,Kiambu,CENTRAL,13658
KIKUYU,Rural,47,5,3,8,Kiambu,CENTRAL,13659
KIKUYU,Rural,48,7,4,11,Kiambu,CENTRAL,13660
KIKUYU,Rural,49,4,4,8,Kiambu,CENTRAL,13661
KIKUYU,Rural,50,5,0,5,Kiambu,CENTRAL,13662
KIKUYU,Rural,51,3,1,4,Kiambu,CENTRAL,13663
KIKUYU,Rural,52,3,1,4,Kiambu,CENTRAL,13664
KIKUYU,Rural,53,4,0,4,Kiambu,CENTRAL,13665
KIKUYU,Rural,54,4,2,6,Kiambu,CENTRAL,13666
KIKUYU,Rural,55,3,5,8,Kiambu,CENTRAL,13667
KIKUYU,Rural,56,2,0,2,Kiambu,CENTRAL,13668
KIKUYU,Rural,57,1,1,2,Kiambu,CENTRAL,13669
KIKUYU,Rural,58,1,0,1,Kiambu,CENTRAL,13670
KIKUYU,Rural,59,3,0,3,Kiambu,CENTRAL,13671
KIKUYU,Rural,60,3,0,3,Kiambu,CENTRAL,13672
KIKUYU,Rural,61,0,1,1,Kiambu,CENTRAL,13673
KIKUYU,Rural,62,1,0,1,Kiambu,CENTRAL,13674
KIKUYU,Rural,63,1,2,3,Kiambu,CENTRAL,13675
KIKUYU,Rural,64,1,1,2,Kiambu,CENTRAL,13676
KIKUYU,Rural,65,0,0,0,Kiambu,CENTRAL,13677
KIKUYU,Rural,66,1,3,4,Kiambu,CENTRAL,13678
KIKUYU,Rural,67,0,0,0,Kiambu,CENTRAL,13679
KIKUYU,Rural,68,0,1,1,Kiambu,CENTRAL,13680
KIKUYU,Rural,69,0,2,2,Kiambu,CENTRAL,13681
KIKUYU,Rural,70,1,1,2,Kiambu,CENTRAL,13682
KIKUYU,Rural,71,0,0,0,Kiambu,CENTRAL,13683
KIKUYU,Rural,72,0,0,0,Kiambu,CENTRAL,13684
KIKUYU,Rural,73,1,1,2,Kiambu,CENTRAL,13685
KIKUYU,Rural,74,0,0,0,Kiambu,CENTRAL,13686
KIKUYU,Rural,75,1,0,1,Kiambu,CENTRAL,13687
KIKUYU,Rural,76,1,0,1,Kiambu,CENTRAL,13688
KIKUYU,Rural,77,0,0,0,Kiambu,CENTRAL,13689
KIKUYU,Rural,78,3,1,4,Kiambu,CENTRAL,13690
KIKUYU,Rural,79,0,2,2,Kiambu,CENTRAL,13691
KIKUYU,Rural,80+,3,6,9,Kiambu,CENTRAL,13692
KIKUYU,Rural,Age NS,2,2,4,Kiambu,CENTRAL,13693
KIAMBU WEST,Rural,0,670,691,1361,Kiambu,CENTRAL,13694
KIAMBU WEST,Rural,1,669,621,1290,Kiambu,CENTRAL,13695
KIAMBU WEST,Rural,2,637,612,1249,Kiambu,CENTRAL,13696
KIAMBU WEST,Rural,3,702,674,1376,Kiambu,CENTRAL,13697
KIAMBU WEST,Rural,4,650,687,1337,Kiambu,CENTRAL,13698
KIAMBU WEST,Rural,5,686,669,1355,Kiambu,CENTRAL,13699
KIAMBU WEST,Rural,6,654,611,1265,Kiambu,CENTRAL,13700
KIAMBU WEST,Rural,7,630,629,1259,Kiambu,CENTRAL,13701
KIAMBU WEST,Rural,8,604,586,1190,Kiambu,CENTRAL,13702
KIAMBU WEST,Rural,9,674,612,1286,Kiambu,CENTRAL,13703
KIAMBU WEST,Rural,10,637,637,1274,Kiambu,CENTRAL,13704
KIAMBU WEST,Rural,11,555,547,1102,Kiambu,CENTRAL,13705
KIAMBU WEST,Rural,12,666,706,1372,Kiambu,CENTRAL,13706
KIAMBU WEST,Rural,13,648,666,1314,Kiambu,CENTRAL,13707
KIAMBU WEST,Rural,14,568,547,1115,Kiambu,CENTRAL,13708
KIAMBU WEST,Rural,15,542,504,1046,Kiambu,CENTRAL,13709
KIAMBU WEST,Rural,16,552,488,1040,Kiambu,CENTRAL,13710
KIAMBU WEST,Rural,17,541,513,1054,Kiambu,CENTRAL,13711
KIAMBU WEST,Rural,18,509,502,1011,Kiambu,CENTRAL,13712
KIAMBU WEST,Rural,19,477,459,936,Kiambu,CENTRAL,13713
KIAMBU WEST,Rural,20,470,544,1014,Kiambu,CENTRAL,13714
KIAMBU WEST,Rural,21,424,365,789,Kiambu,CENTRAL,13715
KIAMBU WEST,Rural,22,461,481,942,Kiambu,CENTRAL,13716
KIAMBU WEST,Rural,23,418,447,865,Kiambu,CENTRAL,13717
KIAMBU WEST,Rural,24,449,476,925,Kiambu,CENTRAL,13718
KIAMBU WEST,Rural,25,528,545,1073,Kiambu,CENTRAL,13719
KIAMBU WEST,Rural,26,383,399,782,Kiambu,CENTRAL,13720
KIAMBU WEST,Rural,27,423,409,832,Kiambu,CENTRAL,13721
KIAMBU WEST,Rural,28,395,416,811,Kiambu,CENTRAL,13722
KIAMBU WEST,Rural,29,396,351,747,Kiambu,CENTRAL,13723
KIAMBU WEST,Rural,30,515,530,1045,Kiambu,CENTRAL,13724
KIAMBU WEST,Rural,31,325,263,588,Kiambu,CENTRAL,13725
KIAMBU WEST,Rural,32,375,402,777,Kiambu,CENTRAL,13726
KIAMBU WEST,Rural,33,282,272,554,Kiambu,CENTRAL,13727
KIAMBU WEST,Rural,34,331,309,640,Kiambu,CENTRAL,13728
KIAMBU WEST,Rural,35,493,427,920,Kiambu,CENTRAL,13729
KIAMBU WEST,Rural,36,298,288,586,Kiambu,CENTRAL,13730
KIAMBU WEST,Rural,37,317,288,605,Kiambu,CENTRAL,13731
KIAMBU WEST,Rural,38,281,285,566,Kiambu,CENTRAL,13732
KIAMBU WEST,Rural,39,251,256,507,Kiambu,CENTRAL,13733
KIAMBU WEST,Rural,40,412,397,809,Kiambu,CENTRAL,13734
KIAMBU WEST,Rural,41,196,220,416,Kiambu,CENTRAL,13735
KIAMBU WEST,Rural,42,253,197,450,Kiambu,CENTRAL,13736
KIAMBU WEST,Rural,43,198,205,403,Kiambu,CENTRAL,13737
KIAMBU WEST,Rural,44,185,206,391,Kiambu,CENTRAL,13738
KIAMBU WEST,Rural,45,326,301,627,Kiambu,CENTRAL,13739
KIAMBU WEST,Rural,46,247,236,483,Kiambu,CENTRAL,13740
KIAMBU WEST,Rural,47,182,193,375,Kiambu,CENTRAL,13741
KIAMBU WEST,Rural,48,166,194,360,Kiambu,CENTRAL,13742
KIAMBU WEST,Rural,49,182,202,384,Kiambu,CENTRAL,13743
KIAMBU WEST,Rural,50,249,254,503,Kiambu,CENTRAL,13744
KIAMBU WEST,Rural,51,151,159,310,Kiambu,CENTRAL,13745
KIAMBU WEST,Rural,52,144,123,267,Kiambu,CENTRAL,13746
KIAMBU WEST,Rural,53,129,113,242,Kiambu,CENTRAL,13747
KIAMBU WEST,Rural,54,112,106,218,Kiambu,CENTRAL,13748
KIAMBU WEST,Rural,55,149,161,310,Kiambu,CENTRAL,13749
KIAMBU WEST,Rural,56,107,108,215,Kiambu,CENTRAL,13750
KIAMBU WEST,Rural,57,165,126,291,Kiambu,CENTRAL,13751
KIAMBU WEST,Rural,58,105,93,198,Kiambu,CENTRAL,13752
KIAMBU WEST,Rural,59,137,92,229,Kiambu,CENTRAL,13753
KIAMBU WEST,Rural,60,182,203,385,Kiambu,CENTRAL,13754
KIAMBU WEST,Rural,61,86,79,165,Kiambu,CENTRAL,13755
KIAMBU WEST,Rural,62,114,112,226,Kiambu,CENTRAL,13756
KIAMBU WEST,Rural,63,77,77,154,Kiambu,CENTRAL,13757
KIAMBU WEST,Rural,64,80,84,164,Kiambu,CENTRAL,13758
KIAMBU WEST,Rural,65,99,139,238,Kiambu,CENTRAL,13759
KIAMBU WEST,Rural,66,82,111,193,Kiambu,CENTRAL,13760
KIAMBU WEST,Rural,67,54,72,126,Kiambu,CENTRAL,13761
KIAMBU WEST,Rural,68,34,52,86,Kiambu,CENTRAL,13762
KIAMBU WEST,Rural,69,64,75,139,Kiambu,CENTRAL,13763
KIAMBU WEST,Rural,70,105,134,239,Kiambu,CENTRAL,13764
KIAMBU WEST,Rural,71,49,64,113,Kiambu,CENTRAL,13765
KIAMBU WEST,Rural,72,52,59,111,Kiambu,CENTRAL,13766
KIAMBU WEST,Rural,73,38,59,97,Kiambu,CENTRAL,13767
KIAMBU WEST,Rural,74,38,63,101,Kiambu,CENTRAL,13768
KIAMBU WEST,Rural,75,52,95,147,Kiambu,CENTRAL,13769
KIAMBU WEST,Rural,76,40,50,90,Kiambu,CENTRAL,13770
KIAMBU WEST,Rural,77,38,35,73,Kiambu,CENTRAL,13771
KIAMBU WEST,Rural,78,24,40,64,Kiambu,CENTRAL,13772
KIAMBU WEST,Rural,79,35,52,87,Kiambu,CENTRAL,13773
KIAMBU WEST,Rural,80+,259,440,699,Kiambu,CENTRAL,13774
KIAMBU WEST,Rural,Age NS,10,13,23,Kiambu,CENTRAL,13775
LARI,Rural,0,1653,1582,3235,Kiambu,CENTRAL,13776
LARI,Rural,1,1555,1490,3045,Kiambu,CENTRAL,13777
LARI,Rural,2,1589,1538,3127,Kiambu,CENTRAL,13778
LARI,Rural,3,1704,1654,3358,Kiambu,CENTRAL,13779
LARI,Rural,4,1771,1708,3479,Kiambu,CENTRAL,13780
LARI,Rural,5,1742,1759,3501,Kiambu,CENTRAL,13781
LARI,Rural,6,1644,1699,3343,Kiambu,CENTRAL,13782
LARI,Rural,7,1678,1619,3297,Kiambu,CENTRAL,13783
LARI,Rural,8,1611,1570,3181,Kiambu,CENTRAL,13784
LARI,Rural,9,1845,1683,3528,Kiambu,CENTRAL,13785
LARI,Rural,10,1705,1686,3391,Kiambu,CENTRAL,13786
LARI,Rural,11,1402,1455,2857,Kiambu,CENTRAL,13787
LARI,Rural,12,1725,1617,3342,Kiambu,CENTRAL,13788
LARI,Rural,13,1606,1652,3258,Kiambu,CENTRAL,13789
LARI,Rural,14,1521,1450,2971,Kiambu,CENTRAL,13790
LARI,Rural,15,1453,1416,2869,Kiambu,CENTRAL,13791
LARI,Rural,16,1361,1420,2781,Kiambu,CENTRAL,13792
LARI,Rural,17,1391,1303,2694,Kiambu,CENTRAL,13793
LARI,Rural,18,1257,1185,2442,Kiambu,CENTRAL,13794
LARI,Rural,19,1242,1078,2320,Kiambu,CENTRAL,13795
LARI,Rural,20,1223,1187,2410,Kiambu,CENTRAL,13796
LARI,Rural,21,990,957,1947,Kiambu,CENTRAL,13797
LARI,Rural,22,973,1101,2074,Kiambu,CENTRAL,13798
LARI,Rural,23,979,1035,2014,Kiambu,CENTRAL,13799
LARI,Rural,24,900,1047,1947,Kiambu,CENTRAL,13800
LARI,Rural,25,1094,1310,2404,Kiambu,CENTRAL,13801
LARI,Rural,26,806,1042,1848,Kiambu,CENTRAL,13802
LARI,Rural,27,971,954,1925,Kiambu,CENTRAL,13803
LARI,Rural,28,731,943,1674,Kiambu,CENTRAL,13804
LARI,Rural,29,808,952,1760,Kiambu,CENTRAL,13805
LARI,Rural,30,1095,1222,2317,Kiambu,CENTRAL,13806
LARI,Rural,31,803,793,1596,Kiambu,CENTRAL,13807
LARI,Rural,32,789,889,1678,Kiambu,CENTRAL,13808
LARI,Rural,33,702,757,1459,Kiambu,CENTRAL,13809
LARI,Rural,34,692,791,1483,Kiambu,CENTRAL,13810
LARI,Rural,35,1041,1134,2175,Kiambu,CENTRAL,13811
LARI,Rural,36,677,693,1370,Kiambu,CENTRAL,13812
LARI,Rural,37,699,700,1399,Kiambu,CENTRAL,13813
LARI,Rural,38,586,715,1301,Kiambu,CENTRAL,13814
LARI,Rural,39,605,668,1273,Kiambu,CENTRAL,13815
LARI,Rural,40,881,974,1855,Kiambu,CENTRAL,13816
LARI,Rural,41,527,578,1105,Kiambu,CENTRAL,13817
LARI,Rural,42,505,540,1045,Kiambu,CENTRAL,13818
LARI,Rural,43,473,574,1047,Kiambu,CENTRAL,13819
LARI,Rural,44,458,483,941,Kiambu,CENTRAL,13820
LARI,Rural,45,715,738,1453,Kiambu,CENTRAL,13821
LARI,Rural,46,498,539,1037,Kiambu,CENTRAL,13822
LARI,Rural,47,428,474,902,Kiambu,CENTRAL,13823
LARI,Rural,48,376,420,796,Kiambu,CENTRAL,13824
LARI,Rural,49,363,445,808,Kiambu,CENTRAL,13825
LARI,Rural,50,516,575,1091,Kiambu,CENTRAL,13826
LARI,Rural,51,297,334,631,Kiambu,CENTRAL,13827
LARI,Rural,52,309,299,608,Kiambu,CENTRAL,13828
LARI,Rural,53,225,260,485,Kiambu,CENTRAL,13829
LARI,Rural,54,236,257,493,Kiambu,CENTRAL,13830
LARI,Rural,55,336,384,720,Kiambu,CENTRAL,13831
LARI,Rural,56,272,328,600,Kiambu,CENTRAL,13832
LARI,Rural,57,364,369,733,Kiambu,CENTRAL,13833
LARI,Rural,58,177,198,375,Kiambu,CENTRAL,13834
LARI,Rural,59,245,301,546,Kiambu,CENTRAL,13835
LARI,Rural,60,384,429,813,Kiambu,CENTRAL,13836
LARI,Rural,61,269,271,540,Kiambu,CENTRAL,13837
LARI,Rural,62,232,221,453,Kiambu,CENTRAL,13838
LARI,Rural,63,210,197,407,Kiambu,CENTRAL,13839
LARI,Rural,64,196,214,410,Kiambu,CENTRAL,13840
LARI,Rural,65,239,250,489,Kiambu,CENTRAL,13841
LARI,Rural,66,196,285,481,Kiambu,CENTRAL,13842
LARI,Rural,67,206,194,400,Kiambu,CENTRAL,13843
LARI,Rural,68,92,138,230,Kiambu,CENTRAL,13844
LARI,Rural,69,156,154,310,Kiambu,CENTRAL,13845
LARI,Rural,70,215,316,531,Kiambu,CENTRAL,13846
LARI,Rural,71,117,109,226,Kiambu,CENTRAL,13847
LARI,Rural,72,94,116,210,Kiambu,CENTRAL,13848
LARI,Rural,73,112,133,245,Kiambu,CENTRAL,13849
LARI,Rural,74,105,154,259,Kiambu,CENTRAL,13850
LARI,Rural,75,105,146,251,Kiambu,CENTRAL,13851
LARI,Rural,76,69,97,166,Kiambu,CENTRAL,13852
LARI,Rural,77,68,92,160,Kiambu,CENTRAL,13853
LARI,Rural,78,69,85,154,Kiambu,CENTRAL,13854
LARI,Rural,79,81,99,180,Kiambu,CENTRAL,13855
LARI,Rural,80+,592,1027,1619,Kiambu,CENTRAL,13856
LARI,Rural,Age NS,5,12,17,Kiambu,CENTRAL,13857
GITHUNGURI,Rural,0,1499,1428,2927,Kiambu,CENTRAL,13858
GITHUNGURI,Rural,1,1436,1379,2815,Kiambu,CENTRAL,13859
GITHUNGURI,Rural,2,1465,1424,2889,Kiambu,CENTRAL,13860
GITHUNGURI,Rural,3,1567,1567,3134,Kiambu,CENTRAL,13861
GITHUNGURI,Rural,4,1598,1548,3146,Kiambu,CENTRAL,13862
GITHUNGURI,Rural,5,1651,1621,3272,Kiambu,CENTRAL,13863
GITHUNGURI,Rural,6,1512,1449,2961,Kiambu,CENTRAL,13864
GITHUNGURI,Rural,7,1566,1501,3067,Kiambu,CENTRAL,13865
GITHUNGURI,Rural,8,1523,1410,2933,Kiambu,CENTRAL,13866
GITHUNGURI,Rural,9,1642,1676,3318,Kiambu,CENTRAL,13867
GITHUNGURI,Rural,10,1538,1595,3133,Kiambu,CENTRAL,13868
GITHUNGURI,Rural,11,1427,1521,2948,Kiambu,CENTRAL,13869
GITHUNGURI,Rural,12,1666,1668,3334,Kiambu,CENTRAL,13870
GITHUNGURI,Rural,13,1655,1636,3291,Kiambu,CENTRAL,13871
GITHUNGURI,Rural,14,1479,1302,2781,Kiambu,CENTRAL,13872
GITHUNGURI,Rural,15,1373,1181,2554,Kiambu,CENTRAL,13873
GITHUNGURI,Rural,16,1283,1263,2546,Kiambu,CENTRAL,13874
GITHUNGURI,Rural,17,1322,1162,2484,Kiambu,CENTRAL,13875
GITHUNGURI,Rural,18,1256,1108,2364,Kiambu,CENTRAL,13876
GITHUNGURI,Rural,19,1206,1027,2233,Kiambu,CENTRAL,13877
GITHUNGURI,Rural,20,1333,1148,2481,Kiambu,CENTRAL,13878
GITHUNGURI,Rural,21,1113,961,2074,Kiambu,CENTRAL,13879
GITHUNGURI,Rural,22,1160,1009,2169,Kiambu,CENTRAL,13880
GITHUNGURI,Rural,23,999,1016,2015,Kiambu,CENTRAL,13881
GITHUNGURI,Rural,24,921,981,1902,Kiambu,CENTRAL,13882
GITHUNGURI,Rural,25,1182,1259,2441,Kiambu,CENTRAL,13883
GITHUNGURI,Rural,26,949,973,1922,Kiambu,CENTRAL,13884
GITHUNGURI,Rural,27,961,1041,2002,Kiambu,CENTRAL,13885
GITHUNGURI,Rural,28,888,1015,1903,Kiambu,CENTRAL,13886
GITHUNGURI,Rural,29,910,982,1892,Kiambu,CENTRAL,13887
GITHUNGURI,Rural,30,1146,1364,2510,Kiambu,CENTRAL,13888
GITHUNGURI,Rural,31,838,826,1664,Kiambu,CENTRAL,13889
GITHUNGURI,Rural,32,865,972,1837,Kiambu,CENTRAL,13890
GITHUNGURI,Rural,33,772,789,1561,Kiambu,CENTRAL,13891
GITHUNGURI,Rural,34,810,810,1620,Kiambu,CENTRAL,13892
GITHUNGURI,Rural,35,1108,1126,2234,Kiambu,CENTRAL,13893
GITHUNGURI,Rural,36,770,756,1526,Kiambu,CENTRAL,13894
GITHUNGURI,Rural,37,737,786,1523,Kiambu,CENTRAL,13895
GITHUNGURI,Rural,38,664,830,1494,Kiambu,CENTRAL,13896
GITHUNGURI,Rural,39,716,747,1463,Kiambu,CENTRAL,13897
GITHUNGURI,Rural,40,962,1014,1976,Kiambu,CENTRAL,13898
GITHUNGURI,Rural,41,577,558,1135,Kiambu,CENTRAL,13899
GITHUNGURI,Rural,42,603,648,1251,Kiambu,CENTRAL,13900
GITHUNGURI,Rural,43,521,565,1086,Kiambu,CENTRAL,13901
GITHUNGURI,Rural,44,538,534,1072,Kiambu,CENTRAL,13902
GITHUNGURI,Rural,45,841,934,1775,Kiambu,CENTRAL,13903
GITHUNGURI,Rural,46,589,626,1215,Kiambu,CENTRAL,13904
GITHUNGURI,Rural,47,530,533,1063,Kiambu,CENTRAL,13905
GITHUNGURI,Rural,48,441,499,940,Kiambu,CENTRAL,13906
GITHUNGURI,Rural,49,500,519,1019,Kiambu,CENTRAL,13907
GITHUNGURI,Rural,50,655,758,1413,Kiambu,CENTRAL,13908
GITHUNGURI,Rural,51,442,428,870,Kiambu,CENTRAL,13909
GITHUNGURI,Rural,52,412,404,816,Kiambu,CENTRAL,13910
GITHUNGURI,Rural,53,316,334,650,Kiambu,CENTRAL,13911
GITHUNGURI,Rural,54,316,346,662,Kiambu,CENTRAL,13912
GITHUNGURI,Rural,55,442,511,953,Kiambu,CENTRAL,13913
GITHUNGURI,Rural,56,358,357,715,Kiambu,CENTRAL,13914
GITHUNGURI,Rural,57,441,467,908,Kiambu,CENTRAL,13915
GITHUNGURI,Rural,58,213,267,480,Kiambu,CENTRAL,13916
GITHUNGURI,Rural,59,298,330,628,Kiambu,CENTRAL,13917
GITHUNGURI,Rural,60,473,607,1080,Kiambu,CENTRAL,13918
GITHUNGURI,Rural,61,263,296,559,Kiambu,CENTRAL,13919
GITHUNGURI,Rural,62,299,244,543,Kiambu,CENTRAL,13920
GITHUNGURI,Rural,63,242,245,487,Kiambu,CENTRAL,13921
GITHUNGURI,Rural,64,247,276,523,Kiambu,CENTRAL,13922
GITHUNGURI,Rural,65,304,363,667,Kiambu,CENTRAL,13923
GITHUNGURI,Rural,66,267,438,705,Kiambu,CENTRAL,13924
GITHUNGURI,Rural,67,258,255,513,Kiambu,CENTRAL,13925
GITHUNGURI,Rural,68,154,189,343,Kiambu,CENTRAL,13926
GITHUNGURI,Rural,69,177,235,412,Kiambu,CENTRAL,13927
GITHUNGURI,Rural,70,300,448,748,Kiambu,CENTRAL,13928
GITHUNGURI,Rural,71,118,140,258,Kiambu,CENTRAL,13929
GITHUNGURI,Rural,72,156,140,296,Kiambu,CENTRAL,13930
GITHUNGURI,Rural,73,170,164,334,Kiambu,CENTRAL,13931
GITHUNGURI,Rural,74,175,181,356,Kiambu,CENTRAL,13932
GITHUNGURI,Rural,75,163,233,396,Kiambu,CENTRAL,13933
GITHUNGURI,Rural,76,115,138,253,Kiambu,CENTRAL,13934
GITHUNGURI,Rural,77,92,145,237,Kiambu,CENTRAL,13935
GITHUNGURI,Rural,78,98,105,203,Kiambu,CENTRAL,13936
GITHUNGURI,Rural,79,124,158,282,Kiambu,CENTRAL,13937
GITHUNGURI,Rural,80+,869,1536,2405,Kiambu,CENTRAL,13938
GITHUNGURI,Rural,Age NS,26,27,53,Kiambu,CENTRAL,13939
THIKA EAST,Rural,0,974,949,1923,Kiambu,CENTRAL,13940
THIKA EAST,Rural,1,998,942,1940,Kiambu,CENTRAL,13941
THIKA EAST,Rural,2,1056,1016,2072,Kiambu,CENTRAL,13942
THIKA EAST,Rural,3,1036,1020,2056,Kiambu,CENTRAL,13943
THIKA EAST,Rural,4,1143,1086,2229,Kiambu,CENTRAL,13944
THIKA EAST,Rural,5,1164,1121,2285,Kiambu,CENTRAL,13945
THIKA EAST,Rural,6,1042,1006,2048,Kiambu,CENTRAL,13946
THIKA EAST,Rural,7,1011,1051,2062,Kiambu,CENTRAL,13947
THIKA EAST,Rural,8,928,942,1870,Kiambu,CENTRAL,13948
THIKA EAST,Rural,9,1093,1041,2134,Kiambu,CENTRAL,13949
THIKA EAST,Rural,10,1094,1006,2100,Kiambu,CENTRAL,13950
THIKA EAST,Rural,11,858,787,1645,Kiambu,CENTRAL,13951
THIKA EAST,Rural,12,1020,952,1972,Kiambu,CENTRAL,13952
THIKA EAST,Rural,13,1037,1041,2078,Kiambu,CENTRAL,13953
THIKA EAST,Rural,14,907,914,1821,Kiambu,CENTRAL,13954
THIKA EAST,Rural,15,792,803,1595,Kiambu,CENTRAL,13955
THIKA EAST,Rural,16,763,706,1469,Kiambu,CENTRAL,13956
THIKA EAST,Rural,17,854,759,1613,Kiambu,CENTRAL,13957
THIKA EAST,Rural,18,793,667,1460,Kiambu,CENTRAL,13958
THIKA EAST,Rural,19,678,576,1254,Kiambu,CENTRAL,13959
THIKA EAST,Rural,20,653,692,1345,Kiambu,CENTRAL,13960
THIKA EAST,Rural,21,547,543,1090,Kiambu,CENTRAL,13961
THIKA EAST,Rural,22,576,599,1175,Kiambu,CENTRAL,13962
THIKA EAST,Rural,23,556,600,1156,Kiambu,CENTRAL,13963
THIKA EAST,Rural,24,489,520,1009,Kiambu,CENTRAL,13964
THIKA EAST,Rural,25,613,638,1251,Kiambu,CENTRAL,13965
THIKA EAST,Rural,26,499,528,1027,Kiambu,CENTRAL,13966
THIKA EAST,Rural,27,541,549,1090,Kiambu,CENTRAL,13967
THIKA EAST,Rural,28,501,602,1103,Kiambu,CENTRAL,13968
THIKA EAST,Rural,29,505,533,1038,Kiambu,CENTRAL,13969
THIKA EAST,Rural,30,757,792,1549,Kiambu,CENTRAL,13970
THIKA EAST,Rural,31,402,423,825,Kiambu,CENTRAL,13971
THIKA EAST,Rural,32,528,532,1060,Kiambu,CENTRAL,13972
THIKA EAST,Rural,33,361,351,712,Kiambu,CENTRAL,13973
THIKA EAST,Rural,34,453,396,849,Kiambu,CENTRAL,13974
THIKA EAST,Rural,35,652,648,1300,Kiambu,CENTRAL,13975
THIKA EAST,Rural,36,424,394,818,Kiambu,CENTRAL,13976
THIKA EAST,Rural,37,389,377,766,Kiambu,CENTRAL,13977
THIKA EAST,Rural,38,427,429,856,Kiambu,CENTRAL,13978
THIKA EAST,Rural,39,315,387,702,Kiambu,CENTRAL,13979
THIKA EAST,Rural,40,502,570,1072,Kiambu,CENTRAL,13980
THIKA EAST,Rural,41,284,282,566,Kiambu,CENTRAL,13981
THIKA EAST,Rural,42,337,342,679,Kiambu,CENTRAL,13982
THIKA EAST,Rural,43,253,277,530,Kiambu,CENTRAL,13983
THIKA EAST,Rural,44,264,214,478,Kiambu,CENTRAL,13984
THIKA EAST,Rural,45,438,470,908,Kiambu,CENTRAL,13985
THIKA EAST,Rural,46,317,310,627,Kiambu,CENTRAL,13986
THIKA EAST,Rural,47,275,263,538,Kiambu,CENTRAL,13987
THIKA EAST,Rural,48,230,231,461,Kiambu,CENTRAL,13988
THIKA EAST,Rural,49,268,239,507,Kiambu,CENTRAL,13989
THIKA EAST,Rural,50,364,360,724,Kiambu,CENTRAL,13990
THIKA EAST,Rural,51,186,164,350,Kiambu,CENTRAL,13991
THIKA EAST,Rural,52,213,205,418,Kiambu,CENTRAL,13992
THIKA EAST,Rural,53,146,154,300,Kiambu,CENTRAL,13993
THIKA EAST,Rural,54,159,160,319,Kiambu,CENTRAL,13994
THIKA EAST,Rural,55,211,237,448,Kiambu,CENTRAL,13995
THIKA EAST,Rural,56,191,163,354,Kiambu,CENTRAL,13996
THIKA EAST,Rural,57,210,239,449,Kiambu,CENTRAL,13997
THIKA EAST,Rural,58,117,98,215,Kiambu,CENTRAL,13998
THIKA EAST,Rural,59,132,138,270,Kiambu,CENTRAL,13999
THIKA EAST,Rural,60,227,256,483,Kiambu,CENTRAL,14000
THIKA EAST,Rural,61,131,106,237,Kiambu,CENTRAL,14001
THIKA EAST,Rural,62,121,103,224,Kiambu,CENTRAL,14002
THIKA EAST,Rural,63,85,109,194,Kiambu,CENTRAL,14003
THIKA EAST,Rural,64,105,106,211,Kiambu,CENTRAL,14004
THIKA EAST,Rural,65,157,148,305,Kiambu,CENTRAL,14005
THIKA EAST,Rural,66,75,190,265,Kiambu,CENTRAL,14006
THIKA EAST,Rural,67,99,104,203,Kiambu,CENTRAL,14007
THIKA EAST,Rural,68,78,84,162,Kiambu,CENTRAL,14008
THIKA EAST,Rural,69,61,84,145,Kiambu,CENTRAL,14009
THIKA EAST,Rural,70,143,202,345,Kiambu,CENTRAL,14010
THIKA EAST,Rural,71,54,72,126,Kiambu,CENTRAL,14011
THIKA EAST,Rural,72,66,66,132,Kiambu,CENTRAL,14012
THIKA EAST,Rural,73,58,67,125,Kiambu,CENTRAL,14013
THIKA EAST,Rural,74,57,64,121,Kiambu,CENTRAL,14014
THIKA EAST,Rural,75,86,102,188,Kiambu,CENTRAL,14015
THIKA EAST,Rural,76,51,63,114,Kiambu,CENTRAL,14016
THIKA EAST,Rural,77,53,48,101,Kiambu,CENTRAL,14017
THIKA EAST,Rural,78,32,42,74,Kiambu,CENTRAL,14018
THIKA EAST,Rural,79,47,59,106,Kiambu,CENTRAL,14019
THIKA EAST,Rural,80+,490,644,1134,Kiambu,CENTRAL,14020
THIKA EAST,Rural,Age NS,26,22,48,Kiambu,CENTRAL,14021
THIKA WEST,Rural,0,307,316,623,Kiambu,CENTRAL,14022
THIKA WEST,Rural,1,284,302,586,Kiambu,CENTRAL,14023
THIKA WEST,Rural,2,314,323,637,Kiambu,CENTRAL,14024
THIKA WEST,Rural,3,358,351,709,Kiambu,CENTRAL,14025
THIKA WEST,Rural,4,350,358,708,Kiambu,CENTRAL,14026
THIKA WEST,Rural,5,347,331,678,Kiambu,CENTRAL,14027
THIKA WEST,Rural,6,289,307,596,Kiambu,CENTRAL,14028
THIKA WEST,Rural,7,313,314,627,Kiambu,CENTRAL,14029
THIKA WEST,Rural,8,271,299,570,Kiambu,CENTRAL,14030
THIKA WEST,Rural,9,307,314,621,Kiambu,CENTRAL,14031
THIKA WEST,Rural,10,311,291,602,Kiambu,CENTRAL,14032
THIKA WEST,Rural,11,248,258,506,Kiambu,CENTRAL,14033
THIKA WEST,Rural,12,287,342,629,Kiambu,CENTRAL,14034
THIKA WEST,Rural,13,313,294,607,Kiambu,CENTRAL,14035
THIKA WEST,Rural,14,238,253,491,Kiambu,CENTRAL,14036
THIKA WEST,Rural,15,209,224,433,Kiambu,CENTRAL,14037
THIKA WEST,Rural,16,186,275,461,Kiambu,CENTRAL,14038
THIKA WEST,Rural,17,237,309,546,Kiambu,CENTRAL,14039
THIKA WEST,Rural,18,219,265,484,Kiambu,CENTRAL,14040
THIKA WEST,Rural,19,197,183,380,Kiambu,CENTRAL,14041
THIKA WEST,Rural,20,273,262,535,Kiambu,CENTRAL,14042
THIKA WEST,Rural,21,200,200,400,Kiambu,CENTRAL,14043
THIKA WEST,Rural,22,246,255,501,Kiambu,CENTRAL,14044
THIKA WEST,Rural,23,240,266,506,Kiambu,CENTRAL,14045
THIKA WEST,Rural,24,223,208,431,Kiambu,CENTRAL,14046
THIKA WEST,Rural,25,334,265,599,Kiambu,CENTRAL,14047
THIKA WEST,Rural,26,222,213,435,Kiambu,CENTRAL,14048
THIKA WEST,Rural,27,212,206,418,Kiambu,CENTRAL,14049
THIKA WEST,Rural,28,213,249,462,Kiambu,CENTRAL,14050
THIKA WEST,Rural,29,209,136,345,Kiambu,CENTRAL,14051
THIKA WEST,Rural,30,312,305,617,Kiambu,CENTRAL,14052
THIKA WEST,Rural,31,165,115,280,Kiambu,CENTRAL,14053
THIKA WEST,Rural,32,213,195,408,Kiambu,CENTRAL,14054
THIKA WEST,Rural,33,145,130,275,Kiambu,CENTRAL,14055
THIKA WEST,Rural,34,199,170,369,Kiambu,CENTRAL,14056
THIKA WEST,Rural,35,281,260,541,Kiambu,CENTRAL,14057
THIKA WEST,Rural,36,129,116,245,Kiambu,CENTRAL,14058
THIKA WEST,Rural,37,138,124,262,Kiambu,CENTRAL,14059
THIKA WEST,Rural,38,167,140,307,Kiambu,CENTRAL,14060
THIKA WEST,Rural,39,130,136,266,Kiambu,CENTRAL,14061
THIKA WEST,Rural,40,218,205,423,Kiambu,CENTRAL,14062
THIKA WEST,Rural,41,97,86,183,Kiambu,CENTRAL,14063
THIKA WEST,Rural,42,128,118,246,Kiambu,CENTRAL,14064
THIKA WEST,Rural,43,84,88,172,Kiambu,CENTRAL,14065
THIKA WEST,Rural,44,91,65,156,Kiambu,CENTRAL,14066
THIKA WEST,Rural,45,200,142,342,Kiambu,CENTRAL,14067
THIKA WEST,Rural,46,129,82,211,Kiambu,CENTRAL,14068
THIKA WEST,Rural,47,92,87,179,Kiambu,CENTRAL,14069
THIKA WEST,Rural,48,96,83,179,Kiambu,CENTRAL,14070
THIKA WEST,Rural,49,84,63,147,Kiambu,CENTRAL,14071
THIKA WEST,Rural,50,134,148,282,Kiambu,CENTRAL,14072
THIKA WEST,Rural,51,65,39,104,Kiambu,CENTRAL,14073
THIKA WEST,Rural,52,75,65,140,Kiambu,CENTRAL,14074
THIKA WEST,Rural,53,47,46,93,Kiambu,CENTRAL,14075
THIKA WEST,Rural,54,44,44,88,Kiambu,CENTRAL,14076
THIKA WEST,Rural,55,95,70,165,Kiambu,CENTRAL,14077
THIKA WEST,Rural,56,40,54,94,Kiambu,CENTRAL,14078
THIKA WEST,Rural,57,60,69,129,Kiambu,CENTRAL,14079
THIKA WEST,Rural,58,45,38,83,Kiambu,CENTRAL,14080
THIKA WEST,Rural,59,24,39,63,Kiambu,CENTRAL,14081
THIKA WEST,Rural,60,90,93,183,Kiambu,CENTRAL,14082
THIKA WEST,Rural,61,32,25,57,Kiambu,CENTRAL,14083
THIKA WEST,Rural,62,42,43,85,Kiambu,CENTRAL,14084
THIKA WEST,Rural,63,31,38,69,Kiambu,CENTRAL,14085
THIKA WEST,Rural,64,30,28,58,Kiambu,CENTRAL,14086
THIKA WEST,Rural,65,58,68,126,Kiambu,CENTRAL,14087
THIKA WEST,Rural,66,12,35,47,Kiambu,CENTRAL,14088
THIKA WEST,Rural,67,23,34,57,Kiambu,CENTRAL,14089
THIKA WEST,Rural,68,27,11,38,Kiambu,CENTRAL,14090
THIKA WEST,Rural,69,22,18,40,Kiambu,CENTRAL,14091
THIKA WEST,Rural,70,44,42,86,Kiambu,CENTRAL,14092
THIKA WEST,Rural,71,15,10,25,Kiambu,CENTRAL,14093
THIKA WEST,Rural,72,16,11,27,Kiambu,CENTRAL,14094
THIKA WEST,Rural,73,11,17,28,Kiambu,CENTRAL,14095
THIKA WEST,Rural,74,12,12,24,Kiambu,CENTRAL,14096
THIKA WEST,Rural,75,12,24,36,Kiambu,CENTRAL,14097
THIKA WEST,Rural,76,11,13,24,Kiambu,CENTRAL,14098
THIKA WEST,Rural,77,9,10,19,Kiambu,CENTRAL,14099
THIKA WEST,Rural,78,11,10,21,Kiambu,CENTRAL,14100
THIKA WEST,Rural,79,8,7,15,Kiambu,CENTRAL,14101
THIKA WEST,Rural,80+,85,143,228,Kiambu,CENTRAL,14102
THIKA WEST,Rural,Age NS,14,5,19,Kiambu,CENTRAL,14103
RUIRU,Rural,0,0,0,0,Kiambu,CENTRAL,14104
RUIRU,Rural,1,0,0,0,Kiambu,CENTRAL,14105
RUIRU,Rural,2,0,0,0,Kiambu,CENTRAL,14106
RUIRU,Rural,3,0,0,0,Kiambu,CENTRAL,14107
RUIRU,Rural,4,0,0,0,Kiambu,CENTRAL,14108
RUIRU,Rural,5,0,0,0,Kiambu,CENTRAL,14109
RUIRU,Rural,6,0,0,0,Kiambu,CENTRAL,14110
RUIRU,Rural,7,0,0,0,Kiambu,CENTRAL,14111
RUIRU,Rural,8,0,0,0,Kiambu,CENTRAL,14112
RUIRU,Rural,9,0,0,0,Kiambu,CENTRAL,14113
RUIRU,Rural,10,0,0,0,Kiambu,CENTRAL,14114
RUIRU,Rural,11,0,0,0,Kiambu,CENTRAL,14115
RUIRU,Rural,12,0,0,0,Kiambu,CENTRAL,14116
RUIRU,Rural,13,0,0,0,Kiambu,CENTRAL,14117
RUIRU,Rural,14,0,0,0,Kiambu,CENTRAL,14118
RUIRU,Rural,15,0,0,0,Kiambu,CENTRAL,14119
RUIRU,Rural,16,0,0,0,Kiambu,CENTRAL,14120
RUIRU,Rural,17,0,0,0,Kiambu,CENTRAL,14121
RUIRU,Rural,18,0,0,0,Kiambu,CENTRAL,14122
RUIRU,Rural,19,0,0,0,Kiambu,CENTRAL,14123
RUIRU,Rural,20,0,0,0,Kiambu,CENTRAL,14124
RUIRU,Rural,21,0,0,0,Kiambu,CENTRAL,14125
RUIRU,Rural,22,0,0,0,Kiambu,CENTRAL,14126
RUIRU,Rural,23,0,0,0,Kiambu,CENTRAL,14127
RUIRU,Rural,24,0,0,0,Kiambu,CENTRAL,14128
RUIRU,Rural,25,0,0,0,Kiambu,CENTRAL,14129
RUIRU,Rural,26,0,0,0,Kiambu,CENTRAL,14130
RUIRU,Rural,27,0,0,0,Kiambu,CENTRAL,14131
RUIRU,Rural,28,0,0,0,Kiambu,CENTRAL,14132
RUIRU,Rural,29,0,0,0,Kiambu,CENTRAL,14133
RUIRU,Rural,30,0,0,0,Kiambu,CENTRAL,14134
RUIRU,Rural,31,0,0,0,Kiambu,CENTRAL,14135
RUIRU,Rural,32,0,0,0,Kiambu,CENTRAL,14136
RUIRU,Rural,33,0,0,0,Kiambu,CENTRAL,14137
RUIRU,Rural,34,0,0,0,Kiambu,CENTRAL,14138
RUIRU,Rural,35,0,0,0,Kiambu,CENTRAL,14139
RUIRU,Rural,36,0,0,0,Kiambu,CENTRAL,14140
RUIRU,Rural,37,0,0,0,Kiambu,CENTRAL,14141
RUIRU,Rural,38,0,0,0,Kiambu,CENTRAL,14142
RUIRU,Rural,39,0,0,0,Kiambu,CENTRAL,14143
RUIRU,Rural,40,0,0,0,Kiambu,CENTRAL,14144
RUIRU,Rural,41,0,0,0,Kiambu,CENTRAL,14145
RUIRU,Rural,42,0,0,0,Kiambu,CENTRAL,14146
RUIRU,Rural,43,0,0,0,Kiambu,CENTRAL,14147
RUIRU,Rural,44,0,0,0,Kiambu,CENTRAL,14148
RUIRU,Rural,45,0,0,0,Kiambu,CENTRAL,14149
RUIRU,Rural,46,0,0,0,Kiambu,CENTRAL,14150
RUIRU,Rural,47,0,0,0,Kiambu,CENTRAL,14151
RUIRU,Rural,48,0,0,0,Kiambu,CENTRAL,14152
RUIRU,Rural,49,0,0,0,Kiambu,CENTRAL,14153
RUIRU,Rural,50,0,0,0,Kiambu,CENTRAL,14154
RUIRU,Rural,51,0,0,0,Kiambu,CENTRAL,14155
RUIRU,Rural,52,0,0,0,Kiambu,CENTRAL,14156
RUIRU,Rural,53,0,0,0,Kiambu,CENTRAL,14157
RUIRU,Rural,54,0,0,0,Kiambu,CENTRAL,14158
RUIRU,Rural,55,0,0,0,Kiambu,CENTRAL,14159
RUIRU,Rural,56,0,0,0,Kiambu,CENTRAL,14160
RUIRU,Rural,57,0,0,0,Kiambu,CENTRAL,14161
RUIRU,Rural,58,0,0,0,Kiambu,CENTRAL,14162
RUIRU,Rural,59,0,0,0,Kiambu,CENTRAL,14163
RUIRU,Rural,60,0,0,0,Kiambu,CENTRAL,14164
RUIRU,Rural,61,0,0,0,Kiambu,CENTRAL,14165
RUIRU,Rural,62,0,0,0,Kiambu,CENTRAL,14166
RUIRU,Rural,63,0,0,0,Kiambu,CENTRAL,14167
RUIRU,Rural,64,0,0,0,Kiambu,CENTRAL,14168
RUIRU,Rural,65,0,0,0,Kiambu,CENTRAL,14169
RUIRU,Rural,66,0,0,0,Kiambu,CENTRAL,14170
RUIRU,Rural,67,0,0,0,Kiambu,CENTRAL,14171
RUIRU,Rural,68,0,0,0,Kiambu,CENTRAL,14172
RUIRU,Rural,69,0,0,0,Kiambu,CENTRAL,14173
RUIRU,Rural,70,0,0,0,Kiambu,CENTRAL,14174
RUIRU,Rural,71,0,0,0,Kiambu,CENTRAL,14175
RUIRU,Rural,72,0,0,0,Kiambu,CENTRAL,14176
RUIRU,Rural,73,0,0,0,Kiambu,CENTRAL,14177
RUIRU,Rural,74,0,0,0,Kiambu,CENTRAL,14178
RUIRU,Rural,75,0,0,0,Kiambu,CENTRAL,14179
RUIRU,Rural,76,0,0,0,Kiambu,CENTRAL,14180
RUIRU,Rural,77,0,0,0,Kiambu,CENTRAL,14181
RUIRU,Rural,78,0,0,0,Kiambu,CENTRAL,14182
RUIRU,Rural,79,0,0,0,Kiambu,CENTRAL,14183
RUIRU,Rural,80+,0,0,0,Kiambu,CENTRAL,14184
RUIRU,Rural,Age NS,0,0,0,Kiambu,CENTRAL,14185
GATANGA,Rural,0,1398,1354,2752,Murang'a,CENTRAL,14186
GATANGA,Rural,1,1355,1290,2645,Murang'a,CENTRAL,14187
GATANGA,Rural,2,1334,1355,2689,Murang'a,CENTRAL,14188
GATANGA,Rural,3,1386,1345,2731,Murang'a,CENTRAL,14189
GATANGA,Rural,4,1503,1425,2928,Murang'a,CENTRAL,14190
GATANGA,Rural,5,1541,1430,2971,Murang'a,CENTRAL,14191
GATANGA,Rural,6,1435,1388,2823,Murang'a,CENTRAL,14192
GATANGA,Rural,7,1390,1410,2800,Murang'a,CENTRAL,14193
GATANGA,Rural,8,1360,1287,2647,Murang'a,CENTRAL,14194
GATANGA,Rural,9,1533,1399,2932,Murang'a,CENTRAL,14195
GATANGA,Rural,10,1471,1358,2829,Murang'a,CENTRAL,14196
GATANGA,Rural,11,1281,1222,2503,Murang'a,CENTRAL,14197
GATANGA,Rural,12,1437,1418,2855,Murang'a,CENTRAL,14198
GATANGA,Rural,13,1382,1447,2829,Murang'a,CENTRAL,14199
GATANGA,Rural,14,1331,1168,2499,Murang'a,CENTRAL,14200
GATANGA,Rural,15,1181,1153,2334,Murang'a,CENTRAL,14201
GATANGA,Rural,16,1266,1109,2375,Murang'a,CENTRAL,14202
GATANGA,Rural,17,1246,1138,2384,Murang'a,CENTRAL,14203
GATANGA,Rural,18,1165,983,2148,Murang'a,CENTRAL,14204
GATANGA,Rural,19,1112,935,2047,Murang'a,CENTRAL,14205
GATANGA,Rural,20,1056,1073,2129,Murang'a,CENTRAL,14206
GATANGA,Rural,21,916,827,1743,Murang'a,CENTRAL,14207
GATANGA,Rural,22,916,967,1883,Murang'a,CENTRAL,14208
GATANGA,Rural,23,863,941,1804,Murang'a,CENTRAL,14209
GATANGA,Rural,24,795,879,1674,Murang'a,CENTRAL,14210
GATANGA,Rural,25,1062,1027,2089,Murang'a,CENTRAL,14211
GATANGA,Rural,26,742,876,1618,Murang'a,CENTRAL,14212
GATANGA,Rural,27,806,836,1642,Murang'a,CENTRAL,14213
GATANGA,Rural,28,729,843,1572,Murang'a,CENTRAL,14214
GATANGA,Rural,29,764,866,1630,Murang'a,CENTRAL,14215
GATANGA,Rural,30,1039,1161,2200,Murang'a,CENTRAL,14216
GATANGA,Rural,31,712,746,1458,Murang'a,CENTRAL,14217
GATANGA,Rural,32,782,777,1559,Murang'a,CENTRAL,14218
GATANGA,Rural,33,673,663,1336,Murang'a,CENTRAL,14219
GATANGA,Rural,34,669,722,1391,Murang'a,CENTRAL,14220
GATANGA,Rural,35,945,987,1932,Murang'a,CENTRAL,14221
GATANGA,Rural,36,604,640,1244,Murang'a,CENTRAL,14222
GATANGA,Rural,37,631,596,1227,Murang'a,CENTRAL,14223
GATANGA,Rural,38,573,612,1185,Murang'a,CENTRAL,14224
GATANGA,Rural,39,496,548,1044,Murang'a,CENTRAL,14225
GATANGA,Rural,40,754,816,1570,Murang'a,CENTRAL,14226
GATANGA,Rural,41,453,520,973,Murang'a,CENTRAL,14227
GATANGA,Rural,42,444,554,998,Murang'a,CENTRAL,14228
GATANGA,Rural,43,420,468,888,Murang'a,CENTRAL,14229
GATANGA,Rural,44,386,460,846,Murang'a,CENTRAL,14230
GATANGA,Rural,45,626,738,1364,Murang'a,CENTRAL,14231
GATANGA,Rural,46,453,487,940,Murang'a,CENTRAL,14232
GATANGA,Rural,47,430,469,899,Murang'a,CENTRAL,14233
GATANGA,Rural,48,357,391,748,Murang'a,CENTRAL,14234
GATANGA,Rural,49,367,446,813,Murang'a,CENTRAL,14235
GATANGA,Rural,50,501,651,1152,Murang'a,CENTRAL,14236
GATANGA,Rural,51,315,345,660,Murang'a,CENTRAL,14237
GATANGA,Rural,52,301,355,656,Murang'a,CENTRAL,14238
GATANGA,Rural,53,285,280,565,Murang'a,CENTRAL,14239
GATANGA,Rural,54,239,244,483,Murang'a,CENTRAL,14240
GATANGA,Rural,55,320,422,742,Murang'a,CENTRAL,14241
GATANGA,Rural,56,250,289,539,Murang'a,CENTRAL,14242
GATANGA,Rural,57,381,447,828,Murang'a,CENTRAL,14243
GATANGA,Rural,58,218,224,442,Murang'a,CENTRAL,14244
GATANGA,Rural,59,259,310,569,Murang'a,CENTRAL,14245
GATANGA,Rural,60,397,470,867,Murang'a,CENTRAL,14246
GATANGA,Rural,61,277,250,527,Murang'a,CENTRAL,14247
GATANGA,Rural,62,258,226,484,Murang'a,CENTRAL,14248
GATANGA,Rural,63,222,195,417,Murang'a,CENTRAL,14249
GATANGA,Rural,64,222,212,434,Murang'a,CENTRAL,14250
GATANGA,Rural,65,251,306,557,Murang'a,CENTRAL,14251
GATANGA,Rural,66,247,367,614,Murang'a,CENTRAL,14252
GATANGA,Rural,67,175,172,347,Murang'a,CENTRAL,14253
GATANGA,Rural,68,115,135,250,Murang'a,CENTRAL,14254
GATANGA,Rural,69,184,172,356,Murang'a,CENTRAL,14255
GATANGA,Rural,70,259,320,579,Murang'a,CENTRAL,14256
GATANGA,Rural,71,111,158,269,Murang'a,CENTRAL,14257
GATANGA,Rural,72,105,141,246,Murang'a,CENTRAL,14258
GATANGA,Rural,73,124,130,254,Murang'a,CENTRAL,14259
GATANGA,Rural,74,106,138,244,Murang'a,CENTRAL,14260
GATANGA,Rural,75,127,171,298,Murang'a,CENTRAL,14261
GATANGA,Rural,76,75,120,195,Murang'a,CENTRAL,14262
GATANGA,Rural,77,79,117,196,Murang'a,CENTRAL,14263
GATANGA,Rural,78,74,101,175,Murang'a,CENTRAL,14264
GATANGA,Rural,79,73,170,243,Murang'a,CENTRAL,14265
GATANGA,Rural,80+,642,1172,1814,Murang'a,CENTRAL,14266
GATANGA,Rural,Age NS,21,15,36,Murang'a,CENTRAL,14267
GATUNDU,Rural,0,2406,2453,4859,Kiambu,CENTRAL,14268
GATUNDU,Rural,1,2250,2216,4466,Kiambu,CENTRAL,14269
GATUNDU,Rural,2,2452,2440,4892,Kiambu,CENTRAL,14270
GATUNDU,Rural,3,2564,2589,5153,Kiambu,CENTRAL,14271
GATUNDU,Rural,4,2786,2697,5483,Kiambu,CENTRAL,14272
GATUNDU,Rural,5,2785,2749,5534,Kiambu,CENTRAL,14273
GATUNDU,Rural,6,2708,2678,5386,Kiambu,CENTRAL,14274
GATUNDU,Rural,7,2705,2690,5395,Kiambu,CENTRAL,14275
GATUNDU,Rural,8,2583,2668,5251,Kiambu,CENTRAL,14276
GATUNDU,Rural,9,3060,2960,6020,Kiambu,CENTRAL,14277
GATUNDU,Rural,10,2895,2793,5688,Kiambu,CENTRAL,14278
GATUNDU,Rural,11,2510,2463,4973,Kiambu,CENTRAL,14279
GATUNDU,Rural,12,2818,2764,5582,Kiambu,CENTRAL,14280
GATUNDU,Rural,13,2949,2780,5729,Kiambu,CENTRAL,14281
GATUNDU,Rural,14,2474,2350,4824,Kiambu,CENTRAL,14282
GATUNDU,Rural,15,2351,2181,4532,Kiambu,CENTRAL,14283
GATUNDU,Rural,16,2243,2045,4288,Kiambu,CENTRAL,14284
GATUNDU,Rural,17,2303,1989,4292,Kiambu,CENTRAL,14285
GATUNDU,Rural,18,2199,1941,4140,Kiambu,CENTRAL,14286
GATUNDU,Rural,19,1986,1591,3577,Kiambu,CENTRAL,14287
GATUNDU,Rural,20,2014,1849,3863,Kiambu,CENTRAL,14288
GATUNDU,Rural,21,1453,1433,2886,Kiambu,CENTRAL,14289
GATUNDU,Rural,22,1519,1709,3228,Kiambu,CENTRAL,14290
GATUNDU,Rural,23,1428,1613,3041,Kiambu,CENTRAL,14291
GATUNDU,Rural,24,1360,1484,2844,Kiambu,CENTRAL,14292
GATUNDU,Rural,25,1692,1960,3652,Kiambu,CENTRAL,14293
GATUNDU,Rural,26,1213,1544,2757,Kiambu,CENTRAL,14294
GATUNDU,Rural,27,1352,1459,2811,Kiambu,CENTRAL,14295
GATUNDU,Rural,28,1202,1594,2796,Kiambu,CENTRAL,14296
GATUNDU,Rural,29,1235,1591,2826,Kiambu,CENTRAL,14297
GATUNDU,Rural,30,1887,2311,4198,Kiambu,CENTRAL,14298
GATUNDU,Rural,31,1135,1211,2346,Kiambu,CENTRAL,14299
GATUNDU,Rural,32,1256,1477,2733,Kiambu,CENTRAL,14300
GATUNDU,Rural,33,1083,1171,2254,Kiambu,CENTRAL,14301
GATUNDU,Rural,34,1118,1228,2346,Kiambu,CENTRAL,14302
GATUNDU,Rural,35,1680,2030,3710,Kiambu,CENTRAL,14303
GATUNDU,Rural,36,1093,1235,2328,Kiambu,CENTRAL,14304
GATUNDU,Rural,37,1027,1040,2067,Kiambu,CENTRAL,14305
GATUNDU,Rural,38,973,1252,2225,Kiambu,CENTRAL,14306
GATUNDU,Rural,39,919,1112,2031,Kiambu,CENTRAL,14307
GATUNDU,Rural,40,1513,1938,3451,Kiambu,CENTRAL,14308
GATUNDU,Rural,41,756,867,1623,Kiambu,CENTRAL,14309
GATUNDU,Rural,42,900,1073,1973,Kiambu,CENTRAL,14310
GATUNDU,Rural,43,727,899,1626,Kiambu,CENTRAL,14311
GATUNDU,Rural,44,676,827,1503,Kiambu,CENTRAL,14312
GATUNDU,Rural,45,1285,1522,2807,Kiambu,CENTRAL,14313
GATUNDU,Rural,46,927,917,1844,Kiambu,CENTRAL,14314
GATUNDU,Rural,47,697,825,1522,Kiambu,CENTRAL,14315
GATUNDU,Rural,48,645,848,1493,Kiambu,CENTRAL,14316
GATUNDU,Rural,49,711,825,1536,Kiambu,CENTRAL,14317
GATUNDU,Rural,50,1018,1486,2504,Kiambu,CENTRAL,14318
GATUNDU,Rural,51,598,661,1259,Kiambu,CENTRAL,14319
GATUNDU,Rural,52,611,700,1311,Kiambu,CENTRAL,14320
GATUNDU,Rural,53,481,547,1028,Kiambu,CENTRAL,14321
GATUNDU,Rural,54,470,532,1002,Kiambu,CENTRAL,14322
GATUNDU,Rural,55,747,893,1640,Kiambu,CENTRAL,14323
GATUNDU,Rural,56,585,588,1173,Kiambu,CENTRAL,14324
GATUNDU,Rural,57,721,694,1415,Kiambu,CENTRAL,14325
GATUNDU,Rural,58,410,414,824,Kiambu,CENTRAL,14326
GATUNDU,Rural,59,475,449,924,Kiambu,CENTRAL,14327
GATUNDU,Rural,60,890,1145,2035,Kiambu,CENTRAL,14328
GATUNDU,Rural,61,474,420,894,Kiambu,CENTRAL,14329
GATUNDU,Rural,62,416,412,828,Kiambu,CENTRAL,14330
GATUNDU,Rural,63,401,384,785,Kiambu,CENTRAL,14331
GATUNDU,Rural,64,381,423,804,Kiambu,CENTRAL,14332
GATUNDU,Rural,65,533,702,1235,Kiambu,CENTRAL,14333
GATUNDU,Rural,66,372,607,979,Kiambu,CENTRAL,14334
GATUNDU,Rural,67,346,415,761,Kiambu,CENTRAL,14335
GATUNDU,Rural,68,256,339,595,Kiambu,CENTRAL,14336
GATUNDU,Rural,69,272,370,642,Kiambu,CENTRAL,14337
GATUNDU,Rural,70,563,821,1384,Kiambu,CENTRAL,14338
GATUNDU,Rural,71,203,274,477,Kiambu,CENTRAL,14339
GATUNDU,Rural,72,234,269,503,Kiambu,CENTRAL,14340
GATUNDU,Rural,73,272,261,533,Kiambu,CENTRAL,14341
GATUNDU,Rural,74,256,262,518,Kiambu,CENTRAL,14342
GATUNDU,Rural,75,280,405,685,Kiambu,CENTRAL,14343
GATUNDU,Rural,76,166,260,426,Kiambu,CENTRAL,14344
GATUNDU,Rural,77,177,179,356,Kiambu,CENTRAL,14345
GATUNDU,Rural,78,160,211,371,Kiambu,CENTRAL,14346
GATUNDU,Rural,79,190,263,453,Kiambu,CENTRAL,14347
GATUNDU,Rural,80+,1416,2541,3957,Kiambu,CENTRAL,14348
GATUNDU,Rural,Age NS,62,37,99,Kiambu,CENTRAL,14349
KWALE,Rural,0,2273,2307,4580,Kwale ,COAST,14350
KWALE,Rural,1,2047,2049,4096,Kwale ,COAST,14351
KWALE,Rural,2,2238,2214,4452,Kwale ,COAST,14352
KWALE,Rural,3,2338,2342,4680,Kwale ,COAST,14353
KWALE,Rural,4,2198,2239,4437,Kwale ,COAST,14354
KWALE,Rural,5,2167,2115,4282,Kwale ,COAST,14355
KWALE,Rural,6,2101,2052,4153,Kwale ,COAST,14356
KWALE,Rural,7,2093,1967,4060,Kwale ,COAST,14357
KWALE,Rural,8,1986,1942,3928,Kwale ,COAST,14358
KWALE,Rural,9,2054,1965,4019,Kwale ,COAST,14359
KWALE,Rural,10,2146,2108,4254,Kwale ,COAST,14360
KWALE,Rural,11,1452,1464,2916,Kwale ,COAST,14361
KWALE,Rural,12,1909,1875,3784,Kwale ,COAST,14362
KWALE,Rural,13,1714,1675,3389,Kwale ,COAST,14363
KWALE,Rural,14,1630,1610,3240,Kwale ,COAST,14364
KWALE,Rural,15,1626,1524,3150,Kwale ,COAST,14365
KWALE,Rural,16,1533,1465,2998,Kwale ,COAST,14366
KWALE,Rural,17,1426,1394,2820,Kwale ,COAST,14367
KWALE,Rural,18,1652,1602,3254,Kwale ,COAST,14368
KWALE,Rural,19,1208,1287,2495,Kwale ,COAST,14369
KWALE,Rural,20,1485,1825,3310,Kwale ,COAST,14370
KWALE,Rural,21,807,1000,1807,Kwale ,COAST,14371
KWALE,Rural,22,1007,1352,2359,Kwale ,COAST,14372
KWALE,Rural,23,852,1172,2024,Kwale ,COAST,14373
KWALE,Rural,24,860,1096,1956,Kwale ,COAST,14374
KWALE,Rural,25,1186,1494,2680,Kwale ,COAST,14375
KWALE,Rural,26,780,1025,1805,Kwale ,COAST,14376
KWALE,Rural,27,750,868,1618,Kwale ,COAST,14377
KWALE,Rural,28,770,1037,1807,Kwale ,COAST,14378
KWALE,Rural,29,662,768,1430,Kwale ,COAST,14379
KWALE,Rural,30,1279,1600,2879,Kwale ,COAST,14380
KWALE,Rural,31,549,581,1130,Kwale ,COAST,14381
KWALE,Rural,32,802,814,1616,Kwale ,COAST,14382
KWALE,Rural,33,488,597,1085,Kwale ,COAST,14383
KWALE,Rural,34,543,546,1089,Kwale ,COAST,14384
KWALE,Rural,35,1024,1098,2122,Kwale ,COAST,14385
KWALE,Rural,36,522,556,1078,Kwale ,COAST,14386
KWALE,Rural,37,508,535,1043,Kwale ,COAST,14387
KWALE,Rural,38,507,581,1088,Kwale ,COAST,14388
KWALE,Rural,39,445,465,910,Kwale ,COAST,14389
KWALE,Rural,40,1011,1254,2265,Kwale ,COAST,14390
KWALE,Rural,41,350,308,658,Kwale ,COAST,14391
KWALE,Rural,42,390,404,794,Kwale ,COAST,14392
KWALE,Rural,43,296,280,576,Kwale ,COAST,14393
KWALE,Rural,44,302,223,525,Kwale ,COAST,14394
KWALE,Rural,45,600,674,1274,Kwale ,COAST,14395
KWALE,Rural,46,422,383,805,Kwale ,COAST,14396
KWALE,Rural,47,324,256,580,Kwale ,COAST,14397
KWALE,Rural,48,337,329,666,Kwale ,COAST,14398
KWALE,Rural,49,306,362,668,Kwale ,COAST,14399
KWALE,Rural,50,717,970,1687,Kwale ,COAST,14400
KWALE,Rural,51,243,235,478,Kwale ,COAST,14401
KWALE,Rural,52,331,316,647,Kwale ,COAST,14402
KWALE,Rural,53,259,227,486,Kwale ,COAST,14403
KWALE,Rural,54,264,245,509,Kwale ,COAST,14404
KWALE,Rural,55,432,424,856,Kwale ,COAST,14405
KWALE,Rural,56,263,214,477,Kwale ,COAST,14406
KWALE,Rural,57,304,235,539,Kwale ,COAST,14407
KWALE,Rural,58,206,172,378,Kwale ,COAST,14408
KWALE,Rural,59,190,206,396,Kwale ,COAST,14409
KWALE,Rural,60,543,627,1170,Kwale ,COAST,14410
KWALE,Rural,61,162,135,297,Kwale ,COAST,14411
KWALE,Rural,62,150,176,326,Kwale ,COAST,14412
KWALE,Rural,63,141,113,254,Kwale ,COAST,14413
KWALE,Rural,64,151,139,290,Kwale ,COAST,14414
KWALE,Rural,65,268,279,547,Kwale ,COAST,14415
KWALE,Rural,66,90,75,165,Kwale ,COAST,14416
KWALE,Rural,67,144,102,246,Kwale ,COAST,14417
KWALE,Rural,68,126,107,233,Kwale ,COAST,14418
KWALE,Rural,69,135,151,286,Kwale ,COAST,14419
KWALE,Rural,70,358,371,729,Kwale ,COAST,14420
KWALE,Rural,71,73,46,119,Kwale ,COAST,14421
KWALE,Rural,72,123,77,200,Kwale ,COAST,14422
KWALE,Rural,73,75,42,117,Kwale ,COAST,14423
KWALE,Rural,74,92,84,176,Kwale ,COAST,14424
KWALE,Rural,75,128,165,293,Kwale ,COAST,14425
KWALE,Rural,76,60,37,97,Kwale ,COAST,14426
KWALE,Rural,77,66,43,109,Kwale ,COAST,14427
KWALE,Rural,78,46,66,112,Kwale ,COAST,14428
KWALE,Rural,79,51,72,123,Kwale ,COAST,14429
KWALE,Rural,80+,477,591,1068,Kwale ,COAST,14430
KWALE,Rural,Age NS,26,28,54,Kwale ,COAST,14431
KINANGO,Rural,0,4261,4138,8399,Kwale ,COAST,14432
KINANGO,Rural,1,3706,3723,7429,Kwale ,COAST,14433
KINANGO,Rural,2,4343,4166,8509,Kwale ,COAST,14434
KINANGO,Rural,3,4068,4121,8189,Kwale ,COAST,14435
KINANGO,Rural,4,3827,3848,7675,Kwale ,COAST,14436
KINANGO,Rural,5,3708,3623,7331,Kwale ,COAST,14437
KINANGO,Rural,6,3666,3701,7367,Kwale ,COAST,14438
KINANGO,Rural,7,3327,3246,6573,Kwale ,COAST,14439
KINANGO,Rural,8,3455,3508,6963,Kwale ,COAST,14440
KINANGO,Rural,9,3308,3300,6608,Kwale ,COAST,14441
KINANGO,Rural,10,3700,3677,7377,Kwale ,COAST,14442
KINANGO,Rural,11,2531,2507,5038,Kwale ,COAST,14443
KINANGO,Rural,12,3235,3089,6324,Kwale ,COAST,14444
KINANGO,Rural,13,2926,2721,5647,Kwale ,COAST,14445
KINANGO,Rural,14,2690,2562,5252,Kwale ,COAST,14446
KINANGO,Rural,15,2549,2335,4884,Kwale ,COAST,14447
KINANGO,Rural,16,2458,2186,4644,Kwale ,COAST,14448
KINANGO,Rural,17,2197,1931,4128,Kwale ,COAST,14449
KINANGO,Rural,18,2179,2206,4385,Kwale ,COAST,14450
KINANGO,Rural,19,1577,1923,3500,Kwale ,COAST,14451
KINANGO,Rural,20,1711,2805,4516,Kwale ,COAST,14452
KINANGO,Rural,21,1037,1361,2398,Kwale ,COAST,14453
KINANGO,Rural,22,1180,2058,3238,Kwale ,COAST,14454
KINANGO,Rural,23,1014,1715,2729,Kwale ,COAST,14455
KINANGO,Rural,24,1047,1736,2783,Kwale ,COAST,14456
KINANGO,Rural,25,1209,2128,3337,Kwale ,COAST,14457
KINANGO,Rural,26,885,1419,2304,Kwale ,COAST,14458
KINANGO,Rural,27,902,1236,2138,Kwale ,COAST,14459
KINANGO,Rural,28,907,1493,2400,Kwale ,COAST,14460
KINANGO,Rural,29,659,1081,1740,Kwale ,COAST,14461
KINANGO,Rural,30,1365,2186,3551,Kwale ,COAST,14462
KINANGO,Rural,31,664,826,1490,Kwale ,COAST,14463
KINANGO,Rural,32,883,1428,2311,Kwale ,COAST,14464
KINANGO,Rural,33,659,914,1573,Kwale ,COAST,14465
KINANGO,Rural,34,680,850,1530,Kwale ,COAST,14466
KINANGO,Rural,35,1137,1412,2549,Kwale ,COAST,14467
KINANGO,Rural,36,629,919,1548,Kwale ,COAST,14468
KINANGO,Rural,37,650,650,1300,Kwale ,COAST,14469
KINANGO,Rural,38,587,763,1350,Kwale ,COAST,14470
KINANGO,Rural,39,495,536,1031,Kwale ,COAST,14471
KINANGO,Rural,40,993,1364,2357,Kwale ,COAST,14472
KINANGO,Rural,41,472,384,856,Kwale ,COAST,14473
KINANGO,Rural,42,446,412,858,Kwale ,COAST,14474
KINANGO,Rural,43,291,259,550,Kwale ,COAST,14475
KINANGO,Rural,44,259,222,481,Kwale ,COAST,14476
KINANGO,Rural,45,642,780,1422,Kwale ,COAST,14477
KINANGO,Rural,46,409,481,890,Kwale ,COAST,14478
KINANGO,Rural,47,399,459,858,Kwale ,COAST,14479
KINANGO,Rural,48,349,510,859,Kwale ,COAST,14480
KINANGO,Rural,49,421,625,1046,Kwale ,COAST,14481
KINANGO,Rural,50,679,1232,1911,Kwale ,COAST,14482
KINANGO,Rural,51,318,468,786,Kwale ,COAST,14483
KINANGO,Rural,52,369,526,895,Kwale ,COAST,14484
KINANGO,Rural,53,326,456,782,Kwale ,COAST,14485
KINANGO,Rural,54,358,373,731,Kwale ,COAST,14486
KINANGO,Rural,55,492,565,1057,Kwale ,COAST,14487
KINANGO,Rural,56,336,358,694,Kwale ,COAST,14488
KINANGO,Rural,57,406,382,788,Kwale ,COAST,14489
KINANGO,Rural,58,256,284,540,Kwale ,COAST,14490
KINANGO,Rural,59,335,455,790,Kwale ,COAST,14491
KINANGO,Rural,60,596,819,1415,Kwale ,COAST,14492
KINANGO,Rural,61,227,215,442,Kwale ,COAST,14493
KINANGO,Rural,62,202,204,406,Kwale ,COAST,14494
KINANGO,Rural,63,185,186,371,Kwale ,COAST,14495
KINANGO,Rural,64,219,246,465,Kwale ,COAST,14496
KINANGO,Rural,65,409,441,850,Kwale ,COAST,14497
KINANGO,Rural,66,150,138,288,Kwale ,COAST,14498
KINANGO,Rural,67,188,178,366,Kwale ,COAST,14499
KINANGO,Rural,68,150,183,333,Kwale ,COAST,14500
KINANGO,Rural,69,217,219,436,Kwale ,COAST,14501
KINANGO,Rural,70,399,468,867,Kwale ,COAST,14502
KINANGO,Rural,71,118,99,217,Kwale ,COAST,14503
KINANGO,Rural,72,127,130,257,Kwale ,COAST,14504
KINANGO,Rural,73,98,103,201,Kwale ,COAST,14505
KINANGO,Rural,74,109,117,226,Kwale ,COAST,14506
KINANGO,Rural,75,188,172,360,Kwale ,COAST,14507
KINANGO,Rural,76,119,97,216,Kwale ,COAST,14508
KINANGO,Rural,77,75,86,161,Kwale ,COAST,14509
KINANGO,Rural,78,104,82,186,Kwale ,COAST,14510
KINANGO,Rural,79,121,150,271,Kwale ,COAST,14511
KINANGO,Rural,80+,835,1053,1888,Kwale ,COAST,14512
KINANGO,Rural,Age NS,69,91,160,Kwale ,COAST,14513
MSAMBWENI,Rural,0,3817,3741,7558,Kwale ,COAST,14514
MSAMBWENI,Rural,1,3398,3354,6752,Kwale ,COAST,14515
MSAMBWENI,Rural,2,3722,3745,7467,Kwale ,COAST,14516
MSAMBWENI,Rural,3,3916,3830,7746,Kwale ,COAST,14517
MSAMBWENI,Rural,4,3785,3720,7505,Kwale ,COAST,14518
MSAMBWENI,Rural,5,3622,3496,7118,Kwale ,COAST,14519
MSAMBWENI,Rural,6,3396,3483,6879,Kwale ,COAST,14520
MSAMBWENI,Rural,7,3248,3205,6453,Kwale ,COAST,14521
MSAMBWENI,Rural,8,3066,3153,6219,Kwale ,COAST,14522
MSAMBWENI,Rural,9,3111,3130,6241,Kwale ,COAST,14523
MSAMBWENI,Rural,10,3513,3309,6822,Kwale ,COAST,14524
MSAMBWENI,Rural,11,2106,2106,4212,Kwale ,COAST,14525
MSAMBWENI,Rural,12,3024,2843,5867,Kwale ,COAST,14526
MSAMBWENI,Rural,13,2564,2545,5109,Kwale ,COAST,14527
MSAMBWENI,Rural,14,2398,2367,4765,Kwale ,COAST,14528
MSAMBWENI,Rural,15,2421,2250,4671,Kwale ,COAST,14529
MSAMBWENI,Rural,16,2231,2120,4351,Kwale ,COAST,14530
MSAMBWENI,Rural,17,2058,1919,3977,Kwale ,COAST,14531
MSAMBWENI,Rural,18,2198,2220,4418,Kwale ,COAST,14532
MSAMBWENI,Rural,19,1595,1768,3363,Kwale ,COAST,14533
MSAMBWENI,Rural,20,1975,2730,4705,Kwale ,COAST,14534
MSAMBWENI,Rural,21,979,1193,2172,Kwale ,COAST,14535
MSAMBWENI,Rural,22,1290,1785,3075,Kwale ,COAST,14536
MSAMBWENI,Rural,23,1184,1462,2646,Kwale ,COAST,14537
MSAMBWENI,Rural,24,1111,1431,2542,Kwale ,COAST,14538
MSAMBWENI,Rural,25,1641,2301,3942,Kwale ,COAST,14539
MSAMBWENI,Rural,26,1005,1347,2352,Kwale ,COAST,14540
MSAMBWENI,Rural,27,1076,1213,2289,Kwale ,COAST,14541
MSAMBWENI,Rural,28,1035,1443,2478,Kwale ,COAST,14542
MSAMBWENI,Rural,29,892,1096,1988,Kwale ,COAST,14543
MSAMBWENI,Rural,30,1942,2687,4629,Kwale ,COAST,14544
MSAMBWENI,Rural,31,764,853,1617,Kwale ,COAST,14545
MSAMBWENI,Rural,32,1099,1316,2415,Kwale ,COAST,14546
MSAMBWENI,Rural,33,691,756,1447,Kwale ,COAST,14547
MSAMBWENI,Rural,34,727,821,1548,Kwale ,COAST,14548
MSAMBWENI,Rural,35,1485,1742,3227,Kwale ,COAST,14549
MSAMBWENI,Rural,36,759,841,1600,Kwale ,COAST,14550
MSAMBWENI,Rural,37,677,697,1374,Kwale ,COAST,14551
MSAMBWENI,Rural,38,712,839,1551,Kwale ,COAST,14552
MSAMBWENI,Rural,39,627,609,1236,Kwale ,COAST,14553
MSAMBWENI,Rural,40,1585,1960,3545,Kwale ,COAST,14554
MSAMBWENI,Rural,41,469,373,842,Kwale ,COAST,14555
MSAMBWENI,Rural,42,622,523,1145,Kwale ,COAST,14556
MSAMBWENI,Rural,43,371,316,687,Kwale ,COAST,14557
MSAMBWENI,Rural,44,314,280,594,Kwale ,COAST,14558
MSAMBWENI,Rural,45,995,1014,2009,Kwale ,COAST,14559
MSAMBWENI,Rural,46,565,447,1012,Kwale ,COAST,14560
MSAMBWENI,Rural,47,433,386,819,Kwale ,COAST,14561
MSAMBWENI,Rural,48,463,541,1004,Kwale ,COAST,14562
MSAMBWENI,Rural,49,461,483,944,Kwale ,COAST,14563
MSAMBWENI,Rural,50,1046,1423,2469,Kwale ,COAST,14564
MSAMBWENI,Rural,51,285,304,589,Kwale ,COAST,14565
MSAMBWENI,Rural,52,463,411,874,Kwale ,COAST,14566
MSAMBWENI,Rural,53,285,289,574,Kwale ,COAST,14567
MSAMBWENI,Rural,54,348,314,662,Kwale ,COAST,14568
MSAMBWENI,Rural,55,608,606,1214,Kwale ,COAST,14569
MSAMBWENI,Rural,56,375,284,659,Kwale ,COAST,14570
MSAMBWENI,Rural,57,409,329,738,Kwale ,COAST,14571
MSAMBWENI,Rural,58,301,255,556,Kwale ,COAST,14572
MSAMBWENI,Rural,59,290,298,588,Kwale ,COAST,14573
MSAMBWENI,Rural,60,889,1103,1992,Kwale ,COAST,14574
MSAMBWENI,Rural,61,229,165,394,Kwale ,COAST,14575
MSAMBWENI,Rural,62,208,239,447,Kwale ,COAST,14576
MSAMBWENI,Rural,63,201,128,329,Kwale ,COAST,14577
MSAMBWENI,Rural,64,201,184,385,Kwale ,COAST,14578
MSAMBWENI,Rural,65,456,462,918,Kwale ,COAST,14579
MSAMBWENI,Rural,66,120,105,225,Kwale ,COAST,14580
MSAMBWENI,Rural,67,181,141,322,Kwale ,COAST,14581
MSAMBWENI,Rural,68,190,185,375,Kwale ,COAST,14582
MSAMBWENI,Rural,69,141,151,292,Kwale ,COAST,14583
MSAMBWENI,Rural,70,622,639,1261,Kwale ,COAST,14584
MSAMBWENI,Rural,71,97,67,164,Kwale ,COAST,14585
MSAMBWENI,Rural,72,140,123,263,Kwale ,COAST,14586
MSAMBWENI,Rural,73,92,67,159,Kwale ,COAST,14587
MSAMBWENI,Rural,74,83,68,151,Kwale ,COAST,14588
MSAMBWENI,Rural,75,214,219,433,Kwale ,COAST,14589
MSAMBWENI,Rural,76,70,51,121,Kwale ,COAST,14590
MSAMBWENI,Rural,77,86,68,154,Kwale ,COAST,14591
MSAMBWENI,Rural,78,85,88,173,Kwale ,COAST,14592
MSAMBWENI,Rural,79,101,88,189,Kwale ,COAST,14593
MSAMBWENI,Rural,80+,829,1094,1923,Kwale ,COAST,14594
MSAMBWENI,Rural,Age NS,32,34,66,Kwale ,COAST,14595
KILIFI,Rural,0,6381,6312,12693,Kilifi,COAST,14596
KILIFI,Rural,1,5923,5794,11717,Kilifi,COAST,14597
KILIFI,Rural,2,6590,6400,12990,Kilifi,COAST,14598
KILIFI,Rural,3,6618,6722,13340,Kilifi,COAST,14599
KILIFI,Rural,4,6297,6189,12486,Kilifi,COAST,14600
KILIFI,Rural,5,6392,6265,12657,Kilifi,COAST,14601
KILIFI,Rural,6,6208,6113,12321,Kilifi,COAST,14602
KILIFI,Rural,7,5896,5833,11729,Kilifi,COAST,14603
KILIFI,Rural,8,5814,5789,11603,Kilifi,COAST,14604
KILIFI,Rural,9,5901,5837,11738,Kilifi,COAST,14605
KILIFI,Rural,10,6324,6077,12401,Kilifi,COAST,14606
KILIFI,Rural,11,4476,4521,8997,Kilifi,COAST,14607
KILIFI,Rural,12,5823,5621,11444,Kilifi,COAST,14608
KILIFI,Rural,13,5133,5119,10252,Kilifi,COAST,14609
KILIFI,Rural,14,4687,4666,9353,Kilifi,COAST,14610
KILIFI,Rural,15,4680,4516,9196,Kilifi,COAST,14611
KILIFI,Rural,16,4362,4100,8462,Kilifi,COAST,14612
KILIFI,Rural,17,4148,3454,7602,Kilifi,COAST,14613
KILIFI,Rural,18,4004,3742,7746,Kilifi,COAST,14614
KILIFI,Rural,19,2915,3038,5953,Kilifi,COAST,14615
KILIFI,Rural,20,3183,4141,7324,Kilifi,COAST,14616
KILIFI,Rural,21,1945,2310,4255,Kilifi,COAST,14617
KILIFI,Rural,22,2211,3062,5273,Kilifi,COAST,14618
KILIFI,Rural,23,1863,2697,4560,Kilifi,COAST,14619
KILIFI,Rural,24,1773,2685,4458,Kilifi,COAST,14620
KILIFI,Rural,25,2188,3308,5496,Kilifi,COAST,14621
KILIFI,Rural,26,1530,2112,3642,Kilifi,COAST,14622
KILIFI,Rural,27,1536,1982,3518,Kilifi,COAST,14623
KILIFI,Rural,28,1544,2483,4027,Kilifi,COAST,14624
KILIFI,Rural,29,1199,1630,2829,Kilifi,COAST,14625
KILIFI,Rural,30,2198,3566,5764,Kilifi,COAST,14626
KILIFI,Rural,31,1275,1734,3009,Kilifi,COAST,14627
KILIFI,Rural,32,1569,2324,3893,Kilifi,COAST,14628
KILIFI,Rural,33,927,1400,2327,Kilifi,COAST,14629
KILIFI,Rural,34,1087,1469,2556,Kilifi,COAST,14630
KILIFI,Rural,35,1877,2458,4335,Kilifi,COAST,14631
KILIFI,Rural,36,1118,1364,2482,Kilifi,COAST,14632
KILIFI,Rural,37,1054,1226,2280,Kilifi,COAST,14633
KILIFI,Rural,38,961,1378,2339,Kilifi,COAST,14634
KILIFI,Rural,39,896,1135,2031,Kilifi,COAST,14635
KILIFI,Rural,40,1741,2891,4632,Kilifi,COAST,14636
KILIFI,Rural,41,772,992,1764,Kilifi,COAST,14637
KILIFI,Rural,42,878,1095,1973,Kilifi,COAST,14638
KILIFI,Rural,43,611,688,1299,Kilifi,COAST,14639
KILIFI,Rural,44,579,542,1121,Kilifi,COAST,14640
KILIFI,Rural,45,1180,1475,2655,Kilifi,COAST,14641
KILIFI,Rural,46,777,836,1613,Kilifi,COAST,14642
KILIFI,Rural,47,788,927,1715,Kilifi,COAST,14643
KILIFI,Rural,48,770,1161,1931,Kilifi,COAST,14644
KILIFI,Rural,49,702,1327,2029,Kilifi,COAST,14645
KILIFI,Rural,50,1136,2158,3294,Kilifi,COAST,14646
KILIFI,Rural,51,586,906,1492,Kilifi,COAST,14647
KILIFI,Rural,52,675,996,1671,Kilifi,COAST,14648
KILIFI,Rural,53,586,820,1406,Kilifi,COAST,14649
KILIFI,Rural,54,648,748,1396,Kilifi,COAST,14650
KILIFI,Rural,55,820,1106,1926,Kilifi,COAST,14651
KILIFI,Rural,56,676,668,1344,Kilifi,COAST,14652
KILIFI,Rural,57,730,584,1314,Kilifi,COAST,14653
KILIFI,Rural,58,491,564,1055,Kilifi,COAST,14654
KILIFI,Rural,59,544,758,1302,Kilifi,COAST,14655
KILIFI,Rural,60,911,1552,2463,Kilifi,COAST,14656
KILIFI,Rural,61,443,445,888,Kilifi,COAST,14657
KILIFI,Rural,62,439,458,897,Kilifi,COAST,14658
KILIFI,Rural,63,386,375,761,Kilifi,COAST,14659
KILIFI,Rural,64,481,550,1031,Kilifi,COAST,14660
KILIFI,Rural,65,749,994,1743,Kilifi,COAST,14661
KILIFI,Rural,66,287,282,569,Kilifi,COAST,14662
KILIFI,Rural,67,353,329,682,Kilifi,COAST,14663
KILIFI,Rural,68,293,356,649,Kilifi,COAST,14664
KILIFI,Rural,69,338,527,865,Kilifi,COAST,14665
KILIFI,Rural,70,674,881,1555,Kilifi,COAST,14666
KILIFI,Rural,71,168,244,412,Kilifi,COAST,14667
KILIFI,Rural,72,271,302,573,Kilifi,COAST,14668
KILIFI,Rural,73,182,181,363,Kilifi,COAST,14669
KILIFI,Rural,74,204,196,400,Kilifi,COAST,14670
KILIFI,Rural,75,314,354,668,Kilifi,COAST,14671
KILIFI,Rural,76,173,197,370,Kilifi,COAST,14672
KILIFI,Rural,77,181,224,405,Kilifi,COAST,14673
KILIFI,Rural,78,189,203,392,Kilifi,COAST,14674
KILIFI,Rural,79,216,271,487,Kilifi,COAST,14675
KILIFI,Rural,80+,1558,1917,3475,Kilifi,COAST,14676
KILIFI,Rural,Age NS,211,224,435,Kilifi,COAST,14677
KALOLENI,Rural,0,3930,4133,8063,Kilifi,COAST,14678
KALOLENI,Rural,1,3470,3517,6987,Kilifi,COAST,14679
KALOLENI,Rural,2,3922,3969,7891,Kilifi,COAST,14680
KALOLENI,Rural,3,3994,3985,7979,Kilifi,COAST,14681
KALOLENI,Rural,4,3903,3739,7642,Kilifi,COAST,14682
KALOLENI,Rural,5,3776,3798,7574,Kilifi,COAST,14683
KALOLENI,Rural,6,3486,3543,7029,Kilifi,COAST,14684
KALOLENI,Rural,7,3499,3371,6870,Kilifi,COAST,14685
KALOLENI,Rural,8,3359,3358,6717,Kilifi,COAST,14686
KALOLENI,Rural,9,3474,3374,6848,Kilifi,COAST,14687
KALOLENI,Rural,10,3510,3613,7123,Kilifi,COAST,14688
KALOLENI,Rural,11,2584,2674,5258,Kilifi,COAST,14689
KALOLENI,Rural,12,3227,3262,6489,Kilifi,COAST,14690
KALOLENI,Rural,13,3033,3097,6130,Kilifi,COAST,14691
KALOLENI,Rural,14,2809,2657,5466,Kilifi,COAST,14692
KALOLENI,Rural,15,2743,2610,5353,Kilifi,COAST,14693
KALOLENI,Rural,16,2677,2540,5217,Kilifi,COAST,14694
KALOLENI,Rural,17,2642,2231,4873,Kilifi,COAST,14695
KALOLENI,Rural,18,2600,2384,4984,Kilifi,COAST,14696
KALOLENI,Rural,19,2065,2018,4083,Kilifi,COAST,14697
KALOLENI,Rural,20,2037,2666,4703,Kilifi,COAST,14698
KALOLENI,Rural,21,1212,1497,2709,Kilifi,COAST,14699
KALOLENI,Rural,22,1348,2047,3395,Kilifi,COAST,14700
KALOLENI,Rural,23,1198,1731,2929,Kilifi,COAST,14701
KALOLENI,Rural,24,1155,1741,2896,Kilifi,COAST,14702
KALOLENI,Rural,25,1402,2210,3612,Kilifi,COAST,14703
KALOLENI,Rural,26,967,1457,2424,Kilifi,COAST,14704
KALOLENI,Rural,27,991,1222,2213,Kilifi,COAST,14705
KALOLENI,Rural,28,976,1514,2490,Kilifi,COAST,14706
KALOLENI,Rural,29,868,1112,1980,Kilifi,COAST,14707
KALOLENI,Rural,30,1415,2087,3502,Kilifi,COAST,14708
KALOLENI,Rural,31,814,1032,1846,Kilifi,COAST,14709
KALOLENI,Rural,32,960,1310,2270,Kilifi,COAST,14710
KALOLENI,Rural,33,639,840,1479,Kilifi,COAST,14711
KALOLENI,Rural,34,787,908,1695,Kilifi,COAST,14712
KALOLENI,Rural,35,1208,1600,2808,Kilifi,COAST,14713
KALOLENI,Rural,36,686,949,1635,Kilifi,COAST,14714
KALOLENI,Rural,37,666,781,1447,Kilifi,COAST,14715
KALOLENI,Rural,38,653,837,1490,Kilifi,COAST,14716
KALOLENI,Rural,39,575,662,1237,Kilifi,COAST,14717
KALOLENI,Rural,40,1129,1707,2836,Kilifi,COAST,14718
KALOLENI,Rural,41,556,605,1161,Kilifi,COAST,14719
KALOLENI,Rural,42,565,720,1285,Kilifi,COAST,14720
KALOLENI,Rural,43,378,434,812,Kilifi,COAST,14721
KALOLENI,Rural,44,391,367,758,Kilifi,COAST,14722
KALOLENI,Rural,45,732,931,1663,Kilifi,COAST,14723
KALOLENI,Rural,46,582,673,1255,Kilifi,COAST,14724
KALOLENI,Rural,47,532,601,1133,Kilifi,COAST,14725
KALOLENI,Rural,48,486,672,1158,Kilifi,COAST,14726
KALOLENI,Rural,49,492,838,1330,Kilifi,COAST,14727
KALOLENI,Rural,50,825,1422,2247,Kilifi,COAST,14728
KALOLENI,Rural,51,438,649,1087,Kilifi,COAST,14729
KALOLENI,Rural,52,511,650,1161,Kilifi,COAST,14730
KALOLENI,Rural,53,386,617,1003,Kilifi,COAST,14731
KALOLENI,Rural,54,444,540,984,Kilifi,COAST,14732
KALOLENI,Rural,55,652,773,1425,Kilifi,COAST,14733
KALOLENI,Rural,56,424,447,871,Kilifi,COAST,14734
KALOLENI,Rural,57,499,454,953,Kilifi,COAST,14735
KALOLENI,Rural,58,335,367,702,Kilifi,COAST,14736
KALOLENI,Rural,59,434,611,1045,Kilifi,COAST,14737
KALOLENI,Rural,60,600,1062,1662,Kilifi,COAST,14738
KALOLENI,Rural,61,317,402,719,Kilifi,COAST,14739
KALOLENI,Rural,62,310,341,651,Kilifi,COAST,14740
KALOLENI,Rural,63,263,298,561,Kilifi,COAST,14741
KALOLENI,Rural,64,298,353,651,Kilifi,COAST,14742
KALOLENI,Rural,65,500,631,1131,Kilifi,COAST,14743
KALOLENI,Rural,66,165,195,360,Kilifi,COAST,14744
KALOLENI,Rural,67,285,284,569,Kilifi,COAST,14745
KALOLENI,Rural,68,192,251,443,Kilifi,COAST,14746
KALOLENI,Rural,69,259,361,620,Kilifi,COAST,14747
KALOLENI,Rural,70,402,633,1035,Kilifi,COAST,14748
KALOLENI,Rural,71,138,184,322,Kilifi,COAST,14749
KALOLENI,Rural,72,218,218,436,Kilifi,COAST,14750
KALOLENI,Rural,73,143,156,299,Kilifi,COAST,14751
KALOLENI,Rural,74,138,182,320,Kilifi,COAST,14752
KALOLENI,Rural,75,227,279,506,Kilifi,COAST,14753
KALOLENI,Rural,76,117,100,217,Kilifi,COAST,14754
KALOLENI,Rural,77,106,135,241,Kilifi,COAST,14755
KALOLENI,Rural,78,118,155,273,Kilifi,COAST,14756
KALOLENI,Rural,79,172,254,426,Kilifi,COAST,14757
KALOLENI,Rural,80+,1081,1532,2613,Kilifi,COAST,14758
KALOLENI,Rural,Age NS,63,62,125,Kilifi,COAST,14759
MALINDI,Rural,0,4916,4807,9723,Kilifi,COAST,14760
MALINDI,Rural,1,4349,4358,8707,Kilifi,COAST,14761
MALINDI,Rural,2,4968,4872,9840,Kilifi,COAST,14762
MALINDI,Rural,3,4922,5041,9963,Kilifi,COAST,14763
MALINDI,Rural,4,4851,4653,9504,Kilifi,COAST,14764
MALINDI,Rural,5,4824,4749,9573,Kilifi,COAST,14765
MALINDI,Rural,6,4605,4512,9117,Kilifi,COAST,14766
MALINDI,Rural,7,4346,4212,8558,Kilifi,COAST,14767
MALINDI,Rural,8,4423,4374,8797,Kilifi,COAST,14768
MALINDI,Rural,9,4379,4324,8703,Kilifi,COAST,14769
MALINDI,Rural,10,4735,4528,9263,Kilifi,COAST,14770
MALINDI,Rural,11,3129,3150,6279,Kilifi,COAST,14771
MALINDI,Rural,12,4215,3957,8172,Kilifi,COAST,14772
MALINDI,Rural,13,3609,3636,7245,Kilifi,COAST,14773
MALINDI,Rural,14,3385,3227,6612,Kilifi,COAST,14774
MALINDI,Rural,15,3567,3276,6843,Kilifi,COAST,14775
MALINDI,Rural,16,3220,2967,6187,Kilifi,COAST,14776
MALINDI,Rural,17,2870,2497,5367,Kilifi,COAST,14777
MALINDI,Rural,18,3049,2997,6046,Kilifi,COAST,14778
MALINDI,Rural,19,2277,2275,4552,Kilifi,COAST,14779
MALINDI,Rural,20,2696,3281,5977,Kilifi,COAST,14780
MALINDI,Rural,21,1612,1832,3444,Kilifi,COAST,14781
MALINDI,Rural,22,1686,2300,3986,Kilifi,COAST,14782
MALINDI,Rural,23,1676,2078,3754,Kilifi,COAST,14783
MALINDI,Rural,24,1564,2077,3641,Kilifi,COAST,14784
MALINDI,Rural,25,1957,2471,4428,Kilifi,COAST,14785
MALINDI,Rural,26,1241,1460,2701,Kilifi,COAST,14786
MALINDI,Rural,27,1232,1414,2646,Kilifi,COAST,14787
MALINDI,Rural,28,1284,1671,2955,Kilifi,COAST,14788
MALINDI,Rural,29,1114,1243,2357,Kilifi,COAST,14789
MALINDI,Rural,30,1892,2547,4439,Kilifi,COAST,14790
MALINDI,Rural,31,1010,1365,2375,Kilifi,COAST,14791
MALINDI,Rural,32,1112,1709,2821,Kilifi,COAST,14792
MALINDI,Rural,33,756,1063,1819,Kilifi,COAST,14793
MALINDI,Rural,34,929,1135,2064,Kilifi,COAST,14794
MALINDI,Rural,35,1566,1891,3457,Kilifi,COAST,14795
MALINDI,Rural,36,915,983,1898,Kilifi,COAST,14796
MALINDI,Rural,37,846,891,1737,Kilifi,COAST,14797
MALINDI,Rural,38,860,993,1853,Kilifi,COAST,14798
MALINDI,Rural,39,779,761,1540,Kilifi,COAST,14799
MALINDI,Rural,40,1496,1905,3401,Kilifi,COAST,14800
MALINDI,Rural,41,667,688,1355,Kilifi,COAST,14801
MALINDI,Rural,42,682,798,1480,Kilifi,COAST,14802
MALINDI,Rural,43,487,442,929,Kilifi,COAST,14803
MALINDI,Rural,44,461,391,852,Kilifi,COAST,14804
MALINDI,Rural,45,958,992,1950,Kilifi,COAST,14805
MALINDI,Rural,46,600,588,1188,Kilifi,COAST,14806
MALINDI,Rural,47,530,574,1104,Kilifi,COAST,14807
MALINDI,Rural,48,649,800,1449,Kilifi,COAST,14808
MALINDI,Rural,49,530,757,1287,Kilifi,COAST,14809
MALINDI,Rural,50,965,1560,2525,Kilifi,COAST,14810
MALINDI,Rural,51,428,610,1038,Kilifi,COAST,14811
MALINDI,Rural,52,541,709,1250,Kilifi,COAST,14812
MALINDI,Rural,53,392,533,925,Kilifi,COAST,14813
MALINDI,Rural,54,477,493,970,Kilifi,COAST,14814
MALINDI,Rural,55,646,749,1395,Kilifi,COAST,14815
MALINDI,Rural,56,481,418,899,Kilifi,COAST,14816
MALINDI,Rural,57,537,462,999,Kilifi,COAST,14817
MALINDI,Rural,58,392,377,769,Kilifi,COAST,14818
MALINDI,Rural,59,432,559,991,Kilifi,COAST,14819
MALINDI,Rural,60,731,1075,1806,Kilifi,COAST,14820
MALINDI,Rural,61,409,376,785,Kilifi,COAST,14821
MALINDI,Rural,62,310,267,577,Kilifi,COAST,14822
MALINDI,Rural,63,269,243,512,Kilifi,COAST,14823
MALINDI,Rural,64,267,305,572,Kilifi,COAST,14824
MALINDI,Rural,65,416,520,936,Kilifi,COAST,14825
MALINDI,Rural,66,153,137,290,Kilifi,COAST,14826
MALINDI,Rural,67,260,235,495,Kilifi,COAST,14827
MALINDI,Rural,68,211,217,428,Kilifi,COAST,14828
MALINDI,Rural,69,299,354,653,Kilifi,COAST,14829
MALINDI,Rural,70,517,676,1193,Kilifi,COAST,14830
MALINDI,Rural,71,148,161,309,Kilifi,COAST,14831
MALINDI,Rural,72,197,190,387,Kilifi,COAST,14832
MALINDI,Rural,73,140,145,285,Kilifi,COAST,14833
MALINDI,Rural,74,144,141,285,Kilifi,COAST,14834
MALINDI,Rural,75,299,271,570,Kilifi,COAST,14835
MALINDI,Rural,76,108,95,203,Kilifi,COAST,14836
MALINDI,Rural,77,109,122,231,Kilifi,COAST,14837
MALINDI,Rural,78,124,144,268,Kilifi,COAST,14838
MALINDI,Rural,79,203,212,415,Kilifi,COAST,14839
MALINDI,Rural,80+,1196,1509,2705,Kilifi,COAST,14840
MALINDI,Rural,Age NS,81,90,171,Kilifi,COAST,14841
TANA RIVER,Rural,0,2695,2488,5183,Tana River,COAST,14842
TANA RIVER,Rural,1,2165,2078,4243,Tana River,COAST,14843
TANA RIVER,Rural,2,2579,2420,4999,Tana River,COAST,14844
TANA RIVER,Rural,3,2324,2317,4641,Tana River,COAST,14845
TANA RIVER,Rural,4,2305,2253,4558,Tana River,COAST,14846
TANA RIVER,Rural,5,2370,2230,4600,Tana River,COAST,14847
TANA RIVER,Rural,6,2199,2057,4256,Tana River,COAST,14848
TANA RIVER,Rural,7,2003,1992,3995,Tana River,COAST,14849
TANA RIVER,Rural,8,2080,1894,3974,Tana River,COAST,14850
TANA RIVER,Rural,9,1629,1609,3238,Tana River,COAST,14851
TANA RIVER,Rural,10,1828,1723,3551,Tana River,COAST,14852
TANA RIVER,Rural,11,1366,1229,2595,Tana River,COAST,14853
TANA RIVER,Rural,12,1695,1574,3269,Tana River,COAST,14854
TANA RIVER,Rural,13,1342,1232,2574,Tana River,COAST,14855
TANA RIVER,Rural,14,1377,1294,2671,Tana River,COAST,14856
TANA RIVER,Rural,15,1222,1158,2380,Tana River,COAST,14857
TANA RIVER,Rural,16,958,957,1915,Tana River,COAST,14858
TANA RIVER,Rural,17,1039,1128,2167,Tana River,COAST,14859
TANA RIVER,Rural,18,994,1416,2410,Tana River,COAST,14860
TANA RIVER,Rural,19,923,1400,2323,Tana River,COAST,14861
TANA RIVER,Rural,20,1025,1475,2500,Tana River,COAST,14862
TANA RIVER,Rural,21,507,755,1262,Tana River,COAST,14863
TANA RIVER,Rural,22,760,901,1661,Tana River,COAST,14864
TANA RIVER,Rural,23,615,659,1274,Tana River,COAST,14865
TANA RIVER,Rural,24,813,1043,1856,Tana River,COAST,14866
TANA RIVER,Rural,25,891,1175,2066,Tana River,COAST,14867
TANA RIVER,Rural,26,500,539,1039,Tana River,COAST,14868
TANA RIVER,Rural,27,628,698,1326,Tana River,COAST,14869
TANA RIVER,Rural,28,547,696,1243,Tana River,COAST,14870
TANA RIVER,Rural,29,777,906,1683,Tana River,COAST,14871
TANA RIVER,Rural,30,855,1139,1994,Tana River,COAST,14872
TANA RIVER,Rural,31,385,383,768,Tana River,COAST,14873
TANA RIVER,Rural,32,364,391,755,Tana River,COAST,14874
TANA RIVER,Rural,33,281,248,529,Tana River,COAST,14875
TANA RIVER,Rural,34,535,611,1146,Tana River,COAST,14876
TANA RIVER,Rural,35,621,759,1380,Tana River,COAST,14877
TANA RIVER,Rural,36,321,323,644,Tana River,COAST,14878
TANA RIVER,Rural,37,363,369,732,Tana River,COAST,14879
TANA RIVER,Rural,38,332,366,698,Tana River,COAST,14880
TANA RIVER,Rural,39,574,656,1230,Tana River,COAST,14881
TANA RIVER,Rural,40,672,789,1461,Tana River,COAST,14882
TANA RIVER,Rural,41,177,191,368,Tana River,COAST,14883
TANA RIVER,Rural,42,226,214,440,Tana River,COAST,14884
TANA RIVER,Rural,43,159,171,330,Tana River,COAST,14885
TANA RIVER,Rural,44,316,334,650,Tana River,COAST,14886
TANA RIVER,Rural,45,442,393,835,Tana River,COAST,14887
TANA RIVER,Rural,46,211,167,378,Tana River,COAST,14888
TANA RIVER,Rural,47,269,227,496,Tana River,COAST,14889
TANA RIVER,Rural,48,294,263,557,Tana River,COAST,14890
TANA RIVER,Rural,49,409,413,822,Tana River,COAST,14891
TANA RIVER,Rural,50,490,480,970,Tana River,COAST,14892
TANA RIVER,Rural,51,194,142,336,Tana River,COAST,14893
TANA RIVER,Rural,52,186,143,329,Tana River,COAST,14894
TANA RIVER,Rural,53,173,127,300,Tana River,COAST,14895
TANA RIVER,Rural,54,193,181,374,Tana River,COAST,14896
TANA RIVER,Rural,55,246,219,465,Tana River,COAST,14897
TANA RIVER,Rural,56,165,119,284,Tana River,COAST,14898
TANA RIVER,Rural,57,156,96,252,Tana River,COAST,14899
TANA RIVER,Rural,58,140,118,258,Tana River,COAST,14900
TANA RIVER,Rural,59,254,287,541,Tana River,COAST,14901
TANA RIVER,Rural,60,346,311,657,Tana River,COAST,14902
TANA RIVER,Rural,61,83,82,165,Tana River,COAST,14903
TANA RIVER,Rural,62,90,49,139,Tana River,COAST,14904
TANA RIVER,Rural,63,82,63,145,Tana River,COAST,14905
TANA RIVER,Rural,64,125,120,245,Tana River,COAST,14906
TANA RIVER,Rural,65,143,99,242,Tana River,COAST,14907
TANA RIVER,Rural,66,84,38,122,Tana River,COAST,14908
TANA RIVER,Rural,67,87,33,120,Tana River,COAST,14909
TANA RIVER,Rural,68,66,42,108,Tana River,COAST,14910
TANA RIVER,Rural,69,168,142,310,Tana River,COAST,14911
TANA RIVER,Rural,70,180,195,375,Tana River,COAST,14912
TANA RIVER,Rural,71,50,32,82,Tana River,COAST,14913
TANA RIVER,Rural,72,56,30,86,Tana River,COAST,14914
TANA RIVER,Rural,73,44,31,75,Tana River,COAST,14915
TANA RIVER,Rural,74,66,42,108,Tana River,COAST,14916
TANA RIVER,Rural,75,65,79,144,Tana River,COAST,14917
TANA RIVER,Rural,76,44,25,69,Tana River,COAST,14918
TANA RIVER,Rural,77,37,27,64,Tana River,COAST,14919
TANA RIVER,Rural,78,47,48,95,Tana River,COAST,14920
TANA RIVER,Rural,79,59,90,149,Tana River,COAST,14921
TANA RIVER,Rural,80+,441,515,956,Tana River,COAST,14922
TANA RIVER,Rural,Age NS,9,11,20,Tana River,COAST,14923
TANA DELTA,Rural,0,1768,1684,3452,Tana River,COAST,14924
TANA DELTA,Rural,1,1570,1624,3194,Tana River,COAST,14925
TANA DELTA,Rural,2,1947,1820,3767,Tana River,COAST,14926
TANA DELTA,Rural,3,1833,1882,3715,Tana River,COAST,14927
TANA DELTA,Rural,4,1892,1865,3757,Tana River,COAST,14928
TANA DELTA,Rural,5,1809,1786,3595,Tana River,COAST,14929
TANA DELTA,Rural,6,1736,1681,3417,Tana River,COAST,14930
TANA DELTA,Rural,7,1597,1414,3011,Tana River,COAST,14931
TANA DELTA,Rural,8,1743,1746,3489,Tana River,COAST,14932
TANA DELTA,Rural,9,1382,1331,2713,Tana River,COAST,14933
TANA DELTA,Rural,10,1750,1633,3383,Tana River,COAST,14934
TANA DELTA,Rural,11,925,919,1844,Tana River,COAST,14935
TANA DELTA,Rural,12,1667,1487,3154,Tana River,COAST,14936
TANA DELTA,Rural,13,1276,1143,2419,Tana River,COAST,14937
TANA DELTA,Rural,14,1204,1082,2286,Tana River,COAST,14938
TANA DELTA,Rural,15,1236,1117,2353,Tana River,COAST,14939
TANA DELTA,Rural,16,1032,915,1947,Tana River,COAST,14940
TANA DELTA,Rural,17,872,713,1585,Tana River,COAST,14941
TANA DELTA,Rural,18,1171,1113,2284,Tana River,COAST,14942
TANA DELTA,Rural,19,626,722,1348,Tana River,COAST,14943
TANA DELTA,Rural,20,1175,1520,2695,Tana River,COAST,14944
TANA DELTA,Rural,21,517,496,1013,Tana River,COAST,14945
TANA DELTA,Rural,22,686,800,1486,Tana River,COAST,14946
TANA DELTA,Rural,23,539,599,1138,Tana River,COAST,14947
TANA DELTA,Rural,24,519,532,1051,Tana River,COAST,14948
TANA DELTA,Rural,25,936,1190,2126,Tana River,COAST,14949
TANA DELTA,Rural,26,456,543,999,Tana River,COAST,14950
TANA DELTA,Rural,27,494,504,998,Tana River,COAST,14951
TANA DELTA,Rural,28,555,711,1266,Tana River,COAST,14952
TANA DELTA,Rural,29,359,385,744,Tana River,COAST,14953
TANA DELTA,Rural,30,1083,1330,2413,Tana River,COAST,14954
TANA DELTA,Rural,31,351,361,712,Tana River,COAST,14955
TANA DELTA,Rural,32,439,445,884,Tana River,COAST,14956
TANA DELTA,Rural,33,273,278,551,Tana River,COAST,14957
TANA DELTA,Rural,34,328,260,588,Tana River,COAST,14958
TANA DELTA,Rural,35,745,815,1560,Tana River,COAST,14959
TANA DELTA,Rural,36,329,343,672,Tana River,COAST,14960
TANA DELTA,Rural,37,336,293,629,Tana River,COAST,14961
TANA DELTA,Rural,38,363,348,711,Tana River,COAST,14962
TANA DELTA,Rural,39,258,233,491,Tana River,COAST,14963
TANA DELTA,Rural,40,722,930,1652,Tana River,COAST,14964
TANA DELTA,Rural,41,186,155,341,Tana River,COAST,14965
TANA DELTA,Rural,42,292,224,516,Tana River,COAST,14966
TANA DELTA,Rural,43,168,133,301,Tana River,COAST,14967
TANA DELTA,Rural,44,206,144,350,Tana River,COAST,14968
TANA DELTA,Rural,45,443,459,902,Tana River,COAST,14969
TANA DELTA,Rural,46,249,229,478,Tana River,COAST,14970
TANA DELTA,Rural,47,189,166,355,Tana River,COAST,14971
TANA DELTA,Rural,48,314,279,593,Tana River,COAST,14972
TANA DELTA,Rural,49,208,173,381,Tana River,COAST,14973
TANA DELTA,Rural,50,574,611,1185,Tana River,COAST,14974
TANA DELTA,Rural,51,157,117,274,Tana River,COAST,14975
TANA DELTA,Rural,52,198,168,366,Tana River,COAST,14976
TANA DELTA,Rural,53,180,125,305,Tana River,COAST,14977
TANA DELTA,Rural,54,156,119,275,Tana River,COAST,14978
TANA DELTA,Rural,55,256,235,491,Tana River,COAST,14979
TANA DELTA,Rural,56,179,148,327,Tana River,COAST,14980
TANA DELTA,Rural,57,166,107,273,Tana River,COAST,14981
TANA DELTA,Rural,58,148,103,251,Tana River,COAST,14982
TANA DELTA,Rural,59,148,122,270,Tana River,COAST,14983
TANA DELTA,Rural,60,354,458,812,Tana River,COAST,14984
TANA DELTA,Rural,61,87,75,162,Tana River,COAST,14985
TANA DELTA,Rural,62,85,73,158,Tana River,COAST,14986
TANA DELTA,Rural,63,77,70,147,Tana River,COAST,14987
TANA DELTA,Rural,64,88,80,168,Tana River,COAST,14988
TANA DELTA,Rural,65,146,139,285,Tana River,COAST,14989
TANA DELTA,Rural,66,62,46,108,Tana River,COAST,14990
TANA DELTA,Rural,67,86,55,141,Tana River,COAST,14991
TANA DELTA,Rural,68,74,57,131,Tana River,COAST,14992
TANA DELTA,Rural,69,83,54,137,Tana River,COAST,14993
TANA DELTA,Rural,70,249,203,452,Tana River,COAST,14994
TANA DELTA,Rural,71,55,32,87,Tana River,COAST,14995
TANA DELTA,Rural,72,53,32,85,Tana River,COAST,14996
TANA DELTA,Rural,73,51,21,72,Tana River,COAST,14997
TANA DELTA,Rural,74,53,29,82,Tana River,COAST,14998
TANA DELTA,Rural,75,85,73,158,Tana River,COAST,14999
TANA DELTA,Rural,76,47,29,76,Tana River,COAST,15000
TANA DELTA,Rural,77,31,30,61,Tana River,COAST,15001
TANA DELTA,Rural,78,42,27,69,Tana River,COAST,15002
TANA DELTA,Rural,79,34,39,73,Tana River,COAST,15003
TANA DELTA,Rural,80+,441,497,938,Tana River,COAST,15004
TANA DELTA,Rural,Age NS,17,15,32,Tana River,COAST,15005
LAMU,Rural,0,1284,1290,2574,Lamu,COAST,15006
LAMU,Rural,1,1140,1124,2264,Lamu,COAST,15007
LAMU,Rural,2,1325,1226,2551,Lamu,COAST,15008
LAMU,Rural,3,1455,1387,2842,Lamu,COAST,15009
LAMU,Rural,4,1337,1237,2574,Lamu,COAST,15010
LAMU,Rural,5,1293,1235,2528,Lamu,COAST,15011
LAMU,Rural,6,1277,1194,2471,Lamu,COAST,15012
LAMU,Rural,7,1280,1169,2449,Lamu,COAST,15013
LAMU,Rural,8,1240,1208,2448,Lamu,COAST,15014
LAMU,Rural,9,1093,1147,2240,Lamu,COAST,15015
LAMU,Rural,10,1212,1109,2321,Lamu,COAST,15016
LAMU,Rural,11,709,780,1489,Lamu,COAST,15017
LAMU,Rural,12,1205,1045,2250,Lamu,COAST,15018
LAMU,Rural,13,992,1025,2017,Lamu,COAST,15019
LAMU,Rural,14,955,898,1853,Lamu,COAST,15020
LAMU,Rural,15,1018,890,1908,Lamu,COAST,15021
LAMU,Rural,16,876,798,1674,Lamu,COAST,15022
LAMU,Rural,17,968,762,1730,Lamu,COAST,15023
LAMU,Rural,18,1062,865,1927,Lamu,COAST,15024
LAMU,Rural,19,768,654,1422,Lamu,COAST,15025
LAMU,Rural,20,1100,919,2019,Lamu,COAST,15026
LAMU,Rural,21,681,577,1258,Lamu,COAST,15027
LAMU,Rural,22,823,751,1574,Lamu,COAST,15028
LAMU,Rural,23,737,582,1319,Lamu,COAST,15029
LAMU,Rural,24,672,564,1236,Lamu,COAST,15030
LAMU,Rural,25,976,887,1863,Lamu,COAST,15031
LAMU,Rural,26,548,485,1033,Lamu,COAST,15032
LAMU,Rural,27,593,514,1107,Lamu,COAST,15033
LAMU,Rural,28,544,597,1141,Lamu,COAST,15034
LAMU,Rural,29,483,399,882,Lamu,COAST,15035
LAMU,Rural,30,1032,921,1953,Lamu,COAST,15036
LAMU,Rural,31,551,435,986,Lamu,COAST,15037
LAMU,Rural,32,541,469,1010,Lamu,COAST,15038
LAMU,Rural,33,376,271,647,Lamu,COAST,15039
LAMU,Rural,34,384,300,684,Lamu,COAST,15040
LAMU,Rural,35,831,793,1624,Lamu,COAST,15041
LAMU,Rural,36,431,318,749,Lamu,COAST,15042
LAMU,Rural,37,392,266,658,Lamu,COAST,15043
LAMU,Rural,38,393,330,723,Lamu,COAST,15044
LAMU,Rural,39,323,266,589,Lamu,COAST,15045
LAMU,Rural,40,832,748,1580,Lamu,COAST,15046
LAMU,Rural,41,260,203,463,Lamu,COAST,15047
LAMU,Rural,42,327,246,573,Lamu,COAST,15048
LAMU,Rural,43,221,154,375,Lamu,COAST,15049
LAMU,Rural,44,205,134,339,Lamu,COAST,15050
LAMU,Rural,45,459,455,914,Lamu,COAST,15051
LAMU,Rural,46,275,271,546,Lamu,COAST,15052
LAMU,Rural,47,224,174,398,Lamu,COAST,15053
LAMU,Rural,48,250,220,470,Lamu,COAST,15054
LAMU,Rural,49,245,184,429,Lamu,COAST,15055
LAMU,Rural,50,516,561,1077,Lamu,COAST,15056
LAMU,Rural,51,160,176,336,Lamu,COAST,15057
LAMU,Rural,52,211,134,345,Lamu,COAST,15058
LAMU,Rural,53,151,121,272,Lamu,COAST,15059
LAMU,Rural,54,156,118,274,Lamu,COAST,15060
LAMU,Rural,55,313,275,588,Lamu,COAST,15061
LAMU,Rural,56,191,163,354,Lamu,COAST,15062
LAMU,Rural,57,174,145,319,Lamu,COAST,15063
LAMU,Rural,58,131,84,215,Lamu,COAST,15064
LAMU,Rural,59,135,94,229,Lamu,COAST,15065
LAMU,Rural,60,436,392,828,Lamu,COAST,15066
LAMU,Rural,61,128,138,266,Lamu,COAST,15067
LAMU,Rural,62,127,81,208,Lamu,COAST,15068
LAMU,Rural,63,94,72,166,Lamu,COAST,15069
LAMU,Rural,64,106,78,184,Lamu,COAST,15070
LAMU,Rural,65,170,155,325,Lamu,COAST,15071
LAMU,Rural,66,75,63,138,Lamu,COAST,15072
LAMU,Rural,67,99,62,161,Lamu,COAST,15073
LAMU,Rural,68,87,57,144,Lamu,COAST,15074
LAMU,Rural,69,72,55,127,Lamu,COAST,15075
LAMU,Rural,70,263,251,514,Lamu,COAST,15076
LAMU,Rural,71,54,44,98,Lamu,COAST,15077
LAMU,Rural,72,51,24,75,Lamu,COAST,15078
LAMU,Rural,73,30,21,51,Lamu,COAST,15079
LAMU,Rural,74,48,34,82,Lamu,COAST,15080
LAMU,Rural,75,81,66,147,Lamu,COAST,15081
LAMU,Rural,76,35,24,59,Lamu,COAST,15082
LAMU,Rural,77,31,23,54,Lamu,COAST,15083
LAMU,Rural,78,23,27,50,Lamu,COAST,15084
LAMU,Rural,79,28,29,57,Lamu,COAST,15085
LAMU,Rural,80+,406,434,840,Lamu,COAST,15086
LAMU,Rural,Age NS,33,11,44,Lamu,COAST,15087
TAITA,Rural,0,2243,2211,4454,Taita Taveta,COAST,15088
TAITA,Rural,1,2133,2064,4197,Taita Taveta,COAST,15089
TAITA,Rural,2,2175,2208,4383,Taita Taveta,COAST,15090
TAITA,Rural,3,2187,2176,4363,Taita Taveta,COAST,15091
TAITA,Rural,4,2293,2066,4359,Taita Taveta,COAST,15092
TAITA,Rural,5,2126,2151,4277,Taita Taveta,COAST,15093
TAITA,Rural,6,2060,2113,4173,Taita Taveta,COAST,15094
TAITA,Rural,7,2235,2171,4406,Taita Taveta,COAST,15095
TAITA,Rural,8,2079,2039,4118,Taita Taveta,COAST,15096
TAITA,Rural,9,2225,2194,4419,Taita Taveta,COAST,15097
TAITA,Rural,10,2346,2254,4600,Taita Taveta,COAST,15098
TAITA,Rural,11,1904,1950,3854,Taita Taveta,COAST,15099
TAITA,Rural,12,2265,2170,4435,Taita Taveta,COAST,15100
TAITA,Rural,13,2130,2132,4262,Taita Taveta,COAST,15101
TAITA,Rural,14,1980,1950,3930,Taita Taveta,COAST,15102
TAITA,Rural,15,1958,1882,3840,Taita Taveta,COAST,15103
TAITA,Rural,16,1876,1807,3683,Taita Taveta,COAST,15104
TAITA,Rural,17,2053,1969,4022,Taita Taveta,COAST,15105
TAITA,Rural,18,2085,1760,3845,Taita Taveta,COAST,15106
TAITA,Rural,19,1790,1475,3265,Taita Taveta,COAST,15107
TAITA,Rural,20,1727,1500,3227,Taita Taveta,COAST,15108
TAITA,Rural,21,1412,1238,2650,Taita Taveta,COAST,15109
TAITA,Rural,22,1419,1325,2744,Taita Taveta,COAST,15110
TAITA,Rural,23,1350,1274,2624,Taita Taveta,COAST,15111
TAITA,Rural,24,1383,1164,2547,Taita Taveta,COAST,15112
TAITA,Rural,25,1569,1279,2848,Taita Taveta,COAST,15113
TAITA,Rural,26,1396,1122,2518,Taita Taveta,COAST,15114
TAITA,Rural,27,1375,1148,2523,Taita Taveta,COAST,15115
TAITA,Rural,28,1175,1030,2205,Taita Taveta,COAST,15116
TAITA,Rural,29,1273,1079,2352,Taita Taveta,COAST,15117
TAITA,Rural,30,1685,1366,3051,Taita Taveta,COAST,15118
TAITA,Rural,31,1151,865,2016,Taita Taveta,COAST,15119
TAITA,Rural,32,1185,1038,2223,Taita Taveta,COAST,15120
TAITA,Rural,33,977,906,1883,Taita Taveta,COAST,15121
TAITA,Rural,34,1092,951,2043,Taita Taveta,COAST,15122
TAITA,Rural,35,1409,1120,2529,Taita Taveta,COAST,15123
TAITA,Rural,36,1057,926,1983,Taita Taveta,COAST,15124
TAITA,Rural,37,955,866,1821,Taita Taveta,COAST,15125
TAITA,Rural,38,917,880,1797,Taita Taveta,COAST,15126
TAITA,Rural,39,917,867,1784,Taita Taveta,COAST,15127
TAITA,Rural,40,1293,1154,2447,Taita Taveta,COAST,15128
TAITA,Rural,41,734,639,1373,Taita Taveta,COAST,15129
TAITA,Rural,42,763,676,1439,Taita Taveta,COAST,15130
TAITA,Rural,43,659,634,1293,Taita Taveta,COAST,15131
TAITA,Rural,44,646,684,1330,Taita Taveta,COAST,15132
TAITA,Rural,45,970,973,1943,Taita Taveta,COAST,15133
TAITA,Rural,46,760,709,1469,Taita Taveta,COAST,15134
TAITA,Rural,47,702,792,1494,Taita Taveta,COAST,15135
TAITA,Rural,48,561,626,1187,Taita Taveta,COAST,15136
TAITA,Rural,49,649,736,1385,Taita Taveta,COAST,15137
TAITA,Rural,50,823,1067,1890,Taita Taveta,COAST,15138
TAITA,Rural,51,531,554,1085,Taita Taveta,COAST,15139
TAITA,Rural,52,582,592,1174,Taita Taveta,COAST,15140
TAITA,Rural,53,557,525,1082,Taita Taveta,COAST,15141
TAITA,Rural,54,480,523,1003,Taita Taveta,COAST,15142
TAITA,Rural,55,702,720,1422,Taita Taveta,COAST,15143
TAITA,Rural,56,548,493,1041,Taita Taveta,COAST,15144
TAITA,Rural,57,614,556,1170,Taita Taveta,COAST,15145
TAITA,Rural,58,405,371,776,Taita Taveta,COAST,15146
TAITA,Rural,59,484,525,1009,Taita Taveta,COAST,15147
TAITA,Rural,60,633,894,1527,Taita Taveta,COAST,15148
TAITA,Rural,61,426,449,875,Taita Taveta,COAST,15149
TAITA,Rural,62,382,338,720,Taita Taveta,COAST,15150
TAITA,Rural,63,344,336,680,Taita Taveta,COAST,15151
TAITA,Rural,64,344,430,774,Taita Taveta,COAST,15152
TAITA,Rural,65,420,523,943,Taita Taveta,COAST,15153
TAITA,Rural,66,285,262,547,Taita Taveta,COAST,15154
TAITA,Rural,67,347,344,691,Taita Taveta,COAST,15155
TAITA,Rural,68,248,278,526,Taita Taveta,COAST,15156
TAITA,Rural,69,319,401,720,Taita Taveta,COAST,15157
TAITA,Rural,70,426,584,1010,Taita Taveta,COAST,15158
TAITA,Rural,71,231,247,478,Taita Taveta,COAST,15159
TAITA,Rural,72,223,187,410,Taita Taveta,COAST,15160
TAITA,Rural,73,231,223,454,Taita Taveta,COAST,15161
TAITA,Rural,74,207,255,462,Taita Taveta,COAST,15162
TAITA,Rural,75,206,247,453,Taita Taveta,COAST,15163
TAITA,Rural,76,135,126,261,Taita Taveta,COAST,15164
TAITA,Rural,77,162,210,372,Taita Taveta,COAST,15165
TAITA,Rural,78,123,132,255,Taita Taveta,COAST,15166
TAITA,Rural,79,170,356,526,Taita Taveta,COAST,15167
TAITA,Rural,80+,1045,1472,2517,Taita Taveta,COAST,15168
TAITA,Rural,Age NS,59,43,102,Taita Taveta,COAST,15169
TAVETA,Rural,0,738,700,1438,Taita Taveta,COAST,15170
TAVETA,Rural,1,748,628,1376,Taita Taveta,COAST,15171
TAVETA,Rural,2,752,773,1525,Taita Taveta,COAST,15172
TAVETA,Rural,3,745,744,1489,Taita Taveta,COAST,15173
TAVETA,Rural,4,727,726,1453,Taita Taveta,COAST,15174
TAVETA,Rural,5,762,740,1502,Taita Taveta,COAST,15175
TAVETA,Rural,6,720,695,1415,Taita Taveta,COAST,15176
TAVETA,Rural,7,725,665,1390,Taita Taveta,COAST,15177
TAVETA,Rural,8,694,647,1341,Taita Taveta,COAST,15178
TAVETA,Rural,9,732,665,1397,Taita Taveta,COAST,15179
TAVETA,Rural,10,695,697,1392,Taita Taveta,COAST,15180
TAVETA,Rural,11,511,517,1028,Taita Taveta,COAST,15181
TAVETA,Rural,12,654,600,1254,Taita Taveta,COAST,15182
TAVETA,Rural,13,649,552,1201,Taita Taveta,COAST,15183
TAVETA,Rural,14,540,511,1051,Taita Taveta,COAST,15184
TAVETA,Rural,15,609,490,1099,Taita Taveta,COAST,15185
TAVETA,Rural,16,528,455,983,Taita Taveta,COAST,15186
TAVETA,Rural,17,555,414,969,Taita Taveta,COAST,15187
TAVETA,Rural,18,543,426,969,Taita Taveta,COAST,15188
TAVETA,Rural,19,486,364,850,Taita Taveta,COAST,15189
TAVETA,Rural,20,529,527,1056,Taita Taveta,COAST,15190
TAVETA,Rural,21,357,351,708,Taita Taveta,COAST,15191
TAVETA,Rural,22,466,397,863,Taita Taveta,COAST,15192
TAVETA,Rural,23,388,387,775,Taita Taveta,COAST,15193
TAVETA,Rural,24,411,364,775,Taita Taveta,COAST,15194
TAVETA,Rural,25,491,443,934,Taita Taveta,COAST,15195
TAVETA,Rural,26,350,366,716,Taita Taveta,COAST,15196
TAVETA,Rural,27,408,341,749,Taita Taveta,COAST,15197
TAVETA,Rural,28,347,321,668,Taita Taveta,COAST,15198
TAVETA,Rural,29,360,352,712,Taita Taveta,COAST,15199
TAVETA,Rural,30,521,413,934,Taita Taveta,COAST,15200
TAVETA,Rural,31,267,232,499,Taita Taveta,COAST,15201
TAVETA,Rural,32,371,303,674,Taita Taveta,COAST,15202
TAVETA,Rural,33,279,219,498,Taita Taveta,COAST,15203
TAVETA,Rural,34,263,219,482,Taita Taveta,COAST,15204
TAVETA,Rural,35,427,400,827,Taita Taveta,COAST,15205
TAVETA,Rural,36,257,220,477,Taita Taveta,COAST,15206
TAVETA,Rural,37,266,204,470,Taita Taveta,COAST,15207
TAVETA,Rural,38,228,237,465,Taita Taveta,COAST,15208
TAVETA,Rural,39,248,220,468,Taita Taveta,COAST,15209
TAVETA,Rural,40,358,314,672,Taita Taveta,COAST,15210
TAVETA,Rural,41,176,159,335,Taita Taveta,COAST,15211
TAVETA,Rural,42,200,172,372,Taita Taveta,COAST,15212
TAVETA,Rural,43,146,127,273,Taita Taveta,COAST,15213
TAVETA,Rural,44,171,131,302,Taita Taveta,COAST,15214
TAVETA,Rural,45,261,250,511,Taita Taveta,COAST,15215
TAVETA,Rural,46,191,177,368,Taita Taveta,COAST,15216
TAVETA,Rural,47,136,142,278,Taita Taveta,COAST,15217
TAVETA,Rural,48,145,128,273,Taita Taveta,COAST,15218
TAVETA,Rural,49,161,132,293,Taita Taveta,COAST,15219
TAVETA,Rural,50,226,222,448,Taita Taveta,COAST,15220
TAVETA,Rural,51,126,104,230,Taita Taveta,COAST,15221
TAVETA,Rural,52,143,126,269,Taita Taveta,COAST,15222
TAVETA,Rural,53,101,96,197,Taita Taveta,COAST,15223
TAVETA,Rural,54,90,98,188,Taita Taveta,COAST,15224
TAVETA,Rural,55,154,131,285,Taita Taveta,COAST,15225
TAVETA,Rural,56,114,102,216,Taita Taveta,COAST,15226
TAVETA,Rural,57,137,110,247,Taita Taveta,COAST,15227
TAVETA,Rural,58,78,74,152,Taita Taveta,COAST,15228
TAVETA,Rural,59,93,75,168,Taita Taveta,COAST,15229
TAVETA,Rural,60,148,183,331,Taita Taveta,COAST,15230
TAVETA,Rural,61,97,67,164,Taita Taveta,COAST,15231
TAVETA,Rural,62,72,45,117,Taita Taveta,COAST,15232
TAVETA,Rural,63,58,61,119,Taita Taveta,COAST,15233
TAVETA,Rural,64,63,54,117,Taita Taveta,COAST,15234
TAVETA,Rural,65,90,87,177,Taita Taveta,COAST,15235
TAVETA,Rural,66,46,21,67,Taita Taveta,COAST,15236
TAVETA,Rural,67,80,62,142,Taita Taveta,COAST,15237
TAVETA,Rural,68,37,33,70,Taita Taveta,COAST,15238
TAVETA,Rural,69,40,56,96,Taita Taveta,COAST,15239
TAVETA,Rural,70,105,105,210,Taita Taveta,COAST,15240
TAVETA,Rural,71,29,29,58,Taita Taveta,COAST,15241
TAVETA,Rural,72,44,31,75,Taita Taveta,COAST,15242
TAVETA,Rural,73,42,31,73,Taita Taveta,COAST,15243
TAVETA,Rural,74,31,24,55,Taita Taveta,COAST,15244
TAVETA,Rural,75,24,51,75,Taita Taveta,COAST,15245
TAVETA,Rural,76,33,32,65,Taita Taveta,COAST,15246
TAVETA,Rural,77,25,23,48,Taita Taveta,COAST,15247
TAVETA,Rural,78,34,28,62,Taita Taveta,COAST,15248
TAVETA,Rural,79,41,48,89,Taita Taveta,COAST,15249
TAVETA,Rural,80+,269,360,629,Taita Taveta,COAST,15250
TAVETA,Rural,Age NS,9,3,12,Taita Taveta,COAST,15251
MARSABIT,Rural,0,506,493,999,Marsabit,EASTERN,15252
MARSABIT,Rural,1,469,445,914,Marsabit,EASTERN,15253
MARSABIT,Rural,2,551,525,1076,Marsabit,EASTERN,15254
MARSABIT,Rural,3,558,582,1140,Marsabit,EASTERN,15255
MARSABIT,Rural,4,551,559,1110,Marsabit,EASTERN,15256
MARSABIT,Rural,5,572,539,1111,Marsabit,EASTERN,15257
MARSABIT,Rural,6,520,545,1065,Marsabit,EASTERN,15258
MARSABIT,Rural,7,576,541,1117,Marsabit,EASTERN,15259
MARSABIT,Rural,8,496,529,1025,Marsabit,EASTERN,15260
MARSABIT,Rural,9,404,400,804,Marsabit,EASTERN,15261
MARSABIT,Rural,10,604,572,1176,Marsabit,EASTERN,15262
MARSABIT,Rural,11,335,325,660,Marsabit,EASTERN,15263
MARSABIT,Rural,12,566,512,1078,Marsabit,EASTERN,15264
MARSABIT,Rural,13,451,442,893,Marsabit,EASTERN,15265
MARSABIT,Rural,14,411,441,852,Marsabit,EASTERN,15266
MARSABIT,Rural,15,520,497,1017,Marsabit,EASTERN,15267
MARSABIT,Rural,16,413,375,788,Marsabit,EASTERN,15268
MARSABIT,Rural,17,363,306,669,Marsabit,EASTERN,15269
MARSABIT,Rural,18,482,412,894,Marsabit,EASTERN,15270
MARSABIT,Rural,19,252,203,455,Marsabit,EASTERN,15271
MARSABIT,Rural,20,488,464,952,Marsabit,EASTERN,15272
MARSABIT,Rural,21,168,193,361,Marsabit,EASTERN,15273
MARSABIT,Rural,22,228,244,472,Marsabit,EASTERN,15274
MARSABIT,Rural,23,185,202,387,Marsabit,EASTERN,15275
MARSABIT,Rural,24,173,192,365,Marsabit,EASTERN,15276
MARSABIT,Rural,25,309,375,684,Marsabit,EASTERN,15277
MARSABIT,Rural,26,158,155,313,Marsabit,EASTERN,15278
MARSABIT,Rural,27,158,166,324,Marsabit,EASTERN,15279
MARSABIT,Rural,28,166,225,391,Marsabit,EASTERN,15280
MARSABIT,Rural,29,96,88,184,Marsabit,EASTERN,15281
MARSABIT,Rural,30,324,420,744,Marsabit,EASTERN,15282
MARSABIT,Rural,31,101,86,187,Marsabit,EASTERN,15283
MARSABIT,Rural,32,150,122,272,Marsabit,EASTERN,15284
MARSABIT,Rural,33,93,93,186,Marsabit,EASTERN,15285
MARSABIT,Rural,34,117,75,192,Marsabit,EASTERN,15286
MARSABIT,Rural,35,226,326,552,Marsabit,EASTERN,15287
MARSABIT,Rural,36,115,112,227,Marsabit,EASTERN,15288
MARSABIT,Rural,37,95,87,182,Marsabit,EASTERN,15289
MARSABIT,Rural,38,102,101,203,Marsabit,EASTERN,15290
MARSABIT,Rural,39,57,70,127,Marsabit,EASTERN,15291
MARSABIT,Rural,40,195,332,527,Marsabit,EASTERN,15292
MARSABIT,Rural,41,59,49,108,Marsabit,EASTERN,15293
MARSABIT,Rural,42,84,99,183,Marsabit,EASTERN,15294
MARSABIT,Rural,43,55,48,103,Marsabit,EASTERN,15295
MARSABIT,Rural,44,53,61,114,Marsabit,EASTERN,15296
MARSABIT,Rural,45,171,193,364,Marsabit,EASTERN,15297
MARSABIT,Rural,46,67,60,127,Marsabit,EASTERN,15298
MARSABIT,Rural,47,59,47,106,Marsabit,EASTERN,15299
MARSABIT,Rural,48,103,101,204,Marsabit,EASTERN,15300
MARSABIT,Rural,49,83,71,154,Marsabit,EASTERN,15301
MARSABIT,Rural,50,154,265,419,Marsabit,EASTERN,15302
MARSABIT,Rural,51,52,49,101,Marsabit,EASTERN,15303
MARSABIT,Rural,52,66,67,133,Marsabit,EASTERN,15304
MARSABIT,Rural,53,38,34,72,Marsabit,EASTERN,15305
MARSABIT,Rural,54,48,47,95,Marsabit,EASTERN,15306
MARSABIT,Rural,55,89,78,167,Marsabit,EASTERN,15307
MARSABIT,Rural,56,74,57,131,Marsabit,EASTERN,15308
MARSABIT,Rural,57,48,34,82,Marsabit,EASTERN,15309
MARSABIT,Rural,58,65,36,101,Marsabit,EASTERN,15310
MARSABIT,Rural,59,38,40,78,Marsabit,EASTERN,15311
MARSABIT,Rural,60,146,203,349,Marsabit,EASTERN,15312
MARSABIT,Rural,61,36,45,81,Marsabit,EASTERN,15313
MARSABIT,Rural,62,35,22,57,Marsabit,EASTERN,15314
MARSABIT,Rural,63,15,19,34,Marsabit,EASTERN,15315
MARSABIT,Rural,64,41,34,75,Marsabit,EASTERN,15316
MARSABIT,Rural,65,71,59,130,Marsabit,EASTERN,15317
MARSABIT,Rural,66,25,14,39,Marsabit,EASTERN,15318
MARSABIT,Rural,67,34,21,55,Marsabit,EASTERN,15319
MARSABIT,Rural,68,38,28,66,Marsabit,EASTERN,15320
MARSABIT,Rural,69,29,19,48,Marsabit,EASTERN,15321
MARSABIT,Rural,70,107,132,239,Marsabit,EASTERN,15322
MARSABIT,Rural,71,12,22,34,Marsabit,EASTERN,15323
MARSABIT,Rural,72,40,36,76,Marsabit,EASTERN,15324
MARSABIT,Rural,73,22,23,45,Marsabit,EASTERN,15325
MARSABIT,Rural,74,34,21,55,Marsabit,EASTERN,15326
MARSABIT,Rural,75,39,42,81,Marsabit,EASTERN,15327
MARSABIT,Rural,76,30,20,50,Marsabit,EASTERN,15328
MARSABIT,Rural,77,19,6,25,Marsabit,EASTERN,15329
MARSABIT,Rural,78,24,13,37,Marsabit,EASTERN,15330
MARSABIT,Rural,79,18,11,29,Marsabit,EASTERN,15331
MARSABIT,Rural,80+,253,216,469,Marsabit,EASTERN,15332
MARSABIT,Rural,Age NS,2,2,4,Marsabit,EASTERN,15333
CHALBI,Rural,0,860,802,1662,Marsabit,EASTERN,15334
CHALBI,Rural,1,889,791,1680,Marsabit,EASTERN,15335
CHALBI,Rural,2,1116,1087,2203,Marsabit,EASTERN,15336
CHALBI,Rural,3,1061,961,2022,Marsabit,EASTERN,15337
CHALBI,Rural,4,1092,1073,2165,Marsabit,EASTERN,15338
CHALBI,Rural,5,1191,1151,2342,Marsabit,EASTERN,15339
CHALBI,Rural,6,1197,1101,2298,Marsabit,EASTERN,15340
CHALBI,Rural,7,1058,1012,2070,Marsabit,EASTERN,15341
CHALBI,Rural,8,1161,1062,2223,Marsabit,EASTERN,15342
CHALBI,Rural,9,949,884,1833,Marsabit,EASTERN,15343
CHALBI,Rural,10,1485,1442,2927,Marsabit,EASTERN,15344
CHALBI,Rural,11,802,816,1618,Marsabit,EASTERN,15345
CHALBI,Rural,12,1387,1084,2471,Marsabit,EASTERN,15346
CHALBI,Rural,13,1003,835,1838,Marsabit,EASTERN,15347
CHALBI,Rural,14,1087,885,1972,Marsabit,EASTERN,15348
CHALBI,Rural,15,1317,1042,2359,Marsabit,EASTERN,15349
CHALBI,Rural,16,891,781,1672,Marsabit,EASTERN,15350
CHALBI,Rural,17,829,615,1444,Marsabit,EASTERN,15351
CHALBI,Rural,18,1194,926,2120,Marsabit,EASTERN,15352
CHALBI,Rural,19,782,628,1410,Marsabit,EASTERN,15353
CHALBI,Rural,20,1433,1120,2553,Marsabit,EASTERN,15354
CHALBI,Rural,21,587,495,1082,Marsabit,EASTERN,15355
CHALBI,Rural,22,819,592,1411,Marsabit,EASTERN,15356
CHALBI,Rural,23,639,426,1065,Marsabit,EASTERN,15357
CHALBI,Rural,24,664,508,1172,Marsabit,EASTERN,15358
CHALBI,Rural,25,832,576,1408,Marsabit,EASTERN,15359
CHALBI,Rural,26,640,460,1100,Marsabit,EASTERN,15360
CHALBI,Rural,27,527,359,886,Marsabit,EASTERN,15361
CHALBI,Rural,28,665,524,1189,Marsabit,EASTERN,15362
CHALBI,Rural,29,389,322,711,Marsabit,EASTERN,15363
CHALBI,Rural,30,1279,932,2211,Marsabit,EASTERN,15364
CHALBI,Rural,31,319,255,574,Marsabit,EASTERN,15365
CHALBI,Rural,32,517,366,883,Marsabit,EASTERN,15366
CHALBI,Rural,33,306,226,532,Marsabit,EASTERN,15367
CHALBI,Rural,34,257,203,460,Marsabit,EASTERN,15368
CHALBI,Rural,35,615,368,983,Marsabit,EASTERN,15369
CHALBI,Rural,36,347,306,653,Marsabit,EASTERN,15370
CHALBI,Rural,37,247,179,426,Marsabit,EASTERN,15371
CHALBI,Rural,38,388,313,701,Marsabit,EASTERN,15372
CHALBI,Rural,39,253,206,459,Marsabit,EASTERN,15373
CHALBI,Rural,40,968,725,1693,Marsabit,EASTERN,15374
CHALBI,Rural,41,174,115,289,Marsabit,EASTERN,15375
CHALBI,Rural,42,330,254,584,Marsabit,EASTERN,15376
CHALBI,Rural,43,159,147,306,Marsabit,EASTERN,15377
CHALBI,Rural,44,122,113,235,Marsabit,EASTERN,15378
CHALBI,Rural,45,412,311,723,Marsabit,EASTERN,15379
CHALBI,Rural,46,212,141,353,Marsabit,EASTERN,15380
CHALBI,Rural,47,188,129,317,Marsabit,EASTERN,15381
CHALBI,Rural,48,245,178,423,Marsabit,EASTERN,15382
CHALBI,Rural,49,167,128,295,Marsabit,EASTERN,15383
CHALBI,Rural,50,714,617,1331,Marsabit,EASTERN,15384
CHALBI,Rural,51,138,104,242,Marsabit,EASTERN,15385
CHALBI,Rural,52,235,137,372,Marsabit,EASTERN,15386
CHALBI,Rural,53,115,80,195,Marsabit,EASTERN,15387
CHALBI,Rural,54,141,92,233,Marsabit,EASTERN,15388
CHALBI,Rural,55,269,155,424,Marsabit,EASTERN,15389
CHALBI,Rural,56,179,92,271,Marsabit,EASTERN,15390
CHALBI,Rural,57,127,80,207,Marsabit,EASTERN,15391
CHALBI,Rural,58,145,98,243,Marsabit,EASTERN,15392
CHALBI,Rural,59,80,72,152,Marsabit,EASTERN,15393
CHALBI,Rural,60,557,455,1012,Marsabit,EASTERN,15394
CHALBI,Rural,61,80,50,130,Marsabit,EASTERN,15395
CHALBI,Rural,62,102,92,194,Marsabit,EASTERN,15396
CHALBI,Rural,63,84,39,123,Marsabit,EASTERN,15397
CHALBI,Rural,64,80,59,139,Marsabit,EASTERN,15398
CHALBI,Rural,65,207,138,345,Marsabit,EASTERN,15399
CHALBI,Rural,66,70,33,103,Marsabit,EASTERN,15400
CHALBI,Rural,67,84,58,142,Marsabit,EASTERN,15401
CHALBI,Rural,68,84,60,144,Marsabit,EASTERN,15402
CHALBI,Rural,69,50,36,86,Marsabit,EASTERN,15403
CHALBI,Rural,70,500,353,853,Marsabit,EASTERN,15404
CHALBI,Rural,71,53,34,87,Marsabit,EASTERN,15405
CHALBI,Rural,72,97,57,154,Marsabit,EASTERN,15406
CHALBI,Rural,73,43,39,82,Marsabit,EASTERN,15407
CHALBI,Rural,74,49,30,79,Marsabit,EASTERN,15408
CHALBI,Rural,75,110,90,200,Marsabit,EASTERN,15409
CHALBI,Rural,76,36,29,65,Marsabit,EASTERN,15410
CHALBI,Rural,77,40,27,67,Marsabit,EASTERN,15411
CHALBI,Rural,78,39,37,76,Marsabit,EASTERN,15412
CHALBI,Rural,79,15,18,33,Marsabit,EASTERN,15413
CHALBI,Rural,80+,721,648,1369,Marsabit,EASTERN,15414
CHALBI,Rural,Age NS,23,14,37,Marsabit,EASTERN,15415
LAISAMIS,Rural,0,1009,989,1998,Marsabit,EASTERN,15416
LAISAMIS,Rural,1,1031,907,1938,Marsabit,EASTERN,15417
LAISAMIS,Rural,2,1426,1315,2741,Marsabit,EASTERN,15418
LAISAMIS,Rural,3,1194,1180,2374,Marsabit,EASTERN,15419
LAISAMIS,Rural,4,1246,1229,2475,Marsabit,EASTERN,15420
LAISAMIS,Rural,5,1183,1223,2406,Marsabit,EASTERN,15421
LAISAMIS,Rural,6,1128,1069,2197,Marsabit,EASTERN,15422
LAISAMIS,Rural,7,907,902,1809,Marsabit,EASTERN,15423
LAISAMIS,Rural,8,962,989,1951,Marsabit,EASTERN,15424
LAISAMIS,Rural,9,759,736,1495,Marsabit,EASTERN,15425
LAISAMIS,Rural,10,1155,1144,2299,Marsabit,EASTERN,15426
LAISAMIS,Rural,11,520,584,1104,Marsabit,EASTERN,15427
LAISAMIS,Rural,12,958,898,1856,Marsabit,EASTERN,15428
LAISAMIS,Rural,13,666,611,1277,Marsabit,EASTERN,15429
LAISAMIS,Rural,14,690,625,1315,Marsabit,EASTERN,15430
LAISAMIS,Rural,15,800,753,1553,Marsabit,EASTERN,15431
LAISAMIS,Rural,16,638,632,1270,Marsabit,EASTERN,15432
LAISAMIS,Rural,17,565,465,1030,Marsabit,EASTERN,15433
LAISAMIS,Rural,18,735,647,1382,Marsabit,EASTERN,15434
LAISAMIS,Rural,19,445,410,855,Marsabit,EASTERN,15435
LAISAMIS,Rural,20,806,793,1599,Marsabit,EASTERN,15436
LAISAMIS,Rural,21,379,407,786,Marsabit,EASTERN,15437
LAISAMIS,Rural,22,438,479,917,Marsabit,EASTERN,15438
LAISAMIS,Rural,23,393,435,828,Marsabit,EASTERN,15439
LAISAMIS,Rural,24,447,538,985,Marsabit,EASTERN,15440
LAISAMIS,Rural,25,519,601,1120,Marsabit,EASTERN,15441
LAISAMIS,Rural,26,439,446,885,Marsabit,EASTERN,15442
LAISAMIS,Rural,27,299,308,607,Marsabit,EASTERN,15443
LAISAMIS,Rural,28,370,520,890,Marsabit,EASTERN,15444
LAISAMIS,Rural,29,223,213,436,Marsabit,EASTERN,15445
LAISAMIS,Rural,30,503,655,1158,Marsabit,EASTERN,15446
LAISAMIS,Rural,31,237,203,440,Marsabit,EASTERN,15447
LAISAMIS,Rural,32,325,341,666,Marsabit,EASTERN,15448
LAISAMIS,Rural,33,151,195,346,Marsabit,EASTERN,15449
LAISAMIS,Rural,34,190,172,362,Marsabit,EASTERN,15450
LAISAMIS,Rural,35,376,410,786,Marsabit,EASTERN,15451
LAISAMIS,Rural,36,225,355,580,Marsabit,EASTERN,15452
LAISAMIS,Rural,37,126,186,312,Marsabit,EASTERN,15453
LAISAMIS,Rural,38,188,295,483,Marsabit,EASTERN,15454
LAISAMIS,Rural,39,115,195,310,Marsabit,EASTERN,15455
LAISAMIS,Rural,40,334,467,801,Marsabit,EASTERN,15456
LAISAMIS,Rural,41,103,154,257,Marsabit,EASTERN,15457
LAISAMIS,Rural,42,214,172,386,Marsabit,EASTERN,15458
LAISAMIS,Rural,43,120,112,232,Marsabit,EASTERN,15459
LAISAMIS,Rural,44,76,110,186,Marsabit,EASTERN,15460
LAISAMIS,Rural,45,230,241,471,Marsabit,EASTERN,15461
LAISAMIS,Rural,46,142,148,290,Marsabit,EASTERN,15462
LAISAMIS,Rural,47,100,126,226,Marsabit,EASTERN,15463
LAISAMIS,Rural,48,206,191,397,Marsabit,EASTERN,15464
LAISAMIS,Rural,49,112,144,256,Marsabit,EASTERN,15465
LAISAMIS,Rural,50,293,315,608,Marsabit,EASTERN,15466
LAISAMIS,Rural,51,76,82,158,Marsabit,EASTERN,15467
LAISAMIS,Rural,52,108,158,266,Marsabit,EASTERN,15468
LAISAMIS,Rural,53,102,84,186,Marsabit,EASTERN,15469
LAISAMIS,Rural,54,79,96,175,Marsabit,EASTERN,15470
LAISAMIS,Rural,55,107,138,245,Marsabit,EASTERN,15471
LAISAMIS,Rural,56,97,132,229,Marsabit,EASTERN,15472
LAISAMIS,Rural,57,76,68,144,Marsabit,EASTERN,15473
LAISAMIS,Rural,58,117,99,216,Marsabit,EASTERN,15474
LAISAMIS,Rural,59,82,98,180,Marsabit,EASTERN,15475
LAISAMIS,Rural,60,194,274,468,Marsabit,EASTERN,15476
LAISAMIS,Rural,61,64,76,140,Marsabit,EASTERN,15477
LAISAMIS,Rural,62,57,84,141,Marsabit,EASTERN,15478
LAISAMIS,Rural,63,50,50,100,Marsabit,EASTERN,15479
LAISAMIS,Rural,64,70,65,135,Marsabit,EASTERN,15480
LAISAMIS,Rural,65,114,112,226,Marsabit,EASTERN,15481
LAISAMIS,Rural,66,33,34,67,Marsabit,EASTERN,15482
LAISAMIS,Rural,67,46,45,91,Marsabit,EASTERN,15483
LAISAMIS,Rural,68,51,65,116,Marsabit,EASTERN,15484
LAISAMIS,Rural,69,54,54,108,Marsabit,EASTERN,15485
LAISAMIS,Rural,70,139,193,332,Marsabit,EASTERN,15486
LAISAMIS,Rural,71,25,33,58,Marsabit,EASTERN,15487
LAISAMIS,Rural,72,61,55,116,Marsabit,EASTERN,15488
LAISAMIS,Rural,73,33,35,68,Marsabit,EASTERN,15489
LAISAMIS,Rural,74,44,34,78,Marsabit,EASTERN,15490
LAISAMIS,Rural,75,64,64,128,Marsabit,EASTERN,15491
LAISAMIS,Rural,76,27,35,62,Marsabit,EASTERN,15492
LAISAMIS,Rural,77,23,16,39,Marsabit,EASTERN,15493
LAISAMIS,Rural,78,41,44,85,Marsabit,EASTERN,15494
LAISAMIS,Rural,79,28,33,61,Marsabit,EASTERN,15495
LAISAMIS,Rural,80+,326,375,701,Marsabit,EASTERN,15496
LAISAMIS,Rural,Age NS,4,5,9,Marsabit,EASTERN,15497
MOYALE,Rural,0,743,684,1427,Marsabit,EASTERN,15498
MOYALE,Rural,1,621,603,1224,Marsabit,EASTERN,15499
MOYALE,Rural,2,1268,1168,2436,Marsabit,EASTERN,15500
MOYALE,Rural,3,943,952,1895,Marsabit,EASTERN,15501
MOYALE,Rural,4,1320,1265,2585,Marsabit,EASTERN,15502
MOYALE,Rural,5,1016,945,1961,Marsabit,EASTERN,15503
MOYALE,Rural,6,1463,1305,2768,Marsabit,EASTERN,15504
MOYALE,Rural,7,938,909,1847,Marsabit,EASTERN,15505
MOYALE,Rural,8,1587,1427,3014,Marsabit,EASTERN,15506
MOYALE,Rural,9,801,681,1482,Marsabit,EASTERN,15507
MOYALE,Rural,10,1673,1461,3134,Marsabit,EASTERN,15508
MOYALE,Rural,11,574,531,1105,Marsabit,EASTERN,15509
MOYALE,Rural,12,1440,1203,2643,Marsabit,EASTERN,15510
MOYALE,Rural,13,812,632,1444,Marsabit,EASTERN,15511
MOYALE,Rural,14,1071,855,1926,Marsabit,EASTERN,15512
MOYALE,Rural,15,1128,856,1984,Marsabit,EASTERN,15513
MOYALE,Rural,16,1120,754,1874,Marsabit,EASTERN,15514
MOYALE,Rural,17,687,425,1112,Marsabit,EASTERN,15515
MOYALE,Rural,18,1340,881,2221,Marsabit,EASTERN,15516
MOYALE,Rural,19,420,310,730,Marsabit,EASTERN,15517
MOYALE,Rural,20,1248,994,2242,Marsabit,EASTERN,15518
MOYALE,Rural,21,318,186,504,Marsabit,EASTERN,15519
MOYALE,Rural,22,462,375,837,Marsabit,EASTERN,15520
MOYALE,Rural,23,261,216,477,Marsabit,EASTERN,15521
MOYALE,Rural,24,341,282,623,Marsabit,EASTERN,15522
MOYALE,Rural,25,647,767,1414,Marsabit,EASTERN,15523
MOYALE,Rural,26,255,256,511,Marsabit,EASTERN,15524
MOYALE,Rural,27,245,221,466,Marsabit,EASTERN,15525
MOYALE,Rural,28,376,416,792,Marsabit,EASTERN,15526
MOYALE,Rural,29,146,152,298,Marsabit,EASTERN,15527
MOYALE,Rural,30,927,926,1853,Marsabit,EASTERN,15528
MOYALE,Rural,31,118,108,226,Marsabit,EASTERN,15529
MOYALE,Rural,32,228,191,419,Marsabit,EASTERN,15530
MOYALE,Rural,33,114,127,241,Marsabit,EASTERN,15531
MOYALE,Rural,34,122,133,255,Marsabit,EASTERN,15532
MOYALE,Rural,35,479,572,1051,Marsabit,EASTERN,15533
MOYALE,Rural,36,128,139,267,Marsabit,EASTERN,15534
MOYALE,Rural,37,157,142,299,Marsabit,EASTERN,15535
MOYALE,Rural,38,154,217,371,Marsabit,EASTERN,15536
MOYALE,Rural,39,77,73,150,Marsabit,EASTERN,15537
MOYALE,Rural,40,756,779,1535,Marsabit,EASTERN,15538
MOYALE,Rural,41,78,51,129,Marsabit,EASTERN,15539
MOYALE,Rural,42,174,116,290,Marsabit,EASTERN,15540
MOYALE,Rural,43,92,68,160,Marsabit,EASTERN,15541
MOYALE,Rural,44,67,64,131,Marsabit,EASTERN,15542
MOYALE,Rural,45,318,366,684,Marsabit,EASTERN,15543
MOYALE,Rural,46,102,74,176,Marsabit,EASTERN,15544
MOYALE,Rural,47,107,88,195,Marsabit,EASTERN,15545
MOYALE,Rural,48,141,105,246,Marsabit,EASTERN,15546
MOYALE,Rural,49,55,51,106,Marsabit,EASTERN,15547
MOYALE,Rural,50,599,544,1143,Marsabit,EASTERN,15548
MOYALE,Rural,51,50,29,79,Marsabit,EASTERN,15549
MOYALE,Rural,52,91,82,173,Marsabit,EASTERN,15550
MOYALE,Rural,53,72,27,99,Marsabit,EASTERN,15551
MOYALE,Rural,54,66,47,113,Marsabit,EASTERN,15552
MOYALE,Rural,55,181,173,354,Marsabit,EASTERN,15553
MOYALE,Rural,56,97,50,147,Marsabit,EASTERN,15554
MOYALE,Rural,57,79,39,118,Marsabit,EASTERN,15555
MOYALE,Rural,58,74,49,123,Marsabit,EASTERN,15556
MOYALE,Rural,59,27,21,48,Marsabit,EASTERN,15557
MOYALE,Rural,60,476,342,818,Marsabit,EASTERN,15558
MOYALE,Rural,61,35,25,60,Marsabit,EASTERN,15559
MOYALE,Rural,62,49,26,75,Marsabit,EASTERN,15560
MOYALE,Rural,63,41,12,53,Marsabit,EASTERN,15561
MOYALE,Rural,64,48,19,67,Marsabit,EASTERN,15562
MOYALE,Rural,65,95,84,179,Marsabit,EASTERN,15563
MOYALE,Rural,66,35,11,46,Marsabit,EASTERN,15564
MOYALE,Rural,67,36,20,56,Marsabit,EASTERN,15565
MOYALE,Rural,68,61,24,85,Marsabit,EASTERN,15566
MOYALE,Rural,69,18,9,27,Marsabit,EASTERN,15567
MOYALE,Rural,70,342,299,641,Marsabit,EASTERN,15568
MOYALE,Rural,71,16,9,25,Marsabit,EASTERN,15569
MOYALE,Rural,72,41,20,61,Marsabit,EASTERN,15570
MOYALE,Rural,73,30,12,42,Marsabit,EASTERN,15571
MOYALE,Rural,74,27,11,38,Marsabit,EASTERN,15572
MOYALE,Rural,75,79,44,123,Marsabit,EASTERN,15573
MOYALE,Rural,76,21,16,37,Marsabit,EASTERN,15574
MOYALE,Rural,77,16,8,24,Marsabit,EASTERN,15575
MOYALE,Rural,78,29,23,52,Marsabit,EASTERN,15576
MOYALE,Rural,79,3,3,6,Marsabit,EASTERN,15577
MOYALE,Rural,80+,325,282,607,Marsabit,EASTERN,15578
MOYALE,Rural,Age NS,15,13,28,Marsabit,EASTERN,15579
ISIOLO,Rural,0,898,829,1727,Isiolo,EASTERN,15580
ISIOLO,Rural,1,781,683,1464,Isiolo,EASTERN,15581
ISIOLO,Rural,2,978,858,1836,Isiolo,EASTERN,15582
ISIOLO,Rural,3,972,958,1930,Isiolo,EASTERN,15583
ISIOLO,Rural,4,903,857,1760,Isiolo,EASTERN,15584
ISIOLO,Rural,5,868,882,1750,Isiolo,EASTERN,15585
ISIOLO,Rural,6,757,748,1505,Isiolo,EASTERN,15586
ISIOLO,Rural,7,781,774,1555,Isiolo,EASTERN,15587
ISIOLO,Rural,8,751,708,1459,Isiolo,EASTERN,15588
ISIOLO,Rural,9,632,617,1249,Isiolo,EASTERN,15589
ISIOLO,Rural,10,881,814,1695,Isiolo,EASTERN,15590
ISIOLO,Rural,11,423,464,887,Isiolo,EASTERN,15591
ISIOLO,Rural,12,821,699,1520,Isiolo,EASTERN,15592
ISIOLO,Rural,13,633,630,1263,Isiolo,EASTERN,15593
ISIOLO,Rural,14,549,459,1008,Isiolo,EASTERN,15594
ISIOLO,Rural,15,578,543,1121,Isiolo,EASTERN,15595
ISIOLO,Rural,16,461,430,891,Isiolo,EASTERN,15596
ISIOLO,Rural,17,404,359,763,Isiolo,EASTERN,15597
ISIOLO,Rural,18,542,527,1069,Isiolo,EASTERN,15598
ISIOLO,Rural,19,360,379,739,Isiolo,EASTERN,15599
ISIOLO,Rural,20,556,698,1254,Isiolo,EASTERN,15600
ISIOLO,Rural,21,307,310,617,Isiolo,EASTERN,15601
ISIOLO,Rural,22,441,374,815,Isiolo,EASTERN,15602
ISIOLO,Rural,23,402,298,700,Isiolo,EASTERN,15603
ISIOLO,Rural,24,415,347,762,Isiolo,EASTERN,15604
ISIOLO,Rural,25,598,660,1258,Isiolo,EASTERN,15605
ISIOLO,Rural,26,314,252,566,Isiolo,EASTERN,15606
ISIOLO,Rural,27,298,247,545,Isiolo,EASTERN,15607
ISIOLO,Rural,28,326,306,632,Isiolo,EASTERN,15608
ISIOLO,Rural,29,215,166,381,Isiolo,EASTERN,15609
ISIOLO,Rural,30,481,544,1025,Isiolo,EASTERN,15610
ISIOLO,Rural,31,189,188,377,Isiolo,EASTERN,15611
ISIOLO,Rural,32,266,224,490,Isiolo,EASTERN,15612
ISIOLO,Rural,33,159,124,283,Isiolo,EASTERN,15613
ISIOLO,Rural,34,165,101,266,Isiolo,EASTERN,15614
ISIOLO,Rural,35,407,442,849,Isiolo,EASTERN,15615
ISIOLO,Rural,36,210,149,359,Isiolo,EASTERN,15616
ISIOLO,Rural,37,167,115,282,Isiolo,EASTERN,15617
ISIOLO,Rural,38,194,159,353,Isiolo,EASTERN,15618
ISIOLO,Rural,39,127,87,214,Isiolo,EASTERN,15619
ISIOLO,Rural,40,363,426,789,Isiolo,EASTERN,15620
ISIOLO,Rural,41,70,49,119,Isiolo,EASTERN,15621
ISIOLO,Rural,42,167,123,290,Isiolo,EASTERN,15622
ISIOLO,Rural,43,127,64,191,Isiolo,EASTERN,15623
ISIOLO,Rural,44,88,60,148,Isiolo,EASTERN,15624
ISIOLO,Rural,45,241,238,479,Isiolo,EASTERN,15625
ISIOLO,Rural,46,120,91,211,Isiolo,EASTERN,15626
ISIOLO,Rural,47,96,81,177,Isiolo,EASTERN,15627
ISIOLO,Rural,48,139,136,275,Isiolo,EASTERN,15628
ISIOLO,Rural,49,129,105,234,Isiolo,EASTERN,15629
ISIOLO,Rural,50,297,307,604,Isiolo,EASTERN,15630
ISIOLO,Rural,51,69,59,128,Isiolo,EASTERN,15631
ISIOLO,Rural,52,89,68,157,Isiolo,EASTERN,15632
ISIOLO,Rural,53,88,51,139,Isiolo,EASTERN,15633
ISIOLO,Rural,54,97,73,170,Isiolo,EASTERN,15634
ISIOLO,Rural,55,139,111,250,Isiolo,EASTERN,15635
ISIOLO,Rural,56,83,57,140,Isiolo,EASTERN,15636
ISIOLO,Rural,57,64,54,118,Isiolo,EASTERN,15637
ISIOLO,Rural,58,65,68,133,Isiolo,EASTERN,15638
ISIOLO,Rural,59,54,62,116,Isiolo,EASTERN,15639
ISIOLO,Rural,60,195,223,418,Isiolo,EASTERN,15640
ISIOLO,Rural,61,53,49,102,Isiolo,EASTERN,15641
ISIOLO,Rural,62,46,31,77,Isiolo,EASTERN,15642
ISIOLO,Rural,63,34,24,58,Isiolo,EASTERN,15643
ISIOLO,Rural,64,50,43,93,Isiolo,EASTERN,15644
ISIOLO,Rural,65,86,112,198,Isiolo,EASTERN,15645
ISIOLO,Rural,66,31,10,41,Isiolo,EASTERN,15646
ISIOLO,Rural,67,45,21,66,Isiolo,EASTERN,15647
ISIOLO,Rural,68,35,33,68,Isiolo,EASTERN,15648
ISIOLO,Rural,69,40,41,81,Isiolo,EASTERN,15649
ISIOLO,Rural,70,123,140,263,Isiolo,EASTERN,15650
ISIOLO,Rural,71,20,31,51,Isiolo,EASTERN,15651
ISIOLO,Rural,72,34,30,64,Isiolo,EASTERN,15652
ISIOLO,Rural,73,22,23,45,Isiolo,EASTERN,15653
ISIOLO,Rural,74,23,20,43,Isiolo,EASTERN,15654
ISIOLO,Rural,75,50,33,83,Isiolo,EASTERN,15655
ISIOLO,Rural,76,26,16,42,Isiolo,EASTERN,15656
ISIOLO,Rural,77,13,15,28,Isiolo,EASTERN,15657
ISIOLO,Rural,78,21,25,46,Isiolo,EASTERN,15658
ISIOLO,Rural,79,24,15,39,Isiolo,EASTERN,15659
ISIOLO,Rural,80+,214,307,521,Isiolo,EASTERN,15660
ISIOLO,Rural,Age NS,17,5,22,Isiolo,EASTERN,15661
GARBATULLA,Rural,0,445,451,896,Isiolo,EASTERN,15662
GARBATULLA,Rural,1,473,394,867,Isiolo,EASTERN,15663
GARBATULLA,Rural,2,608,604,1212,Isiolo,EASTERN,15664
GARBATULLA,Rural,3,554,517,1071,Isiolo,EASTERN,15665
GARBATULLA,Rural,4,607,593,1200,Isiolo,EASTERN,15666
GARBATULLA,Rural,5,602,508,1110,Isiolo,EASTERN,15667
GARBATULLA,Rural,6,578,521,1099,Isiolo,EASTERN,15668
GARBATULLA,Rural,7,507,453,960,Isiolo,EASTERN,15669
GARBATULLA,Rural,8,595,580,1175,Isiolo,EASTERN,15670
GARBATULLA,Rural,9,388,377,765,Isiolo,EASTERN,15671
GARBATULLA,Rural,10,635,601,1236,Isiolo,EASTERN,15672
GARBATULLA,Rural,11,291,297,588,Isiolo,EASTERN,15673
GARBATULLA,Rural,12,623,525,1148,Isiolo,EASTERN,15674
GARBATULLA,Rural,13,476,379,855,Isiolo,EASTERN,15675
GARBATULLA,Rural,14,445,405,850,Isiolo,EASTERN,15676
GARBATULLA,Rural,15,519,432,951,Isiolo,EASTERN,15677
GARBATULLA,Rural,16,448,392,840,Isiolo,EASTERN,15678
GARBATULLA,Rural,17,399,286,685,Isiolo,EASTERN,15679
GARBATULLA,Rural,18,631,428,1059,Isiolo,EASTERN,15680
GARBATULLA,Rural,19,265,215,480,Isiolo,EASTERN,15681
GARBATULLA,Rural,20,739,566,1305,Isiolo,EASTERN,15682
GARBATULLA,Rural,21,241,191,432,Isiolo,EASTERN,15683
GARBATULLA,Rural,22,372,278,650,Isiolo,EASTERN,15684
GARBATULLA,Rural,23,258,187,445,Isiolo,EASTERN,15685
GARBATULLA,Rural,24,246,205,451,Isiolo,EASTERN,15686
GARBATULLA,Rural,25,487,411,898,Isiolo,EASTERN,15687
GARBATULLA,Rural,26,251,182,433,Isiolo,EASTERN,15688
GARBATULLA,Rural,27,192,122,314,Isiolo,EASTERN,15689
GARBATULLA,Rural,28,290,255,545,Isiolo,EASTERN,15690
GARBATULLA,Rural,29,121,93,214,Isiolo,EASTERN,15691
GARBATULLA,Rural,30,619,453,1072,Isiolo,EASTERN,15692
GARBATULLA,Rural,31,113,99,212,Isiolo,EASTERN,15693
GARBATULLA,Rural,32,185,152,337,Isiolo,EASTERN,15694
GARBATULLA,Rural,33,115,67,182,Isiolo,EASTERN,15695
GARBATULLA,Rural,34,103,67,170,Isiolo,EASTERN,15696
GARBATULLA,Rural,35,311,277,588,Isiolo,EASTERN,15697
GARBATULLA,Rural,36,146,150,296,Isiolo,EASTERN,15698
GARBATULLA,Rural,37,82,62,144,Isiolo,EASTERN,15699
GARBATULLA,Rural,38,152,119,271,Isiolo,EASTERN,15700
GARBATULLA,Rural,39,61,62,123,Isiolo,EASTERN,15701
GARBATULLA,Rural,40,483,400,883,Isiolo,EASTERN,15702
GARBATULLA,Rural,41,58,34,92,Isiolo,EASTERN,15703
GARBATULLA,Rural,42,165,93,258,Isiolo,EASTERN,15704
GARBATULLA,Rural,43,80,44,124,Isiolo,EASTERN,15705
GARBATULLA,Rural,44,53,45,98,Isiolo,EASTERN,15706
GARBATULLA,Rural,45,214,196,410,Isiolo,EASTERN,15707
GARBATULLA,Rural,46,98,75,173,Isiolo,EASTERN,15708
GARBATULLA,Rural,47,70,53,123,Isiolo,EASTERN,15709
GARBATULLA,Rural,48,135,94,229,Isiolo,EASTERN,15710
GARBATULLA,Rural,49,66,42,108,Isiolo,EASTERN,15711
GARBATULLA,Rural,50,391,246,637,Isiolo,EASTERN,15712
GARBATULLA,Rural,51,59,28,87,Isiolo,EASTERN,15713
GARBATULLA,Rural,52,102,57,159,Isiolo,EASTERN,15714
GARBATULLA,Rural,53,60,57,117,Isiolo,EASTERN,15715
GARBATULLA,Rural,54,83,51,134,Isiolo,EASTERN,15716
GARBATULLA,Rural,55,121,65,186,Isiolo,EASTERN,15717
GARBATULLA,Rural,56,108,62,170,Isiolo,EASTERN,15718
GARBATULLA,Rural,57,64,31,95,Isiolo,EASTERN,15719
GARBATULLA,Rural,58,74,42,116,Isiolo,EASTERN,15720
GARBATULLA,Rural,59,33,16,49,Isiolo,EASTERN,15721
GARBATULLA,Rural,60,268,185,453,Isiolo,EASTERN,15722
GARBATULLA,Rural,61,23,15,38,Isiolo,EASTERN,15723
GARBATULLA,Rural,62,51,18,69,Isiolo,EASTERN,15724
GARBATULLA,Rural,63,43,23,66,Isiolo,EASTERN,15725
GARBATULLA,Rural,64,23,15,38,Isiolo,EASTERN,15726
GARBATULLA,Rural,65,70,49,119,Isiolo,EASTERN,15727
GARBATULLA,Rural,66,30,12,42,Isiolo,EASTERN,15728
GARBATULLA,Rural,67,40,12,52,Isiolo,EASTERN,15729
GARBATULLA,Rural,68,33,25,58,Isiolo,EASTERN,15730
GARBATULLA,Rural,69,23,19,42,Isiolo,EASTERN,15731
GARBATULLA,Rural,70,191,105,296,Isiolo,EASTERN,15732
GARBATULLA,Rural,71,11,15,26,Isiolo,EASTERN,15733
GARBATULLA,Rural,72,27,22,49,Isiolo,EASTERN,15734
GARBATULLA,Rural,73,23,23,46,Isiolo,EASTERN,15735
GARBATULLA,Rural,74,12,15,27,Isiolo,EASTERN,15736
GARBATULLA,Rural,75,35,21,56,Isiolo,EASTERN,15737
GARBATULLA,Rural,76,22,14,36,Isiolo,EASTERN,15738
GARBATULLA,Rural,77,17,6,23,Isiolo,EASTERN,15739
GARBATULLA,Rural,78,22,24,46,Isiolo,EASTERN,15740
GARBATULLA,Rural,79,5,8,13,Isiolo,EASTERN,15741
GARBATULLA,Rural,80+,195,206,401,Isiolo,EASTERN,15742
GARBATULLA,Rural,Age NS,9,2,11,Isiolo,EASTERN,15743
MERU CENTRAL,Rural,0,1784,1696,3480,Meru,EASTERN,15744
MERU CENTRAL,Rural,1,1657,1464,3121,Meru,EASTERN,15745
MERU CENTRAL,Rural,2,1718,1730,3448,Meru,EASTERN,15746
MERU CENTRAL,Rural,3,1693,1640,3333,Meru,EASTERN,15747
MERU CENTRAL,Rural,4,1691,1763,3454,Meru,EASTERN,15748
MERU CENTRAL,Rural,5,1695,1687,3382,Meru,EASTERN,15749
MERU CENTRAL,Rural,6,1535,1580,3115,Meru,EASTERN,15750
MERU CENTRAL,Rural,7,1580,1578,3158,Meru,EASTERN,15751
MERU CENTRAL,Rural,8,1590,1549,3139,Meru,EASTERN,15752
MERU CENTRAL,Rural,9,1638,1729,3367,Meru,EASTERN,15753
MERU CENTRAL,Rural,10,1631,1587,3218,Meru,EASTERN,15754
MERU CENTRAL,Rural,11,1346,1426,2772,Meru,EASTERN,15755
MERU CENTRAL,Rural,12,1691,1673,3364,Meru,EASTERN,15756
MERU CENTRAL,Rural,13,1646,1595,3241,Meru,EASTERN,15757
MERU CENTRAL,Rural,14,1392,1365,2757,Meru,EASTERN,15758
MERU CENTRAL,Rural,15,1338,1336,2674,Meru,EASTERN,15759
MERU CENTRAL,Rural,16,1279,1310,2589,Meru,EASTERN,15760
MERU CENTRAL,Rural,17,1350,1353,2703,Meru,EASTERN,15761
MERU CENTRAL,Rural,18,1398,1283,2681,Meru,EASTERN,15762
MERU CENTRAL,Rural,19,1180,1168,2348,Meru,EASTERN,15763
MERU CENTRAL,Rural,20,1495,1368,2863,Meru,EASTERN,15764
MERU CENTRAL,Rural,21,1196,1132,2328,Meru,EASTERN,15765
MERU CENTRAL,Rural,22,1253,1225,2478,Meru,EASTERN,15766
MERU CENTRAL,Rural,23,1267,1302,2569,Meru,EASTERN,15767
MERU CENTRAL,Rural,24,1168,1196,2364,Meru,EASTERN,15768
MERU CENTRAL,Rural,25,1660,1648,3308,Meru,EASTERN,15769
MERU CENTRAL,Rural,26,1169,1242,2411,Meru,EASTERN,15770
MERU CENTRAL,Rural,27,1254,1114,2368,Meru,EASTERN,15771
MERU CENTRAL,Rural,28,1123,1119,2242,Meru,EASTERN,15772
MERU CENTRAL,Rural,29,1173,1120,2293,Meru,EASTERN,15773
MERU CENTRAL,Rural,30,1580,1696,3276,Meru,EASTERN,15774
MERU CENTRAL,Rural,31,982,887,1869,Meru,EASTERN,15775
MERU CENTRAL,Rural,32,1033,1016,2049,Meru,EASTERN,15776
MERU CENTRAL,Rural,33,911,836,1747,Meru,EASTERN,15777
MERU CENTRAL,Rural,34,909,882,1791,Meru,EASTERN,15778
MERU CENTRAL,Rural,35,1285,1254,2539,Meru,EASTERN,15779
MERU CENTRAL,Rural,36,861,877,1738,Meru,EASTERN,15780
MERU CENTRAL,Rural,37,864,792,1656,Meru,EASTERN,15781
MERU CENTRAL,Rural,38,754,816,1570,Meru,EASTERN,15782
MERU CENTRAL,Rural,39,810,711,1521,Meru,EASTERN,15783
MERU CENTRAL,Rural,40,1077,1216,2293,Meru,EASTERN,15784
MERU CENTRAL,Rural,41,665,657,1322,Meru,EASTERN,15785
MERU CENTRAL,Rural,42,573,498,1071,Meru,EASTERN,15786
MERU CENTRAL,Rural,43,477,517,994,Meru,EASTERN,15787
MERU CENTRAL,Rural,44,487,510,997,Meru,EASTERN,15788
MERU CENTRAL,Rural,45,906,1050,1956,Meru,EASTERN,15789
MERU CENTRAL,Rural,46,653,729,1382,Meru,EASTERN,15790
MERU CENTRAL,Rural,47,567,630,1197,Meru,EASTERN,15791
MERU CENTRAL,Rural,48,600,624,1224,Meru,EASTERN,15792
MERU CENTRAL,Rural,49,585,603,1188,Meru,EASTERN,15793
MERU CENTRAL,Rural,50,814,1118,1932,Meru,EASTERN,15794
MERU CENTRAL,Rural,51,478,417,895,Meru,EASTERN,15795
MERU CENTRAL,Rural,52,421,420,841,Meru,EASTERN,15796
MERU CENTRAL,Rural,53,375,350,725,Meru,EASTERN,15797
MERU CENTRAL,Rural,54,324,343,667,Meru,EASTERN,15798
MERU CENTRAL,Rural,55,512,643,1155,Meru,EASTERN,15799
MERU CENTRAL,Rural,56,377,383,760,Meru,EASTERN,15800
MERU CENTRAL,Rural,57,532,592,1124,Meru,EASTERN,15801
MERU CENTRAL,Rural,58,293,250,543,Meru,EASTERN,15802
MERU CENTRAL,Rural,59,382,371,753,Meru,EASTERN,15803
MERU CENTRAL,Rural,60,637,798,1435,Meru,EASTERN,15804
MERU CENTRAL,Rural,61,349,324,673,Meru,EASTERN,15805
MERU CENTRAL,Rural,62,264,214,478,Meru,EASTERN,15806
MERU CENTRAL,Rural,63,253,219,472,Meru,EASTERN,15807
MERU CENTRAL,Rural,64,249,288,537,Meru,EASTERN,15808
MERU CENTRAL,Rural,65,321,361,682,Meru,EASTERN,15809
MERU CENTRAL,Rural,66,138,133,271,Meru,EASTERN,15810
MERU CENTRAL,Rural,67,302,319,621,Meru,EASTERN,15811
MERU CENTRAL,Rural,68,154,154,308,Meru,EASTERN,15812
MERU CENTRAL,Rural,69,200,308,508,Meru,EASTERN,15813
MERU CENTRAL,Rural,70,423,637,1060,Meru,EASTERN,15814
MERU CENTRAL,Rural,71,126,164,290,Meru,EASTERN,15815
MERU CENTRAL,Rural,72,150,152,302,Meru,EASTERN,15816
MERU CENTRAL,Rural,73,163,132,295,Meru,EASTERN,15817
MERU CENTRAL,Rural,74,159,179,338,Meru,EASTERN,15818
MERU CENTRAL,Rural,75,213,222,435,Meru,EASTERN,15819
MERU CENTRAL,Rural,76,122,95,217,Meru,EASTERN,15820
MERU CENTRAL,Rural,77,118,156,274,Meru,EASTERN,15821
MERU CENTRAL,Rural,78,113,114,227,Meru,EASTERN,15822
MERU CENTRAL,Rural,79,119,225,344,Meru,EASTERN,15823
MERU CENTRAL,Rural,80+,1051,1584,2635,Meru,EASTERN,15824
MERU CENTRAL,Rural,Age NS,14,9,23,Meru,EASTERN,15825
IMENTI NORTH,Rural,0,2285,2186,4471,Meru,EASTERN,15826
IMENTI NORTH,Rural,1,2031,2041,4072,Meru,EASTERN,15827
IMENTI NORTH,Rural,2,2356,2406,4762,Meru,EASTERN,15828
IMENTI NORTH,Rural,3,2314,2344,4658,Meru,EASTERN,15829
IMENTI NORTH,Rural,4,2450,2333,4783,Meru,EASTERN,15830
IMENTI NORTH,Rural,5,2612,2364,4976,Meru,EASTERN,15831
IMENTI NORTH,Rural,6,2244,2220,4464,Meru,EASTERN,15832
IMENTI NORTH,Rural,7,2223,2208,4431,Meru,EASTERN,15833
IMENTI NORTH,Rural,8,2129,2095,4224,Meru,EASTERN,15834
IMENTI NORTH,Rural,9,2395,2289,4684,Meru,EASTERN,15835
IMENTI NORTH,Rural,10,2396,2243,4639,Meru,EASTERN,15836
IMENTI NORTH,Rural,11,1806,1782,3588,Meru,EASTERN,15837
IMENTI NORTH,Rural,12,2390,2107,4497,Meru,EASTERN,15838
IMENTI NORTH,Rural,13,2191,2146,4337,Meru,EASTERN,15839
IMENTI NORTH,Rural,14,1993,1904,3897,Meru,EASTERN,15840
IMENTI NORTH,Rural,15,1939,1764,3703,Meru,EASTERN,15841
IMENTI NORTH,Rural,16,1694,1666,3360,Meru,EASTERN,15842
IMENTI NORTH,Rural,17,1904,1743,3647,Meru,EASTERN,15843
IMENTI NORTH,Rural,18,1935,1715,3650,Meru,EASTERN,15844
IMENTI NORTH,Rural,19,1643,1476,3119,Meru,EASTERN,15845
IMENTI NORTH,Rural,20,2133,2026,4159,Meru,EASTERN,15846
IMENTI NORTH,Rural,21,1533,1498,3031,Meru,EASTERN,15847
IMENTI NORTH,Rural,22,1727,1782,3509,Meru,EASTERN,15848
IMENTI NORTH,Rural,23,1697,1821,3518,Meru,EASTERN,15849
IMENTI NORTH,Rural,24,1619,1689,3308,Meru,EASTERN,15850
IMENTI NORTH,Rural,25,2439,2412,4851,Meru,EASTERN,15851
IMENTI NORTH,Rural,26,1537,1666,3203,Meru,EASTERN,15852
IMENTI NORTH,Rural,27,1850,1712,3562,Meru,EASTERN,15853
IMENTI NORTH,Rural,28,1708,1717,3425,Meru,EASTERN,15854
IMENTI NORTH,Rural,29,1610,1574,3184,Meru,EASTERN,15855
IMENTI NORTH,Rural,30,2717,2750,5467,Meru,EASTERN,15856
IMENTI NORTH,Rural,31,1366,1072,2438,Meru,EASTERN,15857
IMENTI NORTH,Rural,32,1552,1485,3037,Meru,EASTERN,15858
IMENTI NORTH,Rural,33,1231,1048,2279,Meru,EASTERN,15859
IMENTI NORTH,Rural,34,1192,1110,2302,Meru,EASTERN,15860
IMENTI NORTH,Rural,35,2078,1956,4034,Meru,EASTERN,15861
IMENTI NORTH,Rural,36,1049,950,1999,Meru,EASTERN,15862
IMENTI NORTH,Rural,37,1040,979,2019,Meru,EASTERN,15863
IMENTI NORTH,Rural,38,1085,1160,2245,Meru,EASTERN,15864
IMENTI NORTH,Rural,39,960,925,1885,Meru,EASTERN,15865
IMENTI NORTH,Rural,40,1780,1879,3659,Meru,EASTERN,15866
IMENTI NORTH,Rural,41,791,713,1504,Meru,EASTERN,15867
IMENTI NORTH,Rural,42,825,802,1627,Meru,EASTERN,15868
IMENTI NORTH,Rural,43,616,661,1277,Meru,EASTERN,15869
IMENTI NORTH,Rural,44,611,595,1206,Meru,EASTERN,15870
IMENTI NORTH,Rural,45,1278,1432,2710,Meru,EASTERN,15871
IMENTI NORTH,Rural,46,892,856,1748,Meru,EASTERN,15872
IMENTI NORTH,Rural,47,738,792,1530,Meru,EASTERN,15873
IMENTI NORTH,Rural,48,748,819,1567,Meru,EASTERN,15874
IMENTI NORTH,Rural,49,725,639,1364,Meru,EASTERN,15875
IMENTI NORTH,Rural,50,1218,1454,2672,Meru,EASTERN,15876
IMENTI NORTH,Rural,51,536,493,1029,Meru,EASTERN,15877
IMENTI NORTH,Rural,52,605,513,1118,Meru,EASTERN,15878
IMENTI NORTH,Rural,53,464,452,916,Meru,EASTERN,15879
IMENTI NORTH,Rural,54,428,378,806,Meru,EASTERN,15880
IMENTI NORTH,Rural,55,763,799,1562,Meru,EASTERN,15881
IMENTI NORTH,Rural,56,497,445,942,Meru,EASTERN,15882
IMENTI NORTH,Rural,57,605,610,1215,Meru,EASTERN,15883
IMENTI NORTH,Rural,58,387,317,704,Meru,EASTERN,15884
IMENTI NORTH,Rural,59,453,394,847,Meru,EASTERN,15885
IMENTI NORTH,Rural,60,855,1040,1895,Meru,EASTERN,15886
IMENTI NORTH,Rural,61,336,294,630,Meru,EASTERN,15887
IMENTI NORTH,Rural,62,326,240,566,Meru,EASTERN,15888
IMENTI NORTH,Rural,63,276,207,483,Meru,EASTERN,15889
IMENTI NORTH,Rural,64,261,273,534,Meru,EASTERN,15890
IMENTI NORTH,Rural,65,390,467,857,Meru,EASTERN,15891
IMENTI NORTH,Rural,66,173,171,344,Meru,EASTERN,15892
IMENTI NORTH,Rural,67,334,382,716,Meru,EASTERN,15893
IMENTI NORTH,Rural,68,201,173,374,Meru,EASTERN,15894
IMENTI NORTH,Rural,69,185,249,434,Meru,EASTERN,15895
IMENTI NORTH,Rural,70,542,812,1354,Meru,EASTERN,15896
IMENTI NORTH,Rural,71,146,138,284,Meru,EASTERN,15897
IMENTI NORTH,Rural,72,194,113,307,Meru,EASTERN,15898
IMENTI NORTH,Rural,73,195,126,321,Meru,EASTERN,15899
IMENTI NORTH,Rural,74,158,127,285,Meru,EASTERN,15900
IMENTI NORTH,Rural,75,226,239,465,Meru,EASTERN,15901
IMENTI NORTH,Rural,76,131,90,221,Meru,EASTERN,15902
IMENTI NORTH,Rural,77,118,98,216,Meru,EASTERN,15903
IMENTI NORTH,Rural,78,111,116,227,Meru,EASTERN,15904
IMENTI NORTH,Rural,79,81,158,239,Meru,EASTERN,15905
IMENTI NORTH,Rural,80+,1132,1658,2790,Meru,EASTERN,15906
IMENTI NORTH,Rural,Age NS,71,26,97,Meru,EASTERN,15907
IMENTI SOUTH,Rural,0,1884,1894,3778,Meru,EASTERN,15908
IMENTI SOUTH,Rural,1,1823,1806,3629,Meru,EASTERN,15909
IMENTI SOUTH,Rural,2,2005,1907,3912,Meru,EASTERN,15910
IMENTI SOUTH,Rural,3,2004,1874,3878,Meru,EASTERN,15911
IMENTI SOUTH,Rural,4,2075,1965,4040,Meru,EASTERN,15912
IMENTI SOUTH,Rural,5,2090,1985,4075,Meru,EASTERN,15913
IMENTI SOUTH,Rural,6,1900,1833,3733,Meru,EASTERN,15914
IMENTI SOUTH,Rural,7,1844,1900,3744,Meru,EASTERN,15915
IMENTI SOUTH,Rural,8,1765,1765,3530,Meru,EASTERN,15916
IMENTI SOUTH,Rural,9,1922,1940,3862,Meru,EASTERN,15917
IMENTI SOUTH,Rural,10,1987,1888,3875,Meru,EASTERN,15918
IMENTI SOUTH,Rural,11,1510,1646,3156,Meru,EASTERN,15919
IMENTI SOUTH,Rural,12,2212,2032,4244,Meru,EASTERN,15920
IMENTI SOUTH,Rural,13,1905,1951,3856,Meru,EASTERN,15921
IMENTI SOUTH,Rural,14,1886,1709,3595,Meru,EASTERN,15922
IMENTI SOUTH,Rural,15,1621,1586,3207,Meru,EASTERN,15923
IMENTI SOUTH,Rural,16,1459,1613,3072,Meru,EASTERN,15924
IMENTI SOUTH,Rural,17,1678,1691,3369,Meru,EASTERN,15925
IMENTI SOUTH,Rural,18,1768,1634,3402,Meru,EASTERN,15926
IMENTI SOUTH,Rural,19,1405,1389,2794,Meru,EASTERN,15927
IMENTI SOUTH,Rural,20,1902,1773,3675,Meru,EASTERN,15928
IMENTI SOUTH,Rural,21,1468,1277,2745,Meru,EASTERN,15929
IMENTI SOUTH,Rural,22,1588,1555,3143,Meru,EASTERN,15930
IMENTI SOUTH,Rural,23,1485,1485,2970,Meru,EASTERN,15931
IMENTI SOUTH,Rural,24,1302,1314,2616,Meru,EASTERN,15932
IMENTI SOUTH,Rural,25,1881,1946,3827,Meru,EASTERN,15933
IMENTI SOUTH,Rural,26,1339,1327,2666,Meru,EASTERN,15934
IMENTI SOUTH,Rural,27,1355,1343,2698,Meru,EASTERN,15935
IMENTI SOUTH,Rural,28,1253,1393,2646,Meru,EASTERN,15936
IMENTI SOUTH,Rural,29,1286,1274,2560,Meru,EASTERN,15937
IMENTI SOUTH,Rural,30,2088,2165,4253,Meru,EASTERN,15938
IMENTI SOUTH,Rural,31,1112,929,2041,Meru,EASTERN,15939
IMENTI SOUTH,Rural,32,1264,1135,2399,Meru,EASTERN,15940
IMENTI SOUTH,Rural,33,1058,971,2029,Meru,EASTERN,15941
IMENTI SOUTH,Rural,34,1070,1001,2071,Meru,EASTERN,15942
IMENTI SOUTH,Rural,35,1710,1675,3385,Meru,EASTERN,15943
IMENTI SOUTH,Rural,36,960,936,1896,Meru,EASTERN,15944
IMENTI SOUTH,Rural,37,957,906,1863,Meru,EASTERN,15945
IMENTI SOUTH,Rural,38,990,1020,2010,Meru,EASTERN,15946
IMENTI SOUTH,Rural,39,942,893,1835,Meru,EASTERN,15947
IMENTI SOUTH,Rural,40,1513,1619,3132,Meru,EASTERN,15948
IMENTI SOUTH,Rural,41,728,621,1349,Meru,EASTERN,15949
IMENTI SOUTH,Rural,42,699,599,1298,Meru,EASTERN,15950
IMENTI SOUTH,Rural,43,568,543,1111,Meru,EASTERN,15951
IMENTI SOUTH,Rural,44,553,515,1068,Meru,EASTERN,15952
IMENTI SOUTH,Rural,45,1078,1236,2314,Meru,EASTERN,15953
IMENTI SOUTH,Rural,46,832,764,1596,Meru,EASTERN,15954
IMENTI SOUTH,Rural,47,688,669,1357,Meru,EASTERN,15955
IMENTI SOUTH,Rural,48,649,687,1336,Meru,EASTERN,15956
IMENTI SOUTH,Rural,49,733,626,1359,Meru,EASTERN,15957
IMENTI SOUTH,Rural,50,1162,1222,2384,Meru,EASTERN,15958
IMENTI SOUTH,Rural,51,523,445,968,Meru,EASTERN,15959
IMENTI SOUTH,Rural,52,550,452,1002,Meru,EASTERN,15960
IMENTI SOUTH,Rural,53,421,410,831,Meru,EASTERN,15961
IMENTI SOUTH,Rural,54,316,343,659,Meru,EASTERN,15962
IMENTI SOUTH,Rural,55,656,686,1342,Meru,EASTERN,15963
IMENTI SOUTH,Rural,56,402,432,834,Meru,EASTERN,15964
IMENTI SOUTH,Rural,57,612,511,1123,Meru,EASTERN,15965
IMENTI SOUTH,Rural,58,336,287,623,Meru,EASTERN,15966
IMENTI SOUTH,Rural,59,387,378,765,Meru,EASTERN,15967
IMENTI SOUTH,Rural,60,753,873,1626,Meru,EASTERN,15968
IMENTI SOUTH,Rural,61,349,298,647,Meru,EASTERN,15969
IMENTI SOUTH,Rural,62,302,269,571,Meru,EASTERN,15970
IMENTI SOUTH,Rural,63,255,224,479,Meru,EASTERN,15971
IMENTI SOUTH,Rural,64,275,287,562,Meru,EASTERN,15972
IMENTI SOUTH,Rural,65,359,456,815,Meru,EASTERN,15973
IMENTI SOUTH,Rural,66,146,135,281,Meru,EASTERN,15974
IMENTI SOUTH,Rural,67,299,341,640,Meru,EASTERN,15975
IMENTI SOUTH,Rural,68,208,232,440,Meru,EASTERN,15976
IMENTI SOUTH,Rural,69,231,291,522,Meru,EASTERN,15977
IMENTI SOUTH,Rural,70,531,750,1281,Meru,EASTERN,15978
IMENTI SOUTH,Rural,71,128,134,262,Meru,EASTERN,15979
IMENTI SOUTH,Rural,72,191,171,362,Meru,EASTERN,15980
IMENTI SOUTH,Rural,73,206,184,390,Meru,EASTERN,15981
IMENTI SOUTH,Rural,74,159,162,321,Meru,EASTERN,15982
IMENTI SOUTH,Rural,75,288,277,565,Meru,EASTERN,15983
IMENTI SOUTH,Rural,76,124,85,209,Meru,EASTERN,15984
IMENTI SOUTH,Rural,77,129,123,252,Meru,EASTERN,15985
IMENTI SOUTH,Rural,78,113,116,229,Meru,EASTERN,15986
IMENTI SOUTH,Rural,79,118,192,310,Meru,EASTERN,15987
IMENTI SOUTH,Rural,80+,1237,1719,2956,Meru,EASTERN,15988
IMENTI SOUTH,Rural,Age NS,36,32,68,Meru,EASTERN,15989
MERU SOUTH,Rural,0,1236,1154,2390,Meru,EASTERN,15990
MERU SOUTH,Rural,1,1113,1095,2208,Meru,EASTERN,15991
MERU SOUTH,Rural,2,1158,1188,2346,Meru,EASTERN,15992
MERU SOUTH,Rural,3,1164,1177,2341,Meru,EASTERN,15993
MERU SOUTH,Rural,4,1301,1149,2450,Meru,EASTERN,15994
MERU SOUTH,Rural,5,1263,1211,2474,Meru,EASTERN,15995
MERU SOUTH,Rural,6,1128,1164,2292,Meru,EASTERN,15996
MERU SOUTH,Rural,7,1128,1152,2280,Meru,EASTERN,15997
MERU SOUTH,Rural,8,1031,1043,2074,Meru,EASTERN,15998
MERU SOUTH,Rural,9,1111,1170,2281,Meru,EASTERN,15999
MERU SOUTH,Rural,10,1167,1135,2302,Meru,EASTERN,16000
MERU SOUTH,Rural,11,912,950,1862,Meru,EASTERN,16001
MERU SOUTH,Rural,12,1146,1161,2307,Meru,EASTERN,16002
MERU SOUTH,Rural,13,1099,1159,2258,Meru,EASTERN,16003
MERU SOUTH,Rural,14,1019,1015,2034,Meru,EASTERN,16004
MERU SOUTH,Rural,15,954,901,1855,Meru,EASTERN,16005
MERU SOUTH,Rural,16,872,924,1796,Meru,EASTERN,16006
MERU SOUTH,Rural,17,980,850,1830,Meru,EASTERN,16007
MERU SOUTH,Rural,18,973,805,1778,Meru,EASTERN,16008
MERU SOUTH,Rural,19,778,693,1471,Meru,EASTERN,16009
MERU SOUTH,Rural,20,819,922,1741,Meru,EASTERN,16010
MERU SOUTH,Rural,21,583,621,1204,Meru,EASTERN,16011
MERU SOUTH,Rural,22,629,713,1342,Meru,EASTERN,16012
MERU SOUTH,Rural,23,590,715,1305,Meru,EASTERN,16013
MERU SOUTH,Rural,24,508,684,1192,Meru,EASTERN,16014
MERU SOUTH,Rural,25,689,880,1569,Meru,EASTERN,16015
MERU SOUTH,Rural,26,499,602,1101,Meru,EASTERN,16016
MERU SOUTH,Rural,27,490,576,1066,Meru,EASTERN,16017
MERU SOUTH,Rural,28,471,682,1153,Meru,EASTERN,16018
MERU SOUTH,Rural,29,514,599,1113,Meru,EASTERN,16019
MERU SOUTH,Rural,30,731,947,1678,Meru,EASTERN,16020
MERU SOUTH,Rural,31,442,465,907,Meru,EASTERN,16021
MERU SOUTH,Rural,32,456,561,1017,Meru,EASTERN,16022
MERU SOUTH,Rural,33,393,439,832,Meru,EASTERN,16023
MERU SOUTH,Rural,34,357,454,811,Meru,EASTERN,16024
MERU SOUTH,Rural,35,631,778,1409,Meru,EASTERN,16025
MERU SOUTH,Rural,36,389,422,811,Meru,EASTERN,16026
MERU SOUTH,Rural,37,350,451,801,Meru,EASTERN,16027
MERU SOUTH,Rural,38,358,426,784,Meru,EASTERN,16028
MERU SOUTH,Rural,39,383,416,799,Meru,EASTERN,16029
MERU SOUTH,Rural,40,576,688,1264,Meru,EASTERN,16030
MERU SOUTH,Rural,41,339,307,646,Meru,EASTERN,16031
MERU SOUTH,Rural,42,293,297,590,Meru,EASTERN,16032
MERU SOUTH,Rural,43,245,296,541,Meru,EASTERN,16033
MERU SOUTH,Rural,44,242,252,494,Meru,EASTERN,16034
MERU SOUTH,Rural,45,489,592,1081,Meru,EASTERN,16035
MERU SOUTH,Rural,46,348,405,753,Meru,EASTERN,16036
MERU SOUTH,Rural,47,266,317,583,Meru,EASTERN,16037
MERU SOUTH,Rural,48,282,307,589,Meru,EASTERN,16038
MERU SOUTH,Rural,49,302,321,623,Meru,EASTERN,16039
MERU SOUTH,Rural,50,411,597,1008,Meru,EASTERN,16040
MERU SOUTH,Rural,51,246,233,479,Meru,EASTERN,16041
MERU SOUTH,Rural,52,271,266,537,Meru,EASTERN,16042
MERU SOUTH,Rural,53,186,211,397,Meru,EASTERN,16043
MERU SOUTH,Rural,54,182,193,375,Meru,EASTERN,16044
MERU SOUTH,Rural,55,313,362,675,Meru,EASTERN,16045
MERU SOUTH,Rural,56,233,199,432,Meru,EASTERN,16046
MERU SOUTH,Rural,57,295,282,577,Meru,EASTERN,16047
MERU SOUTH,Rural,58,150,149,299,Meru,EASTERN,16048
MERU SOUTH,Rural,59,216,208,424,Meru,EASTERN,16049
MERU SOUTH,Rural,60,341,412,753,Meru,EASTERN,16050
MERU SOUTH,Rural,61,191,201,392,Meru,EASTERN,16051
MERU SOUTH,Rural,62,177,178,355,Meru,EASTERN,16052
MERU SOUTH,Rural,63,134,124,258,Meru,EASTERN,16053
MERU SOUTH,Rural,64,130,176,306,Meru,EASTERN,16054
MERU SOUTH,Rural,65,173,187,360,Meru,EASTERN,16055
MERU SOUTH,Rural,66,81,90,171,Meru,EASTERN,16056
MERU SOUTH,Rural,67,178,178,356,Meru,EASTERN,16057
MERU SOUTH,Rural,68,119,106,225,Meru,EASTERN,16058
MERU SOUTH,Rural,69,112,162,274,Meru,EASTERN,16059
MERU SOUTH,Rural,70,242,282,524,Meru,EASTERN,16060
MERU SOUTH,Rural,71,71,89,160,Meru,EASTERN,16061
MERU SOUTH,Rural,72,84,57,141,Meru,EASTERN,16062
MERU SOUTH,Rural,73,84,87,171,Meru,EASTERN,16063
MERU SOUTH,Rural,74,67,106,173,Meru,EASTERN,16064
MERU SOUTH,Rural,75,102,129,231,Meru,EASTERN,16065
MERU SOUTH,Rural,76,57,49,106,Meru,EASTERN,16066
MERU SOUTH,Rural,77,50,62,112,Meru,EASTERN,16067
MERU SOUTH,Rural,78,70,54,124,Meru,EASTERN,16068
MERU SOUTH,Rural,79,91,118,209,Meru,EASTERN,16069
MERU SOUTH,Rural,80+,636,934,1570,Meru,EASTERN,16070
MERU SOUTH,Rural,Age NS,21,14,35,Meru,EASTERN,16071
MAARA,Rural,0,876,870,1746,Meru,EASTERN,16072
MAARA,Rural,1,894,853,1747,Meru,EASTERN,16073
MAARA,Rural,2,916,931,1847,Meru,EASTERN,16074
MAARA,Rural,3,957,943,1900,Meru,EASTERN,16075
MAARA,Rural,4,1002,998,2000,Meru,EASTERN,16076
MAARA,Rural,5,944,977,1921,Meru,EASTERN,16077
MAARA,Rural,6,954,983,1937,Meru,EASTERN,16078
MAARA,Rural,7,953,854,1807,Meru,EASTERN,16079
MAARA,Rural,8,859,894,1753,Meru,EASTERN,16080
MAARA,Rural,9,937,908,1845,Meru,EASTERN,16081
MAARA,Rural,10,911,860,1771,Meru,EASTERN,16082
MAARA,Rural,11,740,754,1494,Meru,EASTERN,16083
MAARA,Rural,12,993,918,1911,Meru,EASTERN,16084
MAARA,Rural,13,930,870,1800,Meru,EASTERN,16085
MAARA,Rural,14,821,796,1617,Meru,EASTERN,16086
MAARA,Rural,15,764,727,1491,Meru,EASTERN,16087
MAARA,Rural,16,695,774,1469,Meru,EASTERN,16088
MAARA,Rural,17,772,767,1539,Meru,EASTERN,16089
MAARA,Rural,18,740,689,1429,Meru,EASTERN,16090
MAARA,Rural,19,633,632,1265,Meru,EASTERN,16091
MAARA,Rural,20,726,797,1523,Meru,EASTERN,16092
MAARA,Rural,21,531,593,1124,Meru,EASTERN,16093
MAARA,Rural,22,601,622,1223,Meru,EASTERN,16094
MAARA,Rural,23,643,612,1255,Meru,EASTERN,16095
MAARA,Rural,24,563,532,1095,Meru,EASTERN,16096
MAARA,Rural,25,731,756,1487,Meru,EASTERN,16097
MAARA,Rural,26,483,554,1037,Meru,EASTERN,16098
MAARA,Rural,27,520,547,1067,Meru,EASTERN,16099
MAARA,Rural,28,477,545,1022,Meru,EASTERN,16100
MAARA,Rural,29,513,555,1068,Meru,EASTERN,16101
MAARA,Rural,30,751,784,1535,Meru,EASTERN,16102
MAARA,Rural,31,496,443,939,Meru,EASTERN,16103
MAARA,Rural,32,482,495,977,Meru,EASTERN,16104
MAARA,Rural,33,370,396,766,Meru,EASTERN,16105
MAARA,Rural,34,468,450,918,Meru,EASTERN,16106
MAARA,Rural,35,698,650,1348,Meru,EASTERN,16107
MAARA,Rural,36,404,421,825,Meru,EASTERN,16108
MAARA,Rural,37,386,378,764,Meru,EASTERN,16109
MAARA,Rural,38,376,409,785,Meru,EASTERN,16110
MAARA,Rural,39,386,392,778,Meru,EASTERN,16111
MAARA,Rural,40,583,548,1131,Meru,EASTERN,16112
MAARA,Rural,41,340,296,636,Meru,EASTERN,16113
MAARA,Rural,42,282,261,543,Meru,EASTERN,16114
MAARA,Rural,43,243,255,498,Meru,EASTERN,16115
MAARA,Rural,44,264,250,514,Meru,EASTERN,16116
MAARA,Rural,45,491,531,1022,Meru,EASTERN,16117
MAARA,Rural,46,352,327,679,Meru,EASTERN,16118
MAARA,Rural,47,282,276,558,Meru,EASTERN,16119
MAARA,Rural,48,289,325,614,Meru,EASTERN,16120
MAARA,Rural,49,334,319,653,Meru,EASTERN,16121
MAARA,Rural,50,456,527,983,Meru,EASTERN,16122
MAARA,Rural,51,257,278,535,Meru,EASTERN,16123
MAARA,Rural,52,299,277,576,Meru,EASTERN,16124
MAARA,Rural,53,231,208,439,Meru,EASTERN,16125
MAARA,Rural,54,220,221,441,Meru,EASTERN,16126
MAARA,Rural,55,334,352,686,Meru,EASTERN,16127
MAARA,Rural,56,259,212,471,Meru,EASTERN,16128
MAARA,Rural,57,330,299,629,Meru,EASTERN,16129
MAARA,Rural,58,177,182,359,Meru,EASTERN,16130
MAARA,Rural,59,213,262,475,Meru,EASTERN,16131
MAARA,Rural,60,370,406,776,Meru,EASTERN,16132
MAARA,Rural,61,165,168,333,Meru,EASTERN,16133
MAARA,Rural,62,172,147,319,Meru,EASTERN,16134
MAARA,Rural,63,130,121,251,Meru,EASTERN,16135
MAARA,Rural,64,157,143,300,Meru,EASTERN,16136
MAARA,Rural,65,170,159,329,Meru,EASTERN,16137
MAARA,Rural,66,90,123,213,Meru,EASTERN,16138
MAARA,Rural,67,148,161,309,Meru,EASTERN,16139
MAARA,Rural,68,91,96,187,Meru,EASTERN,16140
MAARA,Rural,69,121,136,257,Meru,EASTERN,16141
MAARA,Rural,70,207,266,473,Meru,EASTERN,16142
MAARA,Rural,71,70,82,152,Meru,EASTERN,16143
MAARA,Rural,72,92,68,160,Meru,EASTERN,16144
MAARA,Rural,73,94,103,197,Meru,EASTERN,16145
MAARA,Rural,74,86,102,188,Meru,EASTERN,16146
MAARA,Rural,75,86,103,189,Meru,EASTERN,16147
MAARA,Rural,76,64,64,128,Meru,EASTERN,16148
MAARA,Rural,77,66,66,132,Meru,EASTERN,16149
MAARA,Rural,78,55,55,110,Meru,EASTERN,16150
MAARA,Rural,79,93,121,214,Meru,EASTERN,16151
MAARA,Rural,80+,671,923,1594,Meru,EASTERN,16152
MAARA,Rural,Age NS,34,19,53,Meru,EASTERN,16153
IGEMBE,Rural,0,7418,7288,14706,Meru,EASTERN,16154
IGEMBE,Rural,1,6535,6307,12842,Meru,EASTERN,16155
IGEMBE,Rural,2,7627,7312,14939,Meru,EASTERN,16156
IGEMBE,Rural,3,7535,7590,15125,Meru,EASTERN,16157
IGEMBE,Rural,4,7714,7376,15090,Meru,EASTERN,16158
IGEMBE,Rural,5,7837,7545,15382,Meru,EASTERN,16159
IGEMBE,Rural,6,7392,7306,14698,Meru,EASTERN,16160
IGEMBE,Rural,7,6732,6429,13161,Meru,EASTERN,16161
IGEMBE,Rural,8,6375,6399,12774,Meru,EASTERN,16162
IGEMBE,Rural,9,6721,6751,13472,Meru,EASTERN,16163
IGEMBE,Rural,10,7562,7530,15092,Meru,EASTERN,16164
IGEMBE,Rural,11,4843,5123,9966,Meru,EASTERN,16165
IGEMBE,Rural,12,6765,6837,13602,Meru,EASTERN,16166
IGEMBE,Rural,13,6096,6164,12260,Meru,EASTERN,16167
IGEMBE,Rural,14,5433,5496,10929,Meru,EASTERN,16168
IGEMBE,Rural,15,5601,5698,11299,Meru,EASTERN,16169
IGEMBE,Rural,16,4776,5107,9883,Meru,EASTERN,16170
IGEMBE,Rural,17,4553,4770,9323,Meru,EASTERN,16171
IGEMBE,Rural,18,5070,5534,10604,Meru,EASTERN,16172
IGEMBE,Rural,19,3510,3828,7338,Meru,EASTERN,16173
IGEMBE,Rural,20,5678,6881,12559,Meru,EASTERN,16174
IGEMBE,Rural,21,3091,3657,6748,Meru,EASTERN,16175
IGEMBE,Rural,22,3777,4642,8419,Meru,EASTERN,16176
IGEMBE,Rural,23,3498,4258,7756,Meru,EASTERN,16177
IGEMBE,Rural,24,3081,3717,6798,Meru,EASTERN,16178
IGEMBE,Rural,25,6010,6745,12755,Meru,EASTERN,16179
IGEMBE,Rural,26,2917,3313,6230,Meru,EASTERN,16180
IGEMBE,Rural,27,3474,3602,7076,Meru,EASTERN,16181
IGEMBE,Rural,28,2964,3548,6512,Meru,EASTERN,16182
IGEMBE,Rural,29,2622,2563,5185,Meru,EASTERN,16183
IGEMBE,Rural,30,6308,6388,12696,Meru,EASTERN,16184
IGEMBE,Rural,31,2298,1750,4048,Meru,EASTERN,16185
IGEMBE,Rural,32,2620,2522,5142,Meru,EASTERN,16186
IGEMBE,Rural,33,1819,1701,3520,Meru,EASTERN,16187
IGEMBE,Rural,34,2054,1835,3889,Meru,EASTERN,16188
IGEMBE,Rural,35,4427,4267,8694,Meru,EASTERN,16189
IGEMBE,Rural,36,1849,1665,3514,Meru,EASTERN,16190
IGEMBE,Rural,37,1720,1602,3322,Meru,EASTERN,16191
IGEMBE,Rural,38,1724,1874,3598,Meru,EASTERN,16192
IGEMBE,Rural,39,1466,1303,2769,Meru,EASTERN,16193
IGEMBE,Rural,40,3777,4119,7896,Meru,EASTERN,16194
IGEMBE,Rural,41,1061,713,1774,Meru,EASTERN,16195
IGEMBE,Rural,42,1196,969,2165,Meru,EASTERN,16196
IGEMBE,Rural,43,757,624,1381,Meru,EASTERN,16197
IGEMBE,Rural,44,687,617,1304,Meru,EASTERN,16198
IGEMBE,Rural,45,2466,2579,5045,Meru,EASTERN,16199
IGEMBE,Rural,46,1406,1224,2630,Meru,EASTERN,16200
IGEMBE,Rural,47,939,852,1791,Meru,EASTERN,16201
IGEMBE,Rural,48,1008,1078,2086,Meru,EASTERN,16202
IGEMBE,Rural,49,954,864,1818,Meru,EASTERN,16203
IGEMBE,Rural,50,2549,3078,5627,Meru,EASTERN,16204
IGEMBE,Rural,51,580,471,1051,Meru,EASTERN,16205
IGEMBE,Rural,52,935,757,1692,Meru,EASTERN,16206
IGEMBE,Rural,53,533,484,1017,Meru,EASTERN,16207
IGEMBE,Rural,54,680,579,1259,Meru,EASTERN,16208
IGEMBE,Rural,55,1546,1493,3039,Meru,EASTERN,16209
IGEMBE,Rural,56,701,452,1153,Meru,EASTERN,16210
IGEMBE,Rural,57,836,510,1346,Meru,EASTERN,16211
IGEMBE,Rural,58,486,400,886,Meru,EASTERN,16212
IGEMBE,Rural,59,569,514,1083,Meru,EASTERN,16213
IGEMBE,Rural,60,2159,2292,4451,Meru,EASTERN,16214
IGEMBE,Rural,61,346,299,645,Meru,EASTERN,16215
IGEMBE,Rural,62,461,388,849,Meru,EASTERN,16216
IGEMBE,Rural,63,254,187,441,Meru,EASTERN,16217
IGEMBE,Rural,64,317,328,645,Meru,EASTERN,16218
IGEMBE,Rural,65,811,854,1665,Meru,EASTERN,16219
IGEMBE,Rural,66,171,154,325,Meru,EASTERN,16220
IGEMBE,Rural,67,401,268,669,Meru,EASTERN,16221
IGEMBE,Rural,68,258,273,531,Meru,EASTERN,16222
IGEMBE,Rural,69,328,369,697,Meru,EASTERN,16223
IGEMBE,Rural,70,1204,1555,2759,Meru,EASTERN,16224
IGEMBE,Rural,71,139,138,277,Meru,EASTERN,16225
IGEMBE,Rural,72,269,218,487,Meru,EASTERN,16226
IGEMBE,Rural,73,176,109,285,Meru,EASTERN,16227
IGEMBE,Rural,74,179,158,337,Meru,EASTERN,16228
IGEMBE,Rural,75,478,527,1005,Meru,EASTERN,16229
IGEMBE,Rural,76,133,155,288,Meru,EASTERN,16230
IGEMBE,Rural,77,142,154,296,Meru,EASTERN,16231
IGEMBE,Rural,78,184,158,342,Meru,EASTERN,16232
IGEMBE,Rural,79,204,190,394,Meru,EASTERN,16233
IGEMBE,Rural,80+,1978,3061,5039,Meru,EASTERN,16234
IGEMBE,Rural,Age NS,200,151,351,Meru,EASTERN,16235
TIGANIA,Rural,0,4465,4535,9000,Meru,EASTERN,16236
TIGANIA,Rural,1,4188,4114,8302,Meru,EASTERN,16237
TIGANIA,Rural,2,4693,4496,9189,Meru,EASTERN,16238
TIGANIA,Rural,3,4668,4837,9505,Meru,EASTERN,16239
TIGANIA,Rural,4,4797,4680,9477,Meru,EASTERN,16240
TIGANIA,Rural,5,5111,4759,9870,Meru,EASTERN,16241
TIGANIA,Rural,6,4597,4616,9213,Meru,EASTERN,16242
TIGANIA,Rural,7,4285,4319,8604,Meru,EASTERN,16243
TIGANIA,Rural,8,3993,3951,7944,Meru,EASTERN,16244
TIGANIA,Rural,9,4266,4387,8653,Meru,EASTERN,16245
TIGANIA,Rural,10,4805,4651,9456,Meru,EASTERN,16246
TIGANIA,Rural,11,3145,3169,6314,Meru,EASTERN,16247
TIGANIA,Rural,12,4459,4353,8812,Meru,EASTERN,16248
TIGANIA,Rural,13,4061,4004,8065,Meru,EASTERN,16249
TIGANIA,Rural,14,3591,3721,7312,Meru,EASTERN,16250
TIGANIA,Rural,15,3448,3522,6970,Meru,EASTERN,16251
TIGANIA,Rural,16,2918,3307,6225,Meru,EASTERN,16252
TIGANIA,Rural,17,2902,3133,6035,Meru,EASTERN,16253
TIGANIA,Rural,18,3065,3091,6156,Meru,EASTERN,16254
TIGANIA,Rural,19,2288,2241,4529,Meru,EASTERN,16255
TIGANIA,Rural,20,2974,3546,6520,Meru,EASTERN,16256
TIGANIA,Rural,21,1879,2150,4029,Meru,EASTERN,16257
TIGANIA,Rural,22,1994,2723,4717,Meru,EASTERN,16258
TIGANIA,Rural,23,1912,2640,4552,Meru,EASTERN,16259
TIGANIA,Rural,24,1647,2246,3893,Meru,EASTERN,16260
TIGANIA,Rural,25,2999,3794,6793,Meru,EASTERN,16261
TIGANIA,Rural,26,1613,2124,3737,Meru,EASTERN,16262
TIGANIA,Rural,27,1807,2212,4019,Meru,EASTERN,16263
TIGANIA,Rural,28,1664,2154,3818,Meru,EASTERN,16264
TIGANIA,Rural,29,1546,1680,3226,Meru,EASTERN,16265
TIGANIA,Rural,30,2968,3714,6682,Meru,EASTERN,16266
TIGANIA,Rural,31,1329,1322,2651,Meru,EASTERN,16267
TIGANIA,Rural,32,1545,1719,3264,Meru,EASTERN,16268
TIGANIA,Rural,33,1202,1186,2388,Meru,EASTERN,16269
TIGANIA,Rural,34,1180,1172,2352,Meru,EASTERN,16270
TIGANIA,Rural,35,2362,2597,4959,Meru,EASTERN,16271
TIGANIA,Rural,36,1182,1308,2490,Meru,EASTERN,16272
TIGANIA,Rural,37,1104,1211,2315,Meru,EASTERN,16273
TIGANIA,Rural,38,1012,1372,2384,Meru,EASTERN,16274
TIGANIA,Rural,39,940,985,1925,Meru,EASTERN,16275
TIGANIA,Rural,40,1990,2775,4765,Meru,EASTERN,16276
TIGANIA,Rural,41,750,648,1398,Meru,EASTERN,16277
TIGANIA,Rural,42,790,707,1497,Meru,EASTERN,16278
TIGANIA,Rural,43,537,565,1102,Meru,EASTERN,16279
TIGANIA,Rural,44,555,555,1110,Meru,EASTERN,16280
TIGANIA,Rural,45,1544,1850,3394,Meru,EASTERN,16281
TIGANIA,Rural,46,869,935,1804,Meru,EASTERN,16282
TIGANIA,Rural,47,760,845,1605,Meru,EASTERN,16283
TIGANIA,Rural,48,722,965,1687,Meru,EASTERN,16284
TIGANIA,Rural,49,668,659,1327,Meru,EASTERN,16285
TIGANIA,Rural,50,1606,2341,3947,Meru,EASTERN,16286
TIGANIA,Rural,51,556,507,1063,Meru,EASTERN,16287
TIGANIA,Rural,52,607,634,1241,Meru,EASTERN,16288
TIGANIA,Rural,53,470,477,947,Meru,EASTERN,16289
TIGANIA,Rural,54,478,496,974,Meru,EASTERN,16290
TIGANIA,Rural,55,949,1077,2026,Meru,EASTERN,16291
TIGANIA,Rural,56,596,570,1166,Meru,EASTERN,16292
TIGANIA,Rural,57,686,557,1243,Meru,EASTERN,16293
TIGANIA,Rural,58,438,443,881,Meru,EASTERN,16294
TIGANIA,Rural,59,471,463,934,Meru,EASTERN,16295
TIGANIA,Rural,60,1252,1644,2896,Meru,EASTERN,16296
TIGANIA,Rural,61,409,331,740,Meru,EASTERN,16297
TIGANIA,Rural,62,531,548,1079,Meru,EASTERN,16298
TIGANIA,Rural,63,281,255,536,Meru,EASTERN,16299
TIGANIA,Rural,64,288,353,641,Meru,EASTERN,16300
TIGANIA,Rural,65,564,801,1365,Meru,EASTERN,16301
TIGANIA,Rural,66,169,163,332,Meru,EASTERN,16302
TIGANIA,Rural,67,321,261,582,Meru,EASTERN,16303
TIGANIA,Rural,68,308,275,583,Meru,EASTERN,16304
TIGANIA,Rural,69,283,313,596,Meru,EASTERN,16305
TIGANIA,Rural,70,834,1163,1997,Meru,EASTERN,16306
TIGANIA,Rural,71,148,169,317,Meru,EASTERN,16307
TIGANIA,Rural,72,235,188,423,Meru,EASTERN,16308
TIGANIA,Rural,73,160,181,341,Meru,EASTERN,16309
TIGANIA,Rural,74,152,179,331,Meru,EASTERN,16310
TIGANIA,Rural,75,348,430,778,Meru,EASTERN,16311
TIGANIA,Rural,76,204,128,332,Meru,EASTERN,16312
TIGANIA,Rural,77,153,231,384,Meru,EASTERN,16313
TIGANIA,Rural,78,148,154,302,Meru,EASTERN,16314
TIGANIA,Rural,79,177,242,419,Meru,EASTERN,16315
TIGANIA,Rural,80+,1628,2282,3910,Meru,EASTERN,16316
TIGANIA,Rural,Age NS,132,115,247,Meru,EASTERN,16317
THARAKA,Rural,0,2008,1950,3958,Tharaka Nithi,EASTERN,16318
THARAKA,Rural,1,1913,1788,3701,Tharaka Nithi,EASTERN,16319
THARAKA,Rural,2,2032,1963,3995,Tharaka Nithi,EASTERN,16320
THARAKA,Rural,3,1992,2003,3995,Tharaka Nithi,EASTERN,16321
THARAKA,Rural,4,1928,1919,3847,Tharaka Nithi,EASTERN,16322
THARAKA,Rural,5,2035,1938,3973,Tharaka Nithi,EASTERN,16323
THARAKA,Rural,6,1865,1935,3800,Tharaka Nithi,EASTERN,16324
THARAKA,Rural,7,1799,1745,3544,Tharaka Nithi,EASTERN,16325
THARAKA,Rural,8,1758,1754,3512,Tharaka Nithi,EASTERN,16326
THARAKA,Rural,9,1723,1704,3427,Tharaka Nithi,EASTERN,16327
THARAKA,Rural,10,1831,1797,3628,Tharaka Nithi,EASTERN,16328
THARAKA,Rural,11,1285,1302,2587,Tharaka Nithi,EASTERN,16329
THARAKA,Rural,12,1680,1601,3281,Tharaka Nithi,EASTERN,16330
THARAKA,Rural,13,1695,1552,3247,Tharaka Nithi,EASTERN,16331
THARAKA,Rural,14,1449,1532,2981,Tharaka Nithi,EASTERN,16332
THARAKA,Rural,15,1535,1563,3098,Tharaka Nithi,EASTERN,16333
THARAKA,Rural,16,1308,1408,2716,Tharaka Nithi,EASTERN,16334
THARAKA,Rural,17,1339,1302,2641,Tharaka Nithi,EASTERN,16335
THARAKA,Rural,18,1241,1322,2563,Tharaka Nithi,EASTERN,16336
THARAKA,Rural,19,1130,1105,2235,Tharaka Nithi,EASTERN,16337
THARAKA,Rural,20,1311,1537,2848,Tharaka Nithi,EASTERN,16338
THARAKA,Rural,21,879,913,1792,Tharaka Nithi,EASTERN,16339
THARAKA,Rural,22,882,1087,1969,Tharaka Nithi,EASTERN,16340
THARAKA,Rural,23,923,1133,2056,Tharaka Nithi,EASTERN,16341
THARAKA,Rural,24,714,983,1697,Tharaka Nithi,EASTERN,16342
THARAKA,Rural,25,1154,1531,2685,Tharaka Nithi,EASTERN,16343
THARAKA,Rural,26,737,894,1631,Tharaka Nithi,EASTERN,16344
THARAKA,Rural,27,797,1001,1798,Tharaka Nithi,EASTERN,16345
THARAKA,Rural,28,701,919,1620,Tharaka Nithi,EASTERN,16346
THARAKA,Rural,29,704,899,1603,Tharaka Nithi,EASTERN,16347
THARAKA,Rural,30,1159,1438,2597,Tharaka Nithi,EASTERN,16348
THARAKA,Rural,31,577,648,1225,Tharaka Nithi,EASTERN,16349
THARAKA,Rural,32,710,819,1529,Tharaka Nithi,EASTERN,16350
THARAKA,Rural,33,533,609,1142,Tharaka Nithi,EASTERN,16351
THARAKA,Rural,34,596,700,1296,Tharaka Nithi,EASTERN,16352
THARAKA,Rural,35,927,1022,1949,Tharaka Nithi,EASTERN,16353
THARAKA,Rural,36,566,605,1171,Tharaka Nithi,EASTERN,16354
THARAKA,Rural,37,469,523,992,Tharaka Nithi,EASTERN,16355
THARAKA,Rural,38,473,588,1061,Tharaka Nithi,EASTERN,16356
THARAKA,Rural,39,449,480,929,Tharaka Nithi,EASTERN,16357
THARAKA,Rural,40,748,921,1669,Tharaka Nithi,EASTERN,16358
THARAKA,Rural,41,358,341,699,Tharaka Nithi,EASTERN,16359
THARAKA,Rural,42,333,323,656,Tharaka Nithi,EASTERN,16360
THARAKA,Rural,43,233,283,516,Tharaka Nithi,EASTERN,16361
THARAKA,Rural,44,290,286,576,Tharaka Nithi,EASTERN,16362
THARAKA,Rural,45,589,662,1251,Tharaka Nithi,EASTERN,16363
THARAKA,Rural,46,365,365,730,Tharaka Nithi,EASTERN,16364
THARAKA,Rural,47,269,308,577,Tharaka Nithi,EASTERN,16365
THARAKA,Rural,48,361,481,842,Tharaka Nithi,EASTERN,16366
THARAKA,Rural,49,277,312,589,Tharaka Nithi,EASTERN,16367
THARAKA,Rural,50,563,677,1240,Tharaka Nithi,EASTERN,16368
THARAKA,Rural,51,287,270,557,Tharaka Nithi,EASTERN,16369
THARAKA,Rural,52,290,235,525,Tharaka Nithi,EASTERN,16370
THARAKA,Rural,53,181,195,376,Tharaka Nithi,EASTERN,16371
THARAKA,Rural,54,190,202,392,Tharaka Nithi,EASTERN,16372
THARAKA,Rural,55,263,325,588,Tharaka Nithi,EASTERN,16373
THARAKA,Rural,56,204,178,382,Tharaka Nithi,EASTERN,16374
THARAKA,Rural,57,291,313,604,Tharaka Nithi,EASTERN,16375
THARAKA,Rural,58,155,176,331,Tharaka Nithi,EASTERN,16376
THARAKA,Rural,59,177,227,404,Tharaka Nithi,EASTERN,16377
THARAKA,Rural,60,445,549,994,Tharaka Nithi,EASTERN,16378
THARAKA,Rural,61,270,310,580,Tharaka Nithi,EASTERN,16379
THARAKA,Rural,62,138,158,296,Tharaka Nithi,EASTERN,16380
THARAKA,Rural,63,115,122,237,Tharaka Nithi,EASTERN,16381
THARAKA,Rural,64,111,160,271,Tharaka Nithi,EASTERN,16382
THARAKA,Rural,65,181,237,418,Tharaka Nithi,EASTERN,16383
THARAKA,Rural,66,84,77,161,Tharaka Nithi,EASTERN,16384
THARAKA,Rural,67,125,115,240,Tharaka Nithi,EASTERN,16385
THARAKA,Rural,68,138,125,263,Tharaka Nithi,EASTERN,16386
THARAKA,Rural,69,129,225,354,Tharaka Nithi,EASTERN,16387
THARAKA,Rural,70,244,339,583,Tharaka Nithi,EASTERN,16388
THARAKA,Rural,71,91,116,207,Tharaka Nithi,EASTERN,16389
THARAKA,Rural,72,85,86,171,Tharaka Nithi,EASTERN,16390
THARAKA,Rural,73,63,82,145,Tharaka Nithi,EASTERN,16391
THARAKA,Rural,74,66,57,123,Tharaka Nithi,EASTERN,16392
THARAKA,Rural,75,99,143,242,Tharaka Nithi,EASTERN,16393
THARAKA,Rural,76,68,67,135,Tharaka Nithi,EASTERN,16394
THARAKA,Rural,77,88,93,181,Tharaka Nithi,EASTERN,16395
THARAKA,Rural,78,78,77,155,Tharaka Nithi,EASTERN,16396
THARAKA,Rural,79,98,124,222,Tharaka Nithi,EASTERN,16397
THARAKA,Rural,80+,707,992,1699,Tharaka Nithi,EASTERN,16398
THARAKA,Rural,Age NS,37,26,63,Tharaka Nithi,EASTERN,16399
EMBU,Rural,0,2365,2361,4726,Embu,EASTERN,16400
EMBU,Rural,1,2202,2166,4368,Embu,EASTERN,16401
EMBU,Rural,2,2537,2442,4979,Embu,EASTERN,16402
EMBU,Rural,3,2654,2596,5250,Embu,EASTERN,16403
EMBU,Rural,4,2601,2618,5219,Embu,EASTERN,16404
EMBU,Rural,5,2790,2769,5559,Embu,EASTERN,16405
EMBU,Rural,6,2564,2534,5098,Embu,EASTERN,16406
EMBU,Rural,7,2575,2578,5153,Embu,EASTERN,16407
EMBU,Rural,8,2556,2508,5064,Embu,EASTERN,16408
EMBU,Rural,9,2921,2834,5755,Embu,EASTERN,16409
EMBU,Rural,10,2728,2699,5427,Embu,EASTERN,16410
EMBU,Rural,11,2325,2240,4565,Embu,EASTERN,16411
EMBU,Rural,12,2837,2825,5662,Embu,EASTERN,16412
EMBU,Rural,13,2708,2634,5342,Embu,EASTERN,16413
EMBU,Rural,14,2400,2359,4759,Embu,EASTERN,16414
EMBU,Rural,15,2252,2141,4393,Embu,EASTERN,16415
EMBU,Rural,16,2157,2095,4252,Embu,EASTERN,16416
EMBU,Rural,17,2248,2168,4416,Embu,EASTERN,16417
EMBU,Rural,18,2404,1936,4340,Embu,EASTERN,16418
EMBU,Rural,19,1887,1718,3605,Embu,EASTERN,16419
EMBU,Rural,20,2132,1977,4109,Embu,EASTERN,16420
EMBU,Rural,21,1585,1642,3227,Embu,EASTERN,16421
EMBU,Rural,22,1796,1870,3666,Embu,EASTERN,16422
EMBU,Rural,23,1735,1902,3637,Embu,EASTERN,16423
EMBU,Rural,24,1660,1734,3394,Embu,EASTERN,16424
EMBU,Rural,25,2046,2183,4229,Embu,EASTERN,16425
EMBU,Rural,26,1540,1763,3303,Embu,EASTERN,16426
EMBU,Rural,27,1723,1745,3468,Embu,EASTERN,16427
EMBU,Rural,28,1605,1805,3410,Embu,EASTERN,16428
EMBU,Rural,29,1586,1689,3275,Embu,EASTERN,16429
EMBU,Rural,30,2380,2545,4925,Embu,EASTERN,16430
EMBU,Rural,31,1355,1343,2698,Embu,EASTERN,16431
EMBU,Rural,32,1511,1697,3208,Embu,EASTERN,16432
EMBU,Rural,33,1207,1287,2494,Embu,EASTERN,16433
EMBU,Rural,34,1375,1370,2745,Embu,EASTERN,16434
EMBU,Rural,35,1926,2109,4035,Embu,EASTERN,16435
EMBU,Rural,36,1149,1283,2432,Embu,EASTERN,16436
EMBU,Rural,37,1160,1121,2281,Embu,EASTERN,16437
EMBU,Rural,38,1262,1376,2638,Embu,EASTERN,16438
EMBU,Rural,39,1147,1174,2321,Embu,EASTERN,16439
EMBU,Rural,40,1758,1878,3636,Embu,EASTERN,16440
EMBU,Rural,41,1000,983,1983,Embu,EASTERN,16441
EMBU,Rural,42,1040,1047,2087,Embu,EASTERN,16442
EMBU,Rural,43,841,946,1787,Embu,EASTERN,16443
EMBU,Rural,44,847,869,1716,Embu,EASTERN,16444
EMBU,Rural,45,1513,1660,3173,Embu,EASTERN,16445
EMBU,Rural,46,1164,1220,2384,Embu,EASTERN,16446
EMBU,Rural,47,827,885,1712,Embu,EASTERN,16447
EMBU,Rural,48,821,890,1711,Embu,EASTERN,16448
EMBU,Rural,49,944,942,1886,Embu,EASTERN,16449
EMBU,Rural,50,1218,1606,2824,Embu,EASTERN,16450
EMBU,Rural,51,657,634,1291,Embu,EASTERN,16451
EMBU,Rural,52,664,655,1319,Embu,EASTERN,16452
EMBU,Rural,53,455,442,897,Embu,EASTERN,16453
EMBU,Rural,54,466,461,927,Embu,EASTERN,16454
EMBU,Rural,55,808,918,1726,Embu,EASTERN,16455
EMBU,Rural,56,629,573,1202,Embu,EASTERN,16456
EMBU,Rural,57,753,659,1412,Embu,EASTERN,16457
EMBU,Rural,58,384,408,792,Embu,EASTERN,16458
EMBU,Rural,59,507,529,1036,Embu,EASTERN,16459
EMBU,Rural,60,909,1195,2104,Embu,EASTERN,16460
EMBU,Rural,61,431,450,881,Embu,EASTERN,16461
EMBU,Rural,62,385,352,737,Embu,EASTERN,16462
EMBU,Rural,63,328,320,648,Embu,EASTERN,16463
EMBU,Rural,64,291,385,676,Embu,EASTERN,16464
EMBU,Rural,65,484,671,1155,Embu,EASTERN,16465
EMBU,Rural,66,240,224,464,Embu,EASTERN,16466
EMBU,Rural,67,344,337,681,Embu,EASTERN,16467
EMBU,Rural,68,193,266,459,Embu,EASTERN,16468
EMBU,Rural,69,270,343,613,Embu,EASTERN,16469
EMBU,Rural,70,508,823,1331,Embu,EASTERN,16470
EMBU,Rural,71,208,238,446,Embu,EASTERN,16471
EMBU,Rural,72,204,178,382,Embu,EASTERN,16472
EMBU,Rural,73,241,227,468,Embu,EASTERN,16473
EMBU,Rural,74,213,220,433,Embu,EASTERN,16474
EMBU,Rural,75,284,342,626,Embu,EASTERN,16475
EMBU,Rural,76,177,163,340,Embu,EASTERN,16476
EMBU,Rural,77,149,175,324,Embu,EASTERN,16477
EMBU,Rural,78,148,173,321,Embu,EASTERN,16478
EMBU,Rural,79,194,250,444,Embu,EASTERN,16479
EMBU,Rural,80+,1548,2634,4182,Embu,EASTERN,16480
EMBU,Rural,Age NS,72,67,139,Embu,EASTERN,16481
MBEERE,Rural,0,3209,3153,6362,Embu,EASTERN,16482
MBEERE,Rural,1,3116,3057,6173,Embu,EASTERN,16483
MBEERE,Rural,2,3180,3146,6326,Embu,EASTERN,16484
MBEERE,Rural,3,3382,3245,6627,Embu,EASTERN,16485
MBEERE,Rural,4,3358,3287,6645,Embu,EASTERN,16486
MBEERE,Rural,5,3433,3316,6749,Embu,EASTERN,16487
MBEERE,Rural,6,3408,3217,6625,Embu,EASTERN,16488
MBEERE,Rural,7,3148,3040,6188,Embu,EASTERN,16489
MBEERE,Rural,8,2789,2799,5588,Embu,EASTERN,16490
MBEERE,Rural,9,3001,2946,5947,Embu,EASTERN,16491
MBEERE,Rural,10,3090,3102,6192,Embu,EASTERN,16492
MBEERE,Rural,11,2330,2460,4790,Embu,EASTERN,16493
MBEERE,Rural,12,2896,2853,5749,Embu,EASTERN,16494
MBEERE,Rural,13,2892,2940,5832,Embu,EASTERN,16495
MBEERE,Rural,14,2684,2565,5249,Embu,EASTERN,16496
MBEERE,Rural,15,2593,2416,5009,Embu,EASTERN,16497
MBEERE,Rural,16,2474,2192,4666,Embu,EASTERN,16498
MBEERE,Rural,17,2567,2158,4725,Embu,EASTERN,16499
MBEERE,Rural,18,2643,2057,4700,Embu,EASTERN,16500
MBEERE,Rural,19,2303,1942,4245,Embu,EASTERN,16501
MBEERE,Rural,20,2305,2163,4468,Embu,EASTERN,16502
MBEERE,Rural,21,1680,1668,3348,Embu,EASTERN,16503
MBEERE,Rural,22,1832,1812,3644,Embu,EASTERN,16504
MBEERE,Rural,23,1788,1913,3701,Embu,EASTERN,16505
MBEERE,Rural,24,1440,1509,2949,Embu,EASTERN,16506
MBEERE,Rural,25,1973,2067,4040,Embu,EASTERN,16507
MBEERE,Rural,26,1461,1560,3021,Embu,EASTERN,16508
MBEERE,Rural,27,1497,1607,3104,Embu,EASTERN,16509
MBEERE,Rural,28,1370,1610,2980,Embu,EASTERN,16510
MBEERE,Rural,29,1415,1510,2925,Embu,EASTERN,16511
MBEERE,Rural,30,1929,2106,4035,Embu,EASTERN,16512
MBEERE,Rural,31,1189,1197,2386,Embu,EASTERN,16513
MBEERE,Rural,32,1273,1380,2653,Embu,EASTERN,16514
MBEERE,Rural,33,1004,1114,2118,Embu,EASTERN,16515
MBEERE,Rural,34,1140,1140,2280,Embu,EASTERN,16516
MBEERE,Rural,35,1645,1740,3385,Embu,EASTERN,16517
MBEERE,Rural,36,1023,1055,2078,Embu,EASTERN,16518
MBEERE,Rural,37,942,988,1930,Embu,EASTERN,16519
MBEERE,Rural,38,894,1148,2042,Embu,EASTERN,16520
MBEERE,Rural,39,892,958,1850,Embu,EASTERN,16521
MBEERE,Rural,40,1269,1591,2860,Embu,EASTERN,16522
MBEERE,Rural,41,758,899,1657,Embu,EASTERN,16523
MBEERE,Rural,42,725,793,1518,Embu,EASTERN,16524
MBEERE,Rural,43,628,732,1360,Embu,EASTERN,16525
MBEERE,Rural,44,616,657,1273,Embu,EASTERN,16526
MBEERE,Rural,45,1055,1257,2312,Embu,EASTERN,16527
MBEERE,Rural,46,871,926,1797,Embu,EASTERN,16528
MBEERE,Rural,47,621,773,1394,Embu,EASTERN,16529
MBEERE,Rural,48,530,699,1229,Embu,EASTERN,16530
MBEERE,Rural,49,630,689,1319,Embu,EASTERN,16531
MBEERE,Rural,50,864,1170,2034,Embu,EASTERN,16532
MBEERE,Rural,51,563,558,1121,Embu,EASTERN,16533
MBEERE,Rural,52,516,580,1096,Embu,EASTERN,16534
MBEERE,Rural,53,392,439,831,Embu,EASTERN,16535
MBEERE,Rural,54,384,480,864,Embu,EASTERN,16536
MBEERE,Rural,55,672,766,1438,Embu,EASTERN,16537
MBEERE,Rural,56,479,489,968,Embu,EASTERN,16538
MBEERE,Rural,57,668,660,1328,Embu,EASTERN,16539
MBEERE,Rural,58,340,391,731,Embu,EASTERN,16540
MBEERE,Rural,59,362,517,879,Embu,EASTERN,16541
MBEERE,Rural,60,673,920,1593,Embu,EASTERN,16542
MBEERE,Rural,61,342,400,742,Embu,EASTERN,16543
MBEERE,Rural,62,321,304,625,Embu,EASTERN,16544
MBEERE,Rural,63,279,260,539,Embu,EASTERN,16545
MBEERE,Rural,64,294,351,645,Embu,EASTERN,16546
MBEERE,Rural,65,415,494,909,Embu,EASTERN,16547
MBEERE,Rural,66,154,171,325,Embu,EASTERN,16548
MBEERE,Rural,67,284,272,556,Embu,EASTERN,16549
MBEERE,Rural,68,214,205,419,Embu,EASTERN,16550
MBEERE,Rural,69,225,366,591,Embu,EASTERN,16551
MBEERE,Rural,70,531,724,1255,Embu,EASTERN,16552
MBEERE,Rural,71,162,211,373,Embu,EASTERN,16553
MBEERE,Rural,72,188,169,357,Embu,EASTERN,16554
MBEERE,Rural,73,216,180,396,Embu,EASTERN,16555
MBEERE,Rural,74,198,225,423,Embu,EASTERN,16556
MBEERE,Rural,75,251,298,549,Embu,EASTERN,16557
MBEERE,Rural,76,134,126,260,Embu,EASTERN,16558
MBEERE,Rural,77,136,97,233,Embu,EASTERN,16559
MBEERE,Rural,78,140,142,282,Embu,EASTERN,16560
MBEERE,Rural,79,177,288,465,Embu,EASTERN,16561
MBEERE,Rural,80+,1423,2137,3560,Embu,EASTERN,16562
MBEERE,Rural,Age NS,44,35,79,Embu,EASTERN,16563
KITUI,Rural,0,5089,4997,10086,Kitui,EASTERN,16564
KITUI,Rural,1,4788,4650,9438,Kitui,EASTERN,16565
KITUI,Rural,2,5279,5081,10360,Kitui,EASTERN,16566
KITUI,Rural,3,4934,5062,9996,Kitui,EASTERN,16567
KITUI,Rural,4,5271,5138,10409,Kitui,EASTERN,16568
KITUI,Rural,5,5577,5164,10741,Kitui,EASTERN,16569
KITUI,Rural,6,5366,5318,10684,Kitui,EASTERN,16570
KITUI,Rural,7,5305,5272,10577,Kitui,EASTERN,16571
KITUI,Rural,8,5036,5079,10115,Kitui,EASTERN,16572
KITUI,Rural,9,5131,5045,10176,Kitui,EASTERN,16573
KITUI,Rural,10,5621,5311,10932,Kitui,EASTERN,16574
KITUI,Rural,11,4265,4357,8622,Kitui,EASTERN,16575
KITUI,Rural,12,5254,4833,10087,Kitui,EASTERN,16576
KITUI,Rural,13,5260,5069,10329,Kitui,EASTERN,16577
KITUI,Rural,14,4728,4532,9260,Kitui,EASTERN,16578
KITUI,Rural,15,4758,4633,9391,Kitui,EASTERN,16579
KITUI,Rural,16,4163,4071,8234,Kitui,EASTERN,16580
KITUI,Rural,17,4534,4200,8734,Kitui,EASTERN,16581
KITUI,Rural,18,4122,3503,7625,Kitui,EASTERN,16582
KITUI,Rural,19,3412,3019,6431,Kitui,EASTERN,16583
KITUI,Rural,20,2798,2896,5694,Kitui,EASTERN,16584
KITUI,Rural,21,2040,2202,4242,Kitui,EASTERN,16585
KITUI,Rural,22,1985,2426,4411,Kitui,EASTERN,16586
KITUI,Rural,23,1733,2401,4134,Kitui,EASTERN,16587
KITUI,Rural,24,1444,2050,3494,Kitui,EASTERN,16588
KITUI,Rural,25,1762,2680,4442,Kitui,EASTERN,16589
KITUI,Rural,26,1309,1997,3306,Kitui,EASTERN,16590
KITUI,Rural,27,1556,2193,3749,Kitui,EASTERN,16591
KITUI,Rural,28,1246,1951,3197,Kitui,EASTERN,16592
KITUI,Rural,29,1482,2129,3611,Kitui,EASTERN,16593
KITUI,Rural,30,1790,2815,4605,Kitui,EASTERN,16594
KITUI,Rural,31,1341,1657,2998,Kitui,EASTERN,16595
KITUI,Rural,32,1249,1912,3161,Kitui,EASTERN,16596
KITUI,Rural,33,1102,1666,2768,Kitui,EASTERN,16597
KITUI,Rural,34,1212,1836,3048,Kitui,EASTERN,16598
KITUI,Rural,35,1935,2797,4732,Kitui,EASTERN,16599
KITUI,Rural,36,1136,1494,2630,Kitui,EASTERN,16600
KITUI,Rural,37,1164,1501,2665,Kitui,EASTERN,16601
KITUI,Rural,38,1007,1399,2406,Kitui,EASTERN,16602
KITUI,Rural,39,1134,1547,2681,Kitui,EASTERN,16603
KITUI,Rural,40,1382,2243,3625,Kitui,EASTERN,16604
KITUI,Rural,41,989,1324,2313,Kitui,EASTERN,16605
KITUI,Rural,42,889,1087,1976,Kitui,EASTERN,16606
KITUI,Rural,43,646,919,1565,Kitui,EASTERN,16607
KITUI,Rural,44,800,928,1728,Kitui,EASTERN,16608
KITUI,Rural,45,1211,1600,2811,Kitui,EASTERN,16609
KITUI,Rural,46,958,1209,2167,Kitui,EASTERN,16610
KITUI,Rural,47,702,1018,1720,Kitui,EASTERN,16611
KITUI,Rural,48,648,955,1603,Kitui,EASTERN,16612
KITUI,Rural,49,772,1145,1917,Kitui,EASTERN,16613
KITUI,Rural,50,1010,1544,2554,Kitui,EASTERN,16614
KITUI,Rural,51,717,889,1606,Kitui,EASTERN,16615
KITUI,Rural,52,724,758,1482,Kitui,EASTERN,16616
KITUI,Rural,53,577,727,1304,Kitui,EASTERN,16617
KITUI,Rural,54,601,684,1285,Kitui,EASTERN,16618
KITUI,Rural,55,699,965,1664,Kitui,EASTERN,16619
KITUI,Rural,56,671,619,1290,Kitui,EASTERN,16620
KITUI,Rural,57,917,1006,1923,Kitui,EASTERN,16621
KITUI,Rural,58,425,616,1041,Kitui,EASTERN,16622
KITUI,Rural,59,613,1019,1632,Kitui,EASTERN,16623
KITUI,Rural,60,896,1379,2275,Kitui,EASTERN,16624
KITUI,Rural,61,537,684,1221,Kitui,EASTERN,16625
KITUI,Rural,62,436,446,882,Kitui,EASTERN,16626
KITUI,Rural,63,594,977,1571,Kitui,EASTERN,16627
KITUI,Rural,64,461,716,1177,Kitui,EASTERN,16628
KITUI,Rural,65,559,691,1250,Kitui,EASTERN,16629
KITUI,Rural,66,313,277,590,Kitui,EASTERN,16630
KITUI,Rural,67,425,490,915,Kitui,EASTERN,16631
KITUI,Rural,68,328,382,710,Kitui,EASTERN,16632
KITUI,Rural,69,420,636,1056,Kitui,EASTERN,16633
KITUI,Rural,70,723,1029,1752,Kitui,EASTERN,16634
KITUI,Rural,71,289,322,611,Kitui,EASTERN,16635
KITUI,Rural,72,306,242,548,Kitui,EASTERN,16636
KITUI,Rural,73,304,328,632,Kitui,EASTERN,16637
KITUI,Rural,74,405,521,926,Kitui,EASTERN,16638
KITUI,Rural,75,320,352,672,Kitui,EASTERN,16639
KITUI,Rural,76,246,188,434,Kitui,EASTERN,16640
KITUI,Rural,77,205,176,381,Kitui,EASTERN,16641
KITUI,Rural,78,190,203,393,Kitui,EASTERN,16642
KITUI,Rural,79,331,503,834,Kitui,EASTERN,16643
KITUI,Rural,80+,2828,4054,6882,Kitui,EASTERN,16644
KITUI,Rural,Age NS,61,68,129,Kitui,EASTERN,16645
MUTOMO,Rural,0,3204,3210,6414,Kitui,EASTERN,16646
MUTOMO,Rural,1,2866,2851,5717,Kitui,EASTERN,16647
MUTOMO,Rural,2,3324,3397,6721,Kitui,EASTERN,16648
MUTOMO,Rural,3,3239,3029,6268,Kitui,EASTERN,16649
MUTOMO,Rural,4,3046,2828,5874,Kitui,EASTERN,16650
MUTOMO,Rural,5,3364,3273,6637,Kitui,EASTERN,16651
MUTOMO,Rural,6,3425,3252,6677,Kitui,EASTERN,16652
MUTOMO,Rural,7,3210,3155,6365,Kitui,EASTERN,16653
MUTOMO,Rural,8,3091,3026,6117,Kitui,EASTERN,16654
MUTOMO,Rural,9,2908,2832,5740,Kitui,EASTERN,16655
MUTOMO,Rural,10,3026,2978,6004,Kitui,EASTERN,16656
MUTOMO,Rural,11,2322,2233,4555,Kitui,EASTERN,16657
MUTOMO,Rural,12,2615,2526,5141,Kitui,EASTERN,16658
MUTOMO,Rural,13,2657,2551,5208,Kitui,EASTERN,16659
MUTOMO,Rural,14,2408,2308,4716,Kitui,EASTERN,16660
MUTOMO,Rural,15,2457,2368,4825,Kitui,EASTERN,16661
MUTOMO,Rural,16,2091,1987,4078,Kitui,EASTERN,16662
MUTOMO,Rural,17,2146,1897,4043,Kitui,EASTERN,16663
MUTOMO,Rural,18,1971,1632,3603,Kitui,EASTERN,16664
MUTOMO,Rural,19,1630,1562,3192,Kitui,EASTERN,16665
MUTOMO,Rural,20,1418,1728,3146,Kitui,EASTERN,16666
MUTOMO,Rural,21,1060,1253,2313,Kitui,EASTERN,16667
MUTOMO,Rural,22,1023,1305,2328,Kitui,EASTERN,16668
MUTOMO,Rural,23,985,1308,2293,Kitui,EASTERN,16669
MUTOMO,Rural,24,755,1104,1859,Kitui,EASTERN,16670
MUTOMO,Rural,25,952,1537,2489,Kitui,EASTERN,16671
MUTOMO,Rural,26,657,1064,1721,Kitui,EASTERN,16672
MUTOMO,Rural,27,806,1226,2032,Kitui,EASTERN,16673
MUTOMO,Rural,28,605,1064,1669,Kitui,EASTERN,16674
MUTOMO,Rural,29,776,1221,1997,Kitui,EASTERN,16675
MUTOMO,Rural,30,950,1528,2478,Kitui,EASTERN,16676
MUTOMO,Rural,31,765,1011,1776,Kitui,EASTERN,16677
MUTOMO,Rural,32,820,1013,1833,Kitui,EASTERN,16678
MUTOMO,Rural,33,619,870,1489,Kitui,EASTERN,16679
MUTOMO,Rural,34,736,1047,1783,Kitui,EASTERN,16680
MUTOMO,Rural,35,1141,1416,2557,Kitui,EASTERN,16681
MUTOMO,Rural,36,685,851,1536,Kitui,EASTERN,16682
MUTOMO,Rural,37,732,808,1540,Kitui,EASTERN,16683
MUTOMO,Rural,38,579,716,1295,Kitui,EASTERN,16684
MUTOMO,Rural,39,672,841,1513,Kitui,EASTERN,16685
MUTOMO,Rural,40,775,1086,1861,Kitui,EASTERN,16686
MUTOMO,Rural,41,577,623,1200,Kitui,EASTERN,16687
MUTOMO,Rural,42,442,477,919,Kitui,EASTERN,16688
MUTOMO,Rural,43,360,412,772,Kitui,EASTERN,16689
MUTOMO,Rural,44,434,426,860,Kitui,EASTERN,16690
MUTOMO,Rural,45,580,690,1270,Kitui,EASTERN,16691
MUTOMO,Rural,46,520,577,1097,Kitui,EASTERN,16692
MUTOMO,Rural,47,443,535,978,Kitui,EASTERN,16693
MUTOMO,Rural,48,321,530,851,Kitui,EASTERN,16694
MUTOMO,Rural,49,389,577,966,Kitui,EASTERN,16695
MUTOMO,Rural,50,472,717,1189,Kitui,EASTERN,16696
MUTOMO,Rural,51,330,431,761,Kitui,EASTERN,16697
MUTOMO,Rural,52,348,391,739,Kitui,EASTERN,16698
MUTOMO,Rural,53,289,397,686,Kitui,EASTERN,16699
MUTOMO,Rural,54,335,486,821,Kitui,EASTERN,16700
MUTOMO,Rural,55,416,465,881,Kitui,EASTERN,16701
MUTOMO,Rural,56,296,335,631,Kitui,EASTERN,16702
MUTOMO,Rural,57,488,465,953,Kitui,EASTERN,16703
MUTOMO,Rural,58,218,222,440,Kitui,EASTERN,16704
MUTOMO,Rural,59,289,393,682,Kitui,EASTERN,16705
MUTOMO,Rural,60,443,470,913,Kitui,EASTERN,16706
MUTOMO,Rural,61,224,295,519,Kitui,EASTERN,16707
MUTOMO,Rural,62,204,236,440,Kitui,EASTERN,16708
MUTOMO,Rural,63,436,789,1225,Kitui,EASTERN,16709
MUTOMO,Rural,64,231,364,595,Kitui,EASTERN,16710
MUTOMO,Rural,65,255,356,611,Kitui,EASTERN,16711
MUTOMO,Rural,66,163,185,348,Kitui,EASTERN,16712
MUTOMO,Rural,67,238,238,476,Kitui,EASTERN,16713
MUTOMO,Rural,68,157,145,302,Kitui,EASTERN,16714
MUTOMO,Rural,69,189,288,477,Kitui,EASTERN,16715
MUTOMO,Rural,70,316,361,677,Kitui,EASTERN,16716
MUTOMO,Rural,71,132,145,277,Kitui,EASTERN,16717
MUTOMO,Rural,72,131,116,247,Kitui,EASTERN,16718
MUTOMO,Rural,73,165,200,365,Kitui,EASTERN,16719
MUTOMO,Rural,74,276,502,778,Kitui,EASTERN,16720
MUTOMO,Rural,75,148,160,308,Kitui,EASTERN,16721
MUTOMO,Rural,76,81,81,162,Kitui,EASTERN,16722
MUTOMO,Rural,77,96,71,167,Kitui,EASTERN,16723
MUTOMO,Rural,78,104,92,196,Kitui,EASTERN,16724
MUTOMO,Rural,79,142,210,352,Kitui,EASTERN,16725
MUTOMO,Rural,80+,1331,1724,3055,Kitui,EASTERN,16726
MUTOMO,Rural,Age NS,34,29,63,Kitui,EASTERN,16727
MWINGI,Rural,0,3676,3576,7252,Kitui,EASTERN,16728
MWINGI,Rural,1,3725,3661,7386,Kitui,EASTERN,16729
MWINGI,Rural,2,3736,3634,7370,Kitui,EASTERN,16730
MWINGI,Rural,3,3817,3711,7528,Kitui,EASTERN,16731
MWINGI,Rural,4,3951,3693,7644,Kitui,EASTERN,16732
MWINGI,Rural,5,4137,3926,8063,Kitui,EASTERN,16733
MWINGI,Rural,6,3972,3879,7851,Kitui,EASTERN,16734
MWINGI,Rural,7,3817,3691,7508,Kitui,EASTERN,16735
MWINGI,Rural,8,3521,3456,6977,Kitui,EASTERN,16736
MWINGI,Rural,9,3832,3514,7346,Kitui,EASTERN,16737
MWINGI,Rural,10,3752,3494,7246,Kitui,EASTERN,16738
MWINGI,Rural,11,3198,3164,6362,Kitui,EASTERN,16739
MWINGI,Rural,12,3766,3429,7195,Kitui,EASTERN,16740
MWINGI,Rural,13,3689,3686,7375,Kitui,EASTERN,16741
MWINGI,Rural,14,3226,3152,6378,Kitui,EASTERN,16742
MWINGI,Rural,15,3398,3300,6698,Kitui,EASTERN,16743
MWINGI,Rural,16,2846,2929,5775,Kitui,EASTERN,16744
MWINGI,Rural,17,3192,2847,6039,Kitui,EASTERN,16745
MWINGI,Rural,18,2715,2545,5260,Kitui,EASTERN,16746
MWINGI,Rural,19,2246,2162,4408,Kitui,EASTERN,16747
MWINGI,Rural,20,1987,2180,4167,Kitui,EASTERN,16748
MWINGI,Rural,21,1476,1738,3214,Kitui,EASTERN,16749
MWINGI,Rural,22,1240,1774,3014,Kitui,EASTERN,16750
MWINGI,Rural,23,1236,1825,3061,Kitui,EASTERN,16751
MWINGI,Rural,24,892,1519,2411,Kitui,EASTERN,16752
MWINGI,Rural,25,1131,1926,3057,Kitui,EASTERN,16753
MWINGI,Rural,26,848,1322,2170,Kitui,EASTERN,16754
MWINGI,Rural,27,912,1565,2477,Kitui,EASTERN,16755
MWINGI,Rural,28,755,1391,2146,Kitui,EASTERN,16756
MWINGI,Rural,29,906,1477,2383,Kitui,EASTERN,16757
MWINGI,Rural,30,1088,1770,2858,Kitui,EASTERN,16758
MWINGI,Rural,31,831,1213,2044,Kitui,EASTERN,16759
MWINGI,Rural,32,786,1283,2069,Kitui,EASTERN,16760
MWINGI,Rural,33,660,1093,1753,Kitui,EASTERN,16761
MWINGI,Rural,34,777,1262,2039,Kitui,EASTERN,16762
MWINGI,Rural,35,1222,1947,3169,Kitui,EASTERN,16763
MWINGI,Rural,36,786,1151,1937,Kitui,EASTERN,16764
MWINGI,Rural,37,707,1023,1730,Kitui,EASTERN,16765
MWINGI,Rural,38,646,1094,1740,Kitui,EASTERN,16766
MWINGI,Rural,39,666,1003,1669,Kitui,EASTERN,16767
MWINGI,Rural,40,894,1411,2305,Kitui,EASTERN,16768
MWINGI,Rural,41,597,905,1502,Kitui,EASTERN,16769
MWINGI,Rural,42,515,753,1268,Kitui,EASTERN,16770
MWINGI,Rural,43,436,660,1096,Kitui,EASTERN,16771
MWINGI,Rural,44,506,694,1200,Kitui,EASTERN,16772
MWINGI,Rural,45,776,1212,1988,Kitui,EASTERN,16773
MWINGI,Rural,46,648,888,1536,Kitui,EASTERN,16774
MWINGI,Rural,47,484,663,1147,Kitui,EASTERN,16775
MWINGI,Rural,48,354,653,1007,Kitui,EASTERN,16776
MWINGI,Rural,49,445,639,1084,Kitui,EASTERN,16777
MWINGI,Rural,50,657,1007,1664,Kitui,EASTERN,16778
MWINGI,Rural,51,423,565,988,Kitui,EASTERN,16779
MWINGI,Rural,52,420,592,1012,Kitui,EASTERN,16780
MWINGI,Rural,53,368,461,829,Kitui,EASTERN,16781
MWINGI,Rural,54,358,501,859,Kitui,EASTERN,16782
MWINGI,Rural,55,506,662,1168,Kitui,EASTERN,16783
MWINGI,Rural,56,428,521,949,Kitui,EASTERN,16784
MWINGI,Rural,57,573,679,1252,Kitui,EASTERN,16785
MWINGI,Rural,58,321,448,769,Kitui,EASTERN,16786
MWINGI,Rural,59,411,643,1054,Kitui,EASTERN,16787
MWINGI,Rural,60,630,851,1481,Kitui,EASTERN,16788
MWINGI,Rural,61,382,476,858,Kitui,EASTERN,16789
MWINGI,Rural,62,304,302,606,Kitui,EASTERN,16790
MWINGI,Rural,63,317,390,707,Kitui,EASTERN,16791
MWINGI,Rural,64,282,459,741,Kitui,EASTERN,16792
MWINGI,Rural,65,353,491,844,Kitui,EASTERN,16793
MWINGI,Rural,66,193,192,385,Kitui,EASTERN,16794
MWINGI,Rural,67,294,323,617,Kitui,EASTERN,16795
MWINGI,Rural,68,260,232,492,Kitui,EASTERN,16796
MWINGI,Rural,69,295,429,724,Kitui,EASTERN,16797
MWINGI,Rural,70,489,694,1183,Kitui,EASTERN,16798
MWINGI,Rural,71,177,234,411,Kitui,EASTERN,16799
MWINGI,Rural,72,211,188,399,Kitui,EASTERN,16800
MWINGI,Rural,73,201,220,421,Kitui,EASTERN,16801
MWINGI,Rural,74,257,320,577,Kitui,EASTERN,16802
MWINGI,Rural,75,240,284,524,Kitui,EASTERN,16803
MWINGI,Rural,76,156,104,260,Kitui,EASTERN,16804
MWINGI,Rural,77,144,150,294,Kitui,EASTERN,16805
MWINGI,Rural,78,132,149,281,Kitui,EASTERN,16806
MWINGI,Rural,79,201,292,493,Kitui,EASTERN,16807
MWINGI,Rural,80+,1731,2282,4013,Kitui,EASTERN,16808
MWINGI,Rural,Age NS,53,68,121,Kitui,EASTERN,16809
KYUSO,Rural,0,2521,2442,4963,Kitui,EASTERN,16810
KYUSO,Rural,1,2490,2523,5013,Kitui,EASTERN,16811
KYUSO,Rural,2,2448,2503,4951,Kitui,EASTERN,16812
KYUSO,Rural,3,2569,2553,5122,Kitui,EASTERN,16813
KYUSO,Rural,4,2566,2575,5141,Kitui,EASTERN,16814
KYUSO,Rural,5,2612,2637,5249,Kitui,EASTERN,16815
KYUSO,Rural,6,2595,2554,5149,Kitui,EASTERN,16816
KYUSO,Rural,7,2255,2274,4529,Kitui,EASTERN,16817
KYUSO,Rural,8,2241,2210,4451,Kitui,EASTERN,16818
KYUSO,Rural,9,2167,2136,4303,Kitui,EASTERN,16819
KYUSO,Rural,10,2179,2190,4369,Kitui,EASTERN,16820
KYUSO,Rural,11,1776,1817,3593,Kitui,EASTERN,16821
KYUSO,Rural,12,2183,2062,4245,Kitui,EASTERN,16822
KYUSO,Rural,13,2188,2165,4353,Kitui,EASTERN,16823
KYUSO,Rural,14,1922,1844,3766,Kitui,EASTERN,16824
KYUSO,Rural,15,2010,1991,4001,Kitui,EASTERN,16825
KYUSO,Rural,16,1601,1707,3308,Kitui,EASTERN,16826
KYUSO,Rural,17,1663,1657,3320,Kitui,EASTERN,16827
KYUSO,Rural,18,1422,1527,2949,Kitui,EASTERN,16828
KYUSO,Rural,19,1350,1357,2707,Kitui,EASTERN,16829
KYUSO,Rural,20,1206,1394,2600,Kitui,EASTERN,16830
KYUSO,Rural,21,881,1074,1955,Kitui,EASTERN,16831
KYUSO,Rural,22,727,1070,1797,Kitui,EASTERN,16832
KYUSO,Rural,23,696,1157,1853,Kitui,EASTERN,16833
KYUSO,Rural,24,548,947,1495,Kitui,EASTERN,16834
KYUSO,Rural,25,742,1352,2094,Kitui,EASTERN,16835
KYUSO,Rural,26,433,853,1286,Kitui,EASTERN,16836
KYUSO,Rural,27,518,931,1449,Kitui,EASTERN,16837
KYUSO,Rural,28,435,906,1341,Kitui,EASTERN,16838
KYUSO,Rural,29,529,827,1356,Kitui,EASTERN,16839
KYUSO,Rural,30,632,1164,1796,Kitui,EASTERN,16840
KYUSO,Rural,31,534,732,1266,Kitui,EASTERN,16841
KYUSO,Rural,32,460,721,1181,Kitui,EASTERN,16842
KYUSO,Rural,33,415,680,1095,Kitui,EASTERN,16843
KYUSO,Rural,34,471,719,1190,Kitui,EASTERN,16844
KYUSO,Rural,35,778,1139,1917,Kitui,EASTERN,16845
KYUSO,Rural,36,472,695,1167,Kitui,EASTERN,16846
KYUSO,Rural,37,430,585,1015,Kitui,EASTERN,16847
KYUSO,Rural,38,414,604,1018,Kitui,EASTERN,16848
KYUSO,Rural,39,403,591,994,Kitui,EASTERN,16849
KYUSO,Rural,40,545,831,1376,Kitui,EASTERN,16850
KYUSO,Rural,41,321,477,798,Kitui,EASTERN,16851
KYUSO,Rural,42,343,403,746,Kitui,EASTERN,16852
KYUSO,Rural,43,246,348,594,Kitui,EASTERN,16853
KYUSO,Rural,44,246,390,636,Kitui,EASTERN,16854
KYUSO,Rural,45,469,667,1136,Kitui,EASTERN,16855
KYUSO,Rural,46,330,513,843,Kitui,EASTERN,16856
KYUSO,Rural,47,270,362,632,Kitui,EASTERN,16857
KYUSO,Rural,48,257,340,597,Kitui,EASTERN,16858
KYUSO,Rural,49,307,403,710,Kitui,EASTERN,16859
KYUSO,Rural,50,463,705,1168,Kitui,EASTERN,16860
KYUSO,Rural,51,261,277,538,Kitui,EASTERN,16861
KYUSO,Rural,52,245,273,518,Kitui,EASTERN,16862
KYUSO,Rural,53,222,251,473,Kitui,EASTERN,16863
KYUSO,Rural,54,240,264,504,Kitui,EASTERN,16864
KYUSO,Rural,55,325,387,712,Kitui,EASTERN,16865
KYUSO,Rural,56,219,293,512,Kitui,EASTERN,16866
KYUSO,Rural,57,317,308,625,Kitui,EASTERN,16867
KYUSO,Rural,58,170,219,389,Kitui,EASTERN,16868
KYUSO,Rural,59,231,365,596,Kitui,EASTERN,16869
KYUSO,Rural,60,379,619,998,Kitui,EASTERN,16870
KYUSO,Rural,61,233,259,492,Kitui,EASTERN,16871
KYUSO,Rural,62,159,158,317,Kitui,EASTERN,16872
KYUSO,Rural,63,175,192,367,Kitui,EASTERN,16873
KYUSO,Rural,64,179,267,446,Kitui,EASTERN,16874
KYUSO,Rural,65,235,370,605,Kitui,EASTERN,16875
KYUSO,Rural,66,109,117,226,Kitui,EASTERN,16876
KYUSO,Rural,67,163,113,276,Kitui,EASTERN,16877
KYUSO,Rural,68,127,163,290,Kitui,EASTERN,16878
KYUSO,Rural,69,170,248,418,Kitui,EASTERN,16879
KYUSO,Rural,70,357,483,840,Kitui,EASTERN,16880
KYUSO,Rural,71,89,164,253,Kitui,EASTERN,16881
KYUSO,Rural,72,111,109,220,Kitui,EASTERN,16882
KYUSO,Rural,73,108,90,198,Kitui,EASTERN,16883
KYUSO,Rural,74,118,136,254,Kitui,EASTERN,16884
KYUSO,Rural,75,164,202,366,Kitui,EASTERN,16885
KYUSO,Rural,76,78,58,136,Kitui,EASTERN,16886
KYUSO,Rural,77,85,81,166,Kitui,EASTERN,16887
KYUSO,Rural,78,90,93,183,Kitui,EASTERN,16888
KYUSO,Rural,79,115,169,284,Kitui,EASTERN,16889
KYUSO,Rural,80+,912,1236,2148,Kitui,EASTERN,16890
KYUSO,Rural,Age NS,54,35,89,Kitui,EASTERN,16891
MACHAKOS,Rural,0,2018,1951,3969,Machakos,EASTERN,16892
MACHAKOS,Rural,1,2086,1930,4016,Machakos,EASTERN,16893
MACHAKOS,Rural,2,2228,2062,4290,Machakos,EASTERN,16894
MACHAKOS,Rural,3,2094,2041,4135,Machakos,EASTERN,16895
MACHAKOS,Rural,4,2174,2022,4196,Machakos,EASTERN,16896
MACHAKOS,Rural,5,2233,2154,4387,Machakos,EASTERN,16897
MACHAKOS,Rural,6,2088,1935,4023,Machakos,EASTERN,16898
MACHAKOS,Rural,7,2058,2063,4121,Machakos,EASTERN,16899
MACHAKOS,Rural,8,2049,1938,3987,Machakos,EASTERN,16900
MACHAKOS,Rural,9,2242,2206,4448,Machakos,EASTERN,16901
MACHAKOS,Rural,10,2232,2078,4310,Machakos,EASTERN,16902
MACHAKOS,Rural,11,1818,1828,3646,Machakos,EASTERN,16903
MACHAKOS,Rural,12,2188,2114,4302,Machakos,EASTERN,16904
MACHAKOS,Rural,13,2203,2194,4397,Machakos,EASTERN,16905
MACHAKOS,Rural,14,2095,1916,4011,Machakos,EASTERN,16906
MACHAKOS,Rural,15,1974,1869,3843,Machakos,EASTERN,16907
MACHAKOS,Rural,16,1806,1738,3544,Machakos,EASTERN,16908
MACHAKOS,Rural,17,1807,1605,3412,Machakos,EASTERN,16909
MACHAKOS,Rural,18,1712,1553,3265,Machakos,EASTERN,16910
MACHAKOS,Rural,19,1600,1270,2870,Machakos,EASTERN,16911
MACHAKOS,Rural,20,1506,1417,2923,Machakos,EASTERN,16912
MACHAKOS,Rural,21,1163,1089,2252,Machakos,EASTERN,16913
MACHAKOS,Rural,22,1132,1207,2339,Machakos,EASTERN,16914
MACHAKOS,Rural,23,1014,1201,2215,Machakos,EASTERN,16915
MACHAKOS,Rural,24,859,1042,1901,Machakos,EASTERN,16916
MACHAKOS,Rural,25,1003,1269,2272,Machakos,EASTERN,16917
MACHAKOS,Rural,26,810,985,1795,Machakos,EASTERN,16918
MACHAKOS,Rural,27,846,1046,1892,Machakos,EASTERN,16919
MACHAKOS,Rural,28,700,1038,1738,Machakos,EASTERN,16920
MACHAKOS,Rural,29,834,1120,1954,Machakos,EASTERN,16921
MACHAKOS,Rural,30,937,1333,2270,Machakos,EASTERN,16922
MACHAKOS,Rural,31,752,887,1639,Machakos,EASTERN,16923
MACHAKOS,Rural,32,687,1035,1722,Machakos,EASTERN,16924
MACHAKOS,Rural,33,599,839,1438,Machakos,EASTERN,16925
MACHAKOS,Rural,34,675,882,1557,Machakos,EASTERN,16926
MACHAKOS,Rural,35,933,1129,2062,Machakos,EASTERN,16927
MACHAKOS,Rural,36,582,699,1281,Machakos,EASTERN,16928
MACHAKOS,Rural,37,534,727,1261,Machakos,EASTERN,16929
MACHAKOS,Rural,38,546,781,1327,Machakos,EASTERN,16930
MACHAKOS,Rural,39,589,827,1416,Machakos,EASTERN,16931
MACHAKOS,Rural,40,669,1036,1705,Machakos,EASTERN,16932
MACHAKOS,Rural,41,459,618,1077,Machakos,EASTERN,16933
MACHAKOS,Rural,42,440,600,1040,Machakos,EASTERN,16934
MACHAKOS,Rural,43,354,485,839,Machakos,EASTERN,16935
MACHAKOS,Rural,44,396,515,911,Machakos,EASTERN,16936
MACHAKOS,Rural,45,571,874,1445,Machakos,EASTERN,16937
MACHAKOS,Rural,46,484,644,1128,Machakos,EASTERN,16938
MACHAKOS,Rural,47,409,591,1000,Machakos,EASTERN,16939
MACHAKOS,Rural,48,382,557,939,Machakos,EASTERN,16940
MACHAKOS,Rural,49,492,654,1146,Machakos,EASTERN,16941
MACHAKOS,Rural,50,607,887,1494,Machakos,EASTERN,16942
MACHAKOS,Rural,51,433,537,970,Machakos,EASTERN,16943
MACHAKOS,Rural,52,439,493,932,Machakos,EASTERN,16944
MACHAKOS,Rural,53,368,497,865,Machakos,EASTERN,16945
MACHAKOS,Rural,54,287,463,750,Machakos,EASTERN,16946
MACHAKOS,Rural,55,424,513,937,Machakos,EASTERN,16947
MACHAKOS,Rural,56,384,430,814,Machakos,EASTERN,16948
MACHAKOS,Rural,57,533,672,1205,Machakos,EASTERN,16949
MACHAKOS,Rural,58,249,316,565,Machakos,EASTERN,16950
MACHAKOS,Rural,59,351,427,778,Machakos,EASTERN,16951
MACHAKOS,Rural,60,500,540,1040,Machakos,EASTERN,16952
MACHAKOS,Rural,61,334,426,760,Machakos,EASTERN,16953
MACHAKOS,Rural,62,252,248,500,Machakos,EASTERN,16954
MACHAKOS,Rural,63,259,246,505,Machakos,EASTERN,16955
MACHAKOS,Rural,64,249,322,571,Machakos,EASTERN,16956
MACHAKOS,Rural,65,217,319,536,Machakos,EASTERN,16957
MACHAKOS,Rural,66,122,205,327,Machakos,EASTERN,16958
MACHAKOS,Rural,67,251,327,578,Machakos,EASTERN,16959
MACHAKOS,Rural,68,151,173,324,Machakos,EASTERN,16960
MACHAKOS,Rural,69,197,370,567,Machakos,EASTERN,16961
MACHAKOS,Rural,70,319,447,766,Machakos,EASTERN,16962
MACHAKOS,Rural,71,188,243,431,Machakos,EASTERN,16963
MACHAKOS,Rural,72,168,163,331,Machakos,EASTERN,16964
MACHAKOS,Rural,73,191,182,373,Machakos,EASTERN,16965
MACHAKOS,Rural,74,140,190,330,Machakos,EASTERN,16966
MACHAKOS,Rural,75,148,183,331,Machakos,EASTERN,16967
MACHAKOS,Rural,76,101,89,190,Machakos,EASTERN,16968
MACHAKOS,Rural,77,117,126,243,Machakos,EASTERN,16969
MACHAKOS,Rural,78,86,104,190,Machakos,EASTERN,16970
MACHAKOS,Rural,79,119,301,420,Machakos,EASTERN,16971
MACHAKOS,Rural,80+,1121,1968,3089,Machakos,EASTERN,16972
MACHAKOS,Rural,Age NS,71,57,128,Machakos,EASTERN,16973
MWALA,Rural,0,1931,1868,3799,Machakos,EASTERN,16974
MWALA,Rural,1,1835,1828,3663,Machakos,EASTERN,16975
MWALA,Rural,2,2101,2027,4128,Machakos,EASTERN,16976
MWALA,Rural,3,1999,1934,3933,Machakos,EASTERN,16977
MWALA,Rural,4,2158,2097,4255,Machakos,EASTERN,16978
MWALA,Rural,5,2376,2169,4545,Machakos,EASTERN,16979
MWALA,Rural,6,2233,2122,4355,Machakos,EASTERN,16980
MWALA,Rural,7,2302,2250,4552,Machakos,EASTERN,16981
MWALA,Rural,8,2107,2130,4237,Machakos,EASTERN,16982
MWALA,Rural,9,2352,2242,4594,Machakos,EASTERN,16983
MWALA,Rural,10,2530,2343,4873,Machakos,EASTERN,16984
MWALA,Rural,11,1993,1985,3978,Machakos,EASTERN,16985
MWALA,Rural,12,2509,2247,4756,Machakos,EASTERN,16986
MWALA,Rural,13,2626,2480,5106,Machakos,EASTERN,16987
MWALA,Rural,14,2311,2150,4461,Machakos,EASTERN,16988
MWALA,Rural,15,2351,2119,4470,Machakos,EASTERN,16989
MWALA,Rural,16,1975,1870,3845,Machakos,EASTERN,16990
MWALA,Rural,17,2335,1939,4274,Machakos,EASTERN,16991
MWALA,Rural,18,2154,1611,3765,Machakos,EASTERN,16992
MWALA,Rural,19,1843,1340,3183,Machakos,EASTERN,16993
MWALA,Rural,20,1743,1352,3095,Machakos,EASTERN,16994
MWALA,Rural,21,1106,978,2084,Machakos,EASTERN,16995
MWALA,Rural,22,1126,1077,2203,Machakos,EASTERN,16996
MWALA,Rural,23,962,1098,2060,Machakos,EASTERN,16997
MWALA,Rural,24,819,915,1734,Machakos,EASTERN,16998
MWALA,Rural,25,1021,1138,2159,Machakos,EASTERN,16999
MWALA,Rural,26,761,900,1661,Machakos,EASTERN,17000
MWALA,Rural,27,762,1005,1767,Machakos,EASTERN,17001
MWALA,Rural,28,655,925,1580,Machakos,EASTERN,17002
MWALA,Rural,29,769,1122,1891,Machakos,EASTERN,17003
MWALA,Rural,30,936,1398,2334,Machakos,EASTERN,17004
MWALA,Rural,31,737,888,1625,Machakos,EASTERN,17005
MWALA,Rural,32,629,1019,1648,Machakos,EASTERN,17006
MWALA,Rural,33,610,860,1470,Machakos,EASTERN,17007
MWALA,Rural,34,653,916,1569,Machakos,EASTERN,17008
MWALA,Rural,35,845,1207,2052,Machakos,EASTERN,17009
MWALA,Rural,36,604,765,1369,Machakos,EASTERN,17010
MWALA,Rural,37,602,767,1369,Machakos,EASTERN,17011
MWALA,Rural,38,567,715,1282,Machakos,EASTERN,17012
MWALA,Rural,39,619,868,1487,Machakos,EASTERN,17013
MWALA,Rural,40,777,1132,1909,Machakos,EASTERN,17014
MWALA,Rural,41,493,631,1124,Machakos,EASTERN,17015
MWALA,Rural,42,487,677,1164,Machakos,EASTERN,17016
MWALA,Rural,43,407,535,942,Machakos,EASTERN,17017
MWALA,Rural,44,441,587,1028,Machakos,EASTERN,17018
MWALA,Rural,45,665,957,1622,Machakos,EASTERN,17019
MWALA,Rural,46,571,737,1308,Machakos,EASTERN,17020
MWALA,Rural,47,443,667,1110,Machakos,EASTERN,17021
MWALA,Rural,48,361,531,892,Machakos,EASTERN,17022
MWALA,Rural,49,533,637,1170,Machakos,EASTERN,17023
MWALA,Rural,50,670,909,1579,Machakos,EASTERN,17024
MWALA,Rural,51,493,591,1084,Machakos,EASTERN,17025
MWALA,Rural,52,466,497,963,Machakos,EASTERN,17026
MWALA,Rural,53,403,485,888,Machakos,EASTERN,17027
MWALA,Rural,54,348,441,789,Machakos,EASTERN,17028
MWALA,Rural,55,471,579,1050,Machakos,EASTERN,17029
MWALA,Rural,56,378,433,811,Machakos,EASTERN,17030
MWALA,Rural,57,549,667,1216,Machakos,EASTERN,17031
MWALA,Rural,58,233,280,513,Machakos,EASTERN,17032
MWALA,Rural,59,358,461,819,Machakos,EASTERN,17033
MWALA,Rural,60,549,613,1162,Machakos,EASTERN,17034
MWALA,Rural,61,362,395,757,Machakos,EASTERN,17035
MWALA,Rural,62,263,243,506,Machakos,EASTERN,17036
MWALA,Rural,63,297,309,606,Machakos,EASTERN,17037
MWALA,Rural,64,280,326,606,Machakos,EASTERN,17038
MWALA,Rural,65,240,371,611,Machakos,EASTERN,17039
MWALA,Rural,66,147,239,386,Machakos,EASTERN,17040
MWALA,Rural,67,281,367,648,Machakos,EASTERN,17041
MWALA,Rural,68,145,205,350,Machakos,EASTERN,17042
MWALA,Rural,69,217,383,600,Machakos,EASTERN,17043
MWALA,Rural,70,384,542,926,Machakos,EASTERN,17044
MWALA,Rural,71,168,202,370,Machakos,EASTERN,17045
MWALA,Rural,72,210,165,375,Machakos,EASTERN,17046
MWALA,Rural,73,183,202,385,Machakos,EASTERN,17047
MWALA,Rural,74,172,189,361,Machakos,EASTERN,17048
MWALA,Rural,75,172,244,416,Machakos,EASTERN,17049
MWALA,Rural,76,98,103,201,Machakos,EASTERN,17050
MWALA,Rural,77,119,190,309,Machakos,EASTERN,17051
MWALA,Rural,78,94,112,206,Machakos,EASTERN,17052
MWALA,Rural,79,166,333,499,Machakos,EASTERN,17053
MWALA,Rural,80+,1632,2446,4078,Machakos,EASTERN,17054
MWALA,Rural,Age NS,61,65,126,Machakos,EASTERN,17055
YATTA,Rural,0,3032,3082,6114,Machakos,EASTERN,17056
YATTA,Rural,1,3096,3158,6254,Machakos,EASTERN,17057
YATTA,Rural,2,3280,3287,6567,Machakos,EASTERN,17058
YATTA,Rural,3,3328,3238,6566,Machakos,EASTERN,17059
YATTA,Rural,4,3479,3385,6864,Machakos,EASTERN,17060
YATTA,Rural,5,3686,3500,7186,Machakos,EASTERN,17061
YATTA,Rural,6,3450,3374,6824,Machakos,EASTERN,17062
YATTA,Rural,7,3443,3388,6831,Machakos,EASTERN,17063
YATTA,Rural,8,3122,3125,6247,Machakos,EASTERN,17064
YATTA,Rural,9,3442,3299,6741,Machakos,EASTERN,17065
YATTA,Rural,10,3563,3305,6868,Machakos,EASTERN,17066
YATTA,Rural,11,2865,2758,5623,Machakos,EASTERN,17067
YATTA,Rural,12,3304,3182,6486,Machakos,EASTERN,17068
YATTA,Rural,13,3488,3357,6845,Machakos,EASTERN,17069
YATTA,Rural,14,3228,2987,6215,Machakos,EASTERN,17070
YATTA,Rural,15,3130,2914,6044,Machakos,EASTERN,17071
YATTA,Rural,16,2867,2608,5475,Machakos,EASTERN,17072
YATTA,Rural,17,3054,2606,5660,Machakos,EASTERN,17073
YATTA,Rural,18,2805,2252,5057,Machakos,EASTERN,17074
YATTA,Rural,19,2582,2085,4667,Machakos,EASTERN,17075
YATTA,Rural,20,2140,1973,4113,Machakos,EASTERN,17076
YATTA,Rural,21,1684,1555,3239,Machakos,EASTERN,17077
YATTA,Rural,22,1574,1682,3256,Machakos,EASTERN,17078
YATTA,Rural,23,1434,1748,3182,Machakos,EASTERN,17079
YATTA,Rural,24,1057,1420,2477,Machakos,EASTERN,17080
YATTA,Rural,25,1357,1867,3224,Machakos,EASTERN,17081
YATTA,Rural,26,1046,1433,2479,Machakos,EASTERN,17082
YATTA,Rural,27,1152,1537,2689,Machakos,EASTERN,17083
YATTA,Rural,28,942,1384,2326,Machakos,EASTERN,17084
YATTA,Rural,29,1101,1542,2643,Machakos,EASTERN,17085
YATTA,Rural,30,1338,1896,3234,Machakos,EASTERN,17086
YATTA,Rural,31,1077,1215,2292,Machakos,EASTERN,17087
YATTA,Rural,32,968,1305,2273,Machakos,EASTERN,17088
YATTA,Rural,33,831,1096,1927,Machakos,EASTERN,17089
YATTA,Rural,34,874,1161,2035,Machakos,EASTERN,17090
YATTA,Rural,35,1178,1628,2806,Machakos,EASTERN,17091
YATTA,Rural,36,837,1076,1913,Machakos,EASTERN,17092
YATTA,Rural,37,834,973,1807,Machakos,EASTERN,17093
YATTA,Rural,38,721,999,1720,Machakos,EASTERN,17094
YATTA,Rural,39,821,1089,1910,Machakos,EASTERN,17095
YATTA,Rural,40,970,1373,2343,Machakos,EASTERN,17096
YATTA,Rural,41,720,886,1606,Machakos,EASTERN,17097
YATTA,Rural,42,642,800,1442,Machakos,EASTERN,17098
YATTA,Rural,43,511,673,1184,Machakos,EASTERN,17099
YATTA,Rural,44,537,658,1195,Machakos,EASTERN,17100
YATTA,Rural,45,875,1234,2109,Machakos,EASTERN,17101
YATTA,Rural,46,761,1008,1769,Machakos,EASTERN,17102
YATTA,Rural,47,570,766,1336,Machakos,EASTERN,17103
YATTA,Rural,48,459,695,1154,Machakos,EASTERN,17104
YATTA,Rural,49,630,817,1447,Machakos,EASTERN,17105
YATTA,Rural,50,793,1009,1802,Machakos,EASTERN,17106
YATTA,Rural,51,618,722,1340,Machakos,EASTERN,17107
YATTA,Rural,52,565,624,1189,Machakos,EASTERN,17108
YATTA,Rural,53,446,570,1016,Machakos,EASTERN,17109
YATTA,Rural,54,459,554,1013,Machakos,EASTERN,17110
YATTA,Rural,55,545,674,1219,Machakos,EASTERN,17111
YATTA,Rural,56,414,563,977,Machakos,EASTERN,17112
YATTA,Rural,57,732,1007,1739,Machakos,EASTERN,17113
YATTA,Rural,58,319,410,729,Machakos,EASTERN,17114
YATTA,Rural,59,397,612,1009,Machakos,EASTERN,17115
YATTA,Rural,60,598,773,1371,Machakos,EASTERN,17116
YATTA,Rural,61,467,545,1012,Machakos,EASTERN,17117
YATTA,Rural,62,336,324,660,Machakos,EASTERN,17118
YATTA,Rural,63,310,377,687,Machakos,EASTERN,17119
YATTA,Rural,64,303,423,726,Machakos,EASTERN,17120
YATTA,Rural,65,284,415,699,Machakos,EASTERN,17121
YATTA,Rural,66,192,285,477,Machakos,EASTERN,17122
YATTA,Rural,67,319,394,713,Machakos,EASTERN,17123
YATTA,Rural,68,213,243,456,Machakos,EASTERN,17124
YATTA,Rural,69,272,388,660,Machakos,EASTERN,17125
YATTA,Rural,70,441,524,965,Machakos,EASTERN,17126
YATTA,Rural,71,216,262,478,Machakos,EASTERN,17127
YATTA,Rural,72,226,161,387,Machakos,EASTERN,17128
YATTA,Rural,73,236,209,445,Machakos,EASTERN,17129
YATTA,Rural,74,182,203,385,Machakos,EASTERN,17130
YATTA,Rural,75,200,221,421,Machakos,EASTERN,17131
YATTA,Rural,76,112,108,220,Machakos,EASTERN,17132
YATTA,Rural,77,165,164,329,Machakos,EASTERN,17133
YATTA,Rural,78,131,135,266,Machakos,EASTERN,17134
YATTA,Rural,79,147,311,458,Machakos,EASTERN,17135
YATTA,Rural,80+,1542,2349,3891,Machakos,EASTERN,17136
YATTA,Rural,Age NS,29,25,54,Machakos,EASTERN,17137
KANGUNDO,Rural,0,0,0,0,Machakos,EASTERN,17138
KANGUNDO,Rural,1,0,0,0,Machakos,EASTERN,17139
KANGUNDO,Rural,2,0,0,0,Machakos,EASTERN,17140
KANGUNDO,Rural,3,0,0,0,Machakos,EASTERN,17141
KANGUNDO,Rural,4,0,0,0,Machakos,EASTERN,17142
KANGUNDO,Rural,5,0,0,0,Machakos,EASTERN,17143
KANGUNDO,Rural,6,0,0,0,Machakos,EASTERN,17144
KANGUNDO,Rural,7,0,0,0,Machakos,EASTERN,17145
KANGUNDO,Rural,8,0,0,0,Machakos,EASTERN,17146
KANGUNDO,Rural,9,0,0,0,Machakos,EASTERN,17147
KANGUNDO,Rural,10,0,0,0,Machakos,EASTERN,17148
KANGUNDO,Rural,11,0,0,0,Machakos,EASTERN,17149
KANGUNDO,Rural,12,0,0,0,Machakos,EASTERN,17150
KANGUNDO,Rural,13,0,0,0,Machakos,EASTERN,17151
KANGUNDO,Rural,14,0,0,0,Machakos,EASTERN,17152
KANGUNDO,Rural,15,0,0,0,Machakos,EASTERN,17153
KANGUNDO,Rural,16,0,0,0,Machakos,EASTERN,17154
KANGUNDO,Rural,17,0,0,0,Machakos,EASTERN,17155
KANGUNDO,Rural,18,0,0,0,Machakos,EASTERN,17156
KANGUNDO,Rural,19,0,0,0,Machakos,EASTERN,17157
KANGUNDO,Rural,20,0,0,0,Machakos,EASTERN,17158
KANGUNDO,Rural,21,0,0,0,Machakos,EASTERN,17159
KANGUNDO,Rural,22,0,0,0,Machakos,EASTERN,17160
KANGUNDO,Rural,23,0,0,0,Machakos,EASTERN,17161
KANGUNDO,Rural,24,0,0,0,Machakos,EASTERN,17162
KANGUNDO,Rural,25,0,0,0,Machakos,EASTERN,17163
KANGUNDO,Rural,26,0,0,0,Machakos,EASTERN,17164
KANGUNDO,Rural,27,0,0,0,Machakos,EASTERN,17165
KANGUNDO,Rural,28,0,0,0,Machakos,EASTERN,17166
KANGUNDO,Rural,29,0,0,0,Machakos,EASTERN,17167
KANGUNDO,Rural,30,0,0,0,Machakos,EASTERN,17168
KANGUNDO,Rural,31,0,0,0,Machakos,EASTERN,17169
KANGUNDO,Rural,32,0,0,0,Machakos,EASTERN,17170
KANGUNDO,Rural,33,0,0,0,Machakos,EASTERN,17171
KANGUNDO,Rural,34,0,0,0,Machakos,EASTERN,17172
KANGUNDO,Rural,35,0,0,0,Machakos,EASTERN,17173
KANGUNDO,Rural,36,0,0,0,Machakos,EASTERN,17174
KANGUNDO,Rural,37,0,0,0,Machakos,EASTERN,17175
KANGUNDO,Rural,38,0,0,0,Machakos,EASTERN,17176
KANGUNDO,Rural,39,0,0,0,Machakos,EASTERN,17177
KANGUNDO,Rural,40,0,0,0,Machakos,EASTERN,17178
KANGUNDO,Rural,41,0,0,0,Machakos,EASTERN,17179
KANGUNDO,Rural,42,0,0,0,Machakos,EASTERN,17180
KANGUNDO,Rural,43,0,0,0,Machakos,EASTERN,17181
KANGUNDO,Rural,44,0,0,0,Machakos,EASTERN,17182
KANGUNDO,Rural,45,0,0,0,Machakos,EASTERN,17183
KANGUNDO,Rural,46,0,0,0,Machakos,EASTERN,17184
KANGUNDO,Rural,47,0,0,0,Machakos,EASTERN,17185
KANGUNDO,Rural,48,0,0,0,Machakos,EASTERN,17186
KANGUNDO,Rural,49,0,0,0,Machakos,EASTERN,17187
KANGUNDO,Rural,50,0,0,0,Machakos,EASTERN,17188
KANGUNDO,Rural,51,0,0,0,Machakos,EASTERN,17189
KANGUNDO,Rural,52,0,0,0,Machakos,EASTERN,17190
KANGUNDO,Rural,53,0,0,0,Machakos,EASTERN,17191
KANGUNDO,Rural,54,0,0,0,Machakos,EASTERN,17192
KANGUNDO,Rural,55,0,0,0,Machakos,EASTERN,17193
KANGUNDO,Rural,56,0,0,0,Machakos,EASTERN,17194
KANGUNDO,Rural,57,0,0,0,Machakos,EASTERN,17195
KANGUNDO,Rural,58,0,0,0,Machakos,EASTERN,17196
KANGUNDO,Rural,59,0,0,0,Machakos,EASTERN,17197
KANGUNDO,Rural,60,0,0,0,Machakos,EASTERN,17198
KANGUNDO,Rural,61,0,0,0,Machakos,EASTERN,17199
KANGUNDO,Rural,62,0,0,0,Machakos,EASTERN,17200
KANGUNDO,Rural,63,0,0,0,Machakos,EASTERN,17201
KANGUNDO,Rural,64,0,0,0,Machakos,EASTERN,17202
KANGUNDO,Rural,65,0,0,0,Machakos,EASTERN,17203
KANGUNDO,Rural,66,0,0,0,Machakos,EASTERN,17204
KANGUNDO,Rural,67,0,0,0,Machakos,EASTERN,17205
KANGUNDO,Rural,68,0,0,0,Machakos,EASTERN,17206
KANGUNDO,Rural,69,0,0,0,Machakos,EASTERN,17207
KANGUNDO,Rural,70,0,0,0,Machakos,EASTERN,17208
KANGUNDO,Rural,71,0,0,0,Machakos,EASTERN,17209
KANGUNDO,Rural,72,0,0,0,Machakos,EASTERN,17210
KANGUNDO,Rural,73,0,0,0,Machakos,EASTERN,17211
KANGUNDO,Rural,74,0,0,0,Machakos,EASTERN,17212
KANGUNDO,Rural,75,0,0,0,Machakos,EASTERN,17213
KANGUNDO,Rural,76,0,0,0,Machakos,EASTERN,17214
KANGUNDO,Rural,77,0,0,0,Machakos,EASTERN,17215
KANGUNDO,Rural,78,0,0,0,Machakos,EASTERN,17216
KANGUNDO,Rural,79,0,0,0,Machakos,EASTERN,17217
KANGUNDO,Rural,80+,0,0,0,Machakos,EASTERN,17218
KANGUNDO,Rural,Age NS,0,0,0,Machakos,EASTERN,17219
MAKUENI,Rural,0,2428,2496,4924,Makueni,EASTERN,17220
MAKUENI,Rural,1,2397,2464,4861,Makueni,EASTERN,17221
MAKUENI,Rural,2,2797,2707,5504,Makueni,EASTERN,17222
MAKUENI,Rural,3,2540,2558,5098,Makueni,EASTERN,17223
MAKUENI,Rural,4,2767,2679,5446,Makueni,EASTERN,17224
MAKUENI,Rural,5,2966,2820,5786,Makueni,EASTERN,17225
MAKUENI,Rural,6,2846,2770,5616,Makueni,EASTERN,17226
MAKUENI,Rural,7,2873,2855,5728,Makueni,EASTERN,17227
MAKUENI,Rural,8,2747,2621,5368,Makueni,EASTERN,17228
MAKUENI,Rural,9,2871,2868,5739,Makueni,EASTERN,17229
MAKUENI,Rural,10,2989,2825,5814,Makueni,EASTERN,17230
MAKUENI,Rural,11,2530,2545,5075,Makueni,EASTERN,17231
MAKUENI,Rural,12,2988,2908,5896,Makueni,EASTERN,17232
MAKUENI,Rural,13,2967,2952,5919,Makueni,EASTERN,17233
MAKUENI,Rural,14,2810,2569,5379,Makueni,EASTERN,17234
MAKUENI,Rural,15,2678,2612,5290,Makueni,EASTERN,17235
MAKUENI,Rural,16,2469,2462,4931,Makueni,EASTERN,17236
MAKUENI,Rural,17,2584,2226,4810,Makueni,EASTERN,17237
MAKUENI,Rural,18,2280,1788,4068,Makueni,EASTERN,17238
MAKUENI,Rural,19,2114,1778,3892,Makueni,EASTERN,17239
MAKUENI,Rural,20,1804,1593,3397,Makueni,EASTERN,17240
MAKUENI,Rural,21,1254,1255,2509,Makueni,EASTERN,17241
MAKUENI,Rural,22,1213,1351,2564,Makueni,EASTERN,17242
MAKUENI,Rural,23,1059,1274,2333,Makueni,EASTERN,17243
MAKUENI,Rural,24,915,1129,2044,Makueni,EASTERN,17244
MAKUENI,Rural,25,1057,1425,2482,Makueni,EASTERN,17245
MAKUENI,Rural,26,787,1110,1897,Makueni,EASTERN,17246
MAKUENI,Rural,27,878,1174,2052,Makueni,EASTERN,17247
MAKUENI,Rural,28,682,1135,1817,Makueni,EASTERN,17248
MAKUENI,Rural,29,861,1214,2075,Makueni,EASTERN,17249
MAKUENI,Rural,30,1042,1494,2536,Makueni,EASTERN,17250
MAKUENI,Rural,31,731,971,1702,Makueni,EASTERN,17251
MAKUENI,Rural,32,705,1035,1740,Makueni,EASTERN,17252
MAKUENI,Rural,33,627,923,1550,Makueni,EASTERN,17253
MAKUENI,Rural,34,729,1016,1745,Makueni,EASTERN,17254
MAKUENI,Rural,35,1041,1432,2473,Makueni,EASTERN,17255
MAKUENI,Rural,36,646,926,1572,Makueni,EASTERN,17256
MAKUENI,Rural,37,666,869,1535,Makueni,EASTERN,17257
MAKUENI,Rural,38,569,857,1426,Makueni,EASTERN,17258
MAKUENI,Rural,39,714,929,1643,Makueni,EASTERN,17259
MAKUENI,Rural,40,825,1142,1967,Makueni,EASTERN,17260
MAKUENI,Rural,41,587,722,1309,Makueni,EASTERN,17261
MAKUENI,Rural,42,488,660,1148,Makueni,EASTERN,17262
MAKUENI,Rural,43,429,580,1009,Makueni,EASTERN,17263
MAKUENI,Rural,44,426,603,1029,Makueni,EASTERN,17264
MAKUENI,Rural,45,721,985,1706,Makueni,EASTERN,17265
MAKUENI,Rural,46,547,664,1211,Makueni,EASTERN,17266
MAKUENI,Rural,47,444,611,1055,Makueni,EASTERN,17267
MAKUENI,Rural,48,388,565,953,Makueni,EASTERN,17268
MAKUENI,Rural,49,487,691,1178,Makueni,EASTERN,17269
MAKUENI,Rural,50,636,935,1571,Makueni,EASTERN,17270
MAKUENI,Rural,51,439,612,1051,Makueni,EASTERN,17271
MAKUENI,Rural,52,416,556,972,Makueni,EASTERN,17272
MAKUENI,Rural,53,363,504,867,Makueni,EASTERN,17273
MAKUENI,Rural,54,347,452,799,Makueni,EASTERN,17274
MAKUENI,Rural,55,427,608,1035,Makueni,EASTERN,17275
MAKUENI,Rural,56,388,458,846,Makueni,EASTERN,17276
MAKUENI,Rural,57,562,822,1384,Makueni,EASTERN,17277
MAKUENI,Rural,58,270,311,581,Makueni,EASTERN,17278
MAKUENI,Rural,59,370,529,899,Makueni,EASTERN,17279
MAKUENI,Rural,60,562,726,1288,Makueni,EASTERN,17280
MAKUENI,Rural,61,359,471,830,Makueni,EASTERN,17281
MAKUENI,Rural,62,295,301,596,Makueni,EASTERN,17282
MAKUENI,Rural,63,301,341,642,Makueni,EASTERN,17283
MAKUENI,Rural,64,312,403,715,Makueni,EASTERN,17284
MAKUENI,Rural,65,276,439,715,Makueni,EASTERN,17285
MAKUENI,Rural,66,180,243,423,Makueni,EASTERN,17286
MAKUENI,Rural,67,306,382,688,Makueni,EASTERN,17287
MAKUENI,Rural,68,191,189,380,Makueni,EASTERN,17288
MAKUENI,Rural,69,250,413,663,Makueni,EASTERN,17289
MAKUENI,Rural,70,399,610,1009,Makueni,EASTERN,17290
MAKUENI,Rural,71,183,203,386,Makueni,EASTERN,17291
MAKUENI,Rural,72,200,144,344,Makueni,EASTERN,17292
MAKUENI,Rural,73,199,196,395,Makueni,EASTERN,17293
MAKUENI,Rural,74,162,199,361,Makueni,EASTERN,17294
MAKUENI,Rural,75,173,217,390,Makueni,EASTERN,17295
MAKUENI,Rural,76,126,90,216,Makueni,EASTERN,17296
MAKUENI,Rural,77,131,108,239,Makueni,EASTERN,17297
MAKUENI,Rural,78,126,121,247,Makueni,EASTERN,17298
MAKUENI,Rural,79,146,285,431,Makueni,EASTERN,17299
MAKUENI,Rural,80+,1497,2450,3947,Makueni,EASTERN,17300
MAKUENI,Rural,Age NS,16,21,37,Makueni,EASTERN,17301
MBOONI,Rural,0,2390,2192,4582,Makueni,EASTERN,17302
MBOONI,Rural,1,2390,2170,4560,Makueni,EASTERN,17303
MBOONI,Rural,2,2560,2536,5096,Makueni,EASTERN,17304
MBOONI,Rural,3,2500,2397,4897,Makueni,EASTERN,17305
MBOONI,Rural,4,2619,2552,5171,Makueni,EASTERN,17306
MBOONI,Rural,5,2693,2528,5221,Makueni,EASTERN,17307
MBOONI,Rural,6,2636,2611,5247,Makueni,EASTERN,17308
MBOONI,Rural,7,2765,2523,5288,Makueni,EASTERN,17309
MBOONI,Rural,8,2513,2348,4861,Makueni,EASTERN,17310
MBOONI,Rural,9,2721,2637,5358,Makueni,EASTERN,17311
MBOONI,Rural,10,2760,2671,5431,Makueni,EASTERN,17312
MBOONI,Rural,11,2370,2445,4815,Makueni,EASTERN,17313
MBOONI,Rural,12,2768,2668,5436,Makueni,EASTERN,17314
MBOONI,Rural,13,2857,2784,5641,Makueni,EASTERN,17315
MBOONI,Rural,14,2522,2415,4937,Makueni,EASTERN,17316
MBOONI,Rural,15,2558,2498,5056,Makueni,EASTERN,17317
MBOONI,Rural,16,2376,2378,4754,Makueni,EASTERN,17318
MBOONI,Rural,17,2572,2243,4815,Makueni,EASTERN,17319
MBOONI,Rural,18,2181,1879,4060,Makueni,EASTERN,17320
MBOONI,Rural,19,2144,1691,3835,Makueni,EASTERN,17321
MBOONI,Rural,20,1771,1594,3365,Makueni,EASTERN,17322
MBOONI,Rural,21,1359,1187,2546,Makueni,EASTERN,17323
MBOONI,Rural,22,1180,1240,2420,Makueni,EASTERN,17324
MBOONI,Rural,23,1045,1283,2328,Makueni,EASTERN,17325
MBOONI,Rural,24,840,1090,1930,Makueni,EASTERN,17326
MBOONI,Rural,25,1000,1440,2440,Makueni,EASTERN,17327
MBOONI,Rural,26,753,1041,1794,Makueni,EASTERN,17328
MBOONI,Rural,27,853,1152,2005,Makueni,EASTERN,17329
MBOONI,Rural,28,636,1046,1682,Makueni,EASTERN,17330
MBOONI,Rural,29,849,1196,2045,Makueni,EASTERN,17331
MBOONI,Rural,30,950,1453,2403,Makueni,EASTERN,17332
MBOONI,Rural,31,726,974,1700,Makueni,EASTERN,17333
MBOONI,Rural,32,708,1022,1730,Makueni,EASTERN,17334
MBOONI,Rural,33,600,941,1541,Makueni,EASTERN,17335
MBOONI,Rural,34,684,967,1651,Makueni,EASTERN,17336
MBOONI,Rural,35,923,1350,2273,Makueni,EASTERN,17337
MBOONI,Rural,36,663,934,1597,Makueni,EASTERN,17338
MBOONI,Rural,37,660,896,1556,Makueni,EASTERN,17339
MBOONI,Rural,38,552,852,1404,Makueni,EASTERN,17340
MBOONI,Rural,39,700,943,1643,Makueni,EASTERN,17341
MBOONI,Rural,40,742,1062,1804,Makueni,EASTERN,17342
MBOONI,Rural,41,567,697,1264,Makueni,EASTERN,17343
MBOONI,Rural,42,450,593,1043,Makueni,EASTERN,17344
MBOONI,Rural,43,376,546,922,Makueni,EASTERN,17345
MBOONI,Rural,44,429,626,1055,Makueni,EASTERN,17346
MBOONI,Rural,45,598,958,1556,Makueni,EASTERN,17347
MBOONI,Rural,46,515,743,1258,Makueni,EASTERN,17348
MBOONI,Rural,47,451,675,1126,Makueni,EASTERN,17349
MBOONI,Rural,48,374,573,947,Makueni,EASTERN,17350
MBOONI,Rural,49,550,787,1337,Makueni,EASTERN,17351
MBOONI,Rural,50,659,973,1632,Makueni,EASTERN,17352
MBOONI,Rural,51,504,572,1076,Makueni,EASTERN,17353
MBOONI,Rural,52,458,560,1018,Makueni,EASTERN,17354
MBOONI,Rural,53,403,557,960,Makueni,EASTERN,17355
MBOONI,Rural,54,337,467,804,Makueni,EASTERN,17356
MBOONI,Rural,55,471,591,1062,Makueni,EASTERN,17357
MBOONI,Rural,56,394,445,839,Makueni,EASTERN,17358
MBOONI,Rural,57,589,785,1374,Makueni,EASTERN,17359
MBOONI,Rural,58,268,331,599,Makueni,EASTERN,17360
MBOONI,Rural,59,409,532,941,Makueni,EASTERN,17361
MBOONI,Rural,60,535,629,1164,Makueni,EASTERN,17362
MBOONI,Rural,61,418,471,889,Makueni,EASTERN,17363
MBOONI,Rural,62,256,270,526,Makueni,EASTERN,17364
MBOONI,Rural,63,285,371,656,Makueni,EASTERN,17365
MBOONI,Rural,64,254,446,700,Makueni,EASTERN,17366
MBOONI,Rural,65,250,377,627,Makueni,EASTERN,17367
MBOONI,Rural,66,139,203,342,Makueni,EASTERN,17368
MBOONI,Rural,67,278,366,644,Makueni,EASTERN,17369
MBOONI,Rural,68,174,202,376,Makueni,EASTERN,17370
MBOONI,Rural,69,227,431,658,Makueni,EASTERN,17371
MBOONI,Rural,70,380,508,888,Makueni,EASTERN,17372
MBOONI,Rural,71,197,252,449,Makueni,EASTERN,17373
MBOONI,Rural,72,169,174,343,Makueni,EASTERN,17374
MBOONI,Rural,73,200,184,384,Makueni,EASTERN,17375
MBOONI,Rural,74,158,211,369,Makueni,EASTERN,17376
MBOONI,Rural,75,189,238,427,Makueni,EASTERN,17377
MBOONI,Rural,76,100,113,213,Makueni,EASTERN,17378
MBOONI,Rural,77,114,157,271,Makueni,EASTERN,17379
MBOONI,Rural,78,92,140,232,Makueni,EASTERN,17380
MBOONI,Rural,79,196,334,530,Makueni,EASTERN,17381
MBOONI,Rural,80+,1478,2358,3836,Makueni,EASTERN,17382
MBOONI,Rural,Age NS,17,17,34,Makueni,EASTERN,17383
KIBWEZI,Rural,0,3493,3415,6908,Makueni,EASTERN,17384
KIBWEZI,Rural,1,3370,3253,6623,Makueni,EASTERN,17385
KIBWEZI,Rural,2,3713,3605,7318,Makueni,EASTERN,17386
KIBWEZI,Rural,3,3550,3624,7174,Makueni,EASTERN,17387
KIBWEZI,Rural,4,3792,3556,7348,Makueni,EASTERN,17388
KIBWEZI,Rural,5,4025,3679,7704,Makueni,EASTERN,17389
KIBWEZI,Rural,6,3695,3521,7216,Makueni,EASTERN,17390
KIBWEZI,Rural,7,3741,3684,7425,Makueni,EASTERN,17391
KIBWEZI,Rural,8,3568,3525,7093,Makueni,EASTERN,17392
KIBWEZI,Rural,9,3603,3466,7069,Makueni,EASTERN,17393
KIBWEZI,Rural,10,3528,3414,6942,Makueni,EASTERN,17394
KIBWEZI,Rural,11,2745,2813,5558,Makueni,EASTERN,17395
KIBWEZI,Rural,12,3410,3143,6553,Makueni,EASTERN,17396
KIBWEZI,Rural,13,3321,3260,6581,Makueni,EASTERN,17397
KIBWEZI,Rural,14,3057,2756,5813,Makueni,EASTERN,17398
KIBWEZI,Rural,15,3169,2851,6020,Makueni,EASTERN,17399
KIBWEZI,Rural,16,2693,2562,5255,Makueni,EASTERN,17400
KIBWEZI,Rural,17,2816,2484,5300,Makueni,EASTERN,17401
KIBWEZI,Rural,18,2650,2133,4783,Makueni,EASTERN,17402
KIBWEZI,Rural,19,2434,1982,4416,Makueni,EASTERN,17403
KIBWEZI,Rural,20,2358,2091,4449,Makueni,EASTERN,17404
KIBWEZI,Rural,21,1619,1571,3190,Makueni,EASTERN,17405
KIBWEZI,Rural,22,1711,1651,3362,Makueni,EASTERN,17406
KIBWEZI,Rural,23,1393,1733,3126,Makueni,EASTERN,17407
KIBWEZI,Rural,24,1256,1551,2807,Makueni,EASTERN,17408
KIBWEZI,Rural,25,1594,1888,3482,Makueni,EASTERN,17409
KIBWEZI,Rural,26,1142,1349,2491,Makueni,EASTERN,17410
KIBWEZI,Rural,27,1405,1649,3054,Makueni,EASTERN,17411
KIBWEZI,Rural,28,1114,1469,2583,Makueni,EASTERN,17412
KIBWEZI,Rural,29,1319,1579,2898,Makueni,EASTERN,17413
KIBWEZI,Rural,30,1622,2014,3636,Makueni,EASTERN,17414
KIBWEZI,Rural,31,1189,1213,2402,Makueni,EASTERN,17415
KIBWEZI,Rural,32,1212,1433,2645,Makueni,EASTERN,17416
KIBWEZI,Rural,33,904,945,1849,Makueni,EASTERN,17417
KIBWEZI,Rural,34,1179,1280,2459,Makueni,EASTERN,17418
KIBWEZI,Rural,35,1702,1873,3575,Makueni,EASTERN,17419
KIBWEZI,Rural,36,972,1030,2002,Makueni,EASTERN,17420
KIBWEZI,Rural,37,957,983,1940,Makueni,EASTERN,17421
KIBWEZI,Rural,38,901,966,1867,Makueni,EASTERN,17422
KIBWEZI,Rural,39,987,1069,2056,Makueni,EASTERN,17423
KIBWEZI,Rural,40,1258,1441,2699,Makueni,EASTERN,17424
KIBWEZI,Rural,41,774,731,1505,Makueni,EASTERN,17425
KIBWEZI,Rural,42,634,708,1342,Makueni,EASTERN,17426
KIBWEZI,Rural,43,555,648,1203,Makueni,EASTERN,17427
KIBWEZI,Rural,44,569,623,1192,Makueni,EASTERN,17428
KIBWEZI,Rural,45,940,1119,2059,Makueni,EASTERN,17429
KIBWEZI,Rural,46,669,837,1506,Makueni,EASTERN,17430
KIBWEZI,Rural,47,588,690,1278,Makueni,EASTERN,17431
KIBWEZI,Rural,48,455,593,1048,Makueni,EASTERN,17432
KIBWEZI,Rural,49,615,742,1357,Makueni,EASTERN,17433
KIBWEZI,Rural,50,884,1041,1925,Makueni,EASTERN,17434
KIBWEZI,Rural,51,545,637,1182,Makueni,EASTERN,17435
KIBWEZI,Rural,52,585,576,1161,Makueni,EASTERN,17436
KIBWEZI,Rural,53,441,548,989,Makueni,EASTERN,17437
KIBWEZI,Rural,54,440,495,935,Makueni,EASTERN,17438
KIBWEZI,Rural,55,533,686,1219,Makueni,EASTERN,17439
KIBWEZI,Rural,56,493,514,1007,Makueni,EASTERN,17440
KIBWEZI,Rural,57,731,828,1559,Makueni,EASTERN,17441
KIBWEZI,Rural,58,366,394,760,Makueni,EASTERN,17442
KIBWEZI,Rural,59,445,510,955,Makueni,EASTERN,17443
KIBWEZI,Rural,60,668,749,1417,Makueni,EASTERN,17444
KIBWEZI,Rural,61,427,421,848,Makueni,EASTERN,17445
KIBWEZI,Rural,62,325,290,615,Makueni,EASTERN,17446
KIBWEZI,Rural,63,334,341,675,Makueni,EASTERN,17447
KIBWEZI,Rural,64,302,382,684,Makueni,EASTERN,17448
KIBWEZI,Rural,65,354,410,764,Makueni,EASTERN,17449
KIBWEZI,Rural,66,153,187,340,Makueni,EASTERN,17450
KIBWEZI,Rural,67,324,342,666,Makueni,EASTERN,17451
KIBWEZI,Rural,68,198,203,401,Makueni,EASTERN,17452
KIBWEZI,Rural,69,220,302,522,Makueni,EASTERN,17453
KIBWEZI,Rural,70,411,491,902,Makueni,EASTERN,17454
KIBWEZI,Rural,71,182,160,342,Makueni,EASTERN,17455
KIBWEZI,Rural,72,180,139,319,Makueni,EASTERN,17456
KIBWEZI,Rural,73,186,158,344,Makueni,EASTERN,17457
KIBWEZI,Rural,74,174,196,370,Makueni,EASTERN,17458
KIBWEZI,Rural,75,182,189,371,Makueni,EASTERN,17459
KIBWEZI,Rural,76,97,92,189,Makueni,EASTERN,17460
KIBWEZI,Rural,77,116,101,217,Makueni,EASTERN,17461
KIBWEZI,Rural,78,102,118,220,Makueni,EASTERN,17462
KIBWEZI,Rural,79,125,254,379,Makueni,EASTERN,17463
KIBWEZI,Rural,80+,1260,2038,3298,Makueni,EASTERN,17464
KIBWEZI,Rural,Age NS,64,51,115,Makueni,EASTERN,17465
NZAUI,Rural,0,2624,2576,5200,Makueni,EASTERN,17466
NZAUI,Rural,1,2658,2665,5323,Makueni,EASTERN,17467
NZAUI,Rural,2,2855,2914,5769,Makueni,EASTERN,17468
NZAUI,Rural,3,2821,2744,5565,Makueni,EASTERN,17469
NZAUI,Rural,4,2844,2753,5597,Makueni,EASTERN,17470
NZAUI,Rural,5,3078,3027,6105,Makueni,EASTERN,17471
NZAUI,Rural,6,3021,2963,5984,Makueni,EASTERN,17472
NZAUI,Rural,7,3022,2863,5885,Makueni,EASTERN,17473
NZAUI,Rural,8,2800,2843,5643,Makueni,EASTERN,17474
NZAUI,Rural,9,3124,2975,6099,Makueni,EASTERN,17475
NZAUI,Rural,10,3162,3078,6240,Makueni,EASTERN,17476
NZAUI,Rural,11,2633,2686,5319,Makueni,EASTERN,17477
NZAUI,Rural,12,2991,2780,5771,Makueni,EASTERN,17478
NZAUI,Rural,13,2979,2937,5916,Makueni,EASTERN,17479
NZAUI,Rural,14,2948,2655,5603,Makueni,EASTERN,17480
NZAUI,Rural,15,2718,2606,5324,Makueni,EASTERN,17481
NZAUI,Rural,16,2594,2428,5022,Makueni,EASTERN,17482
NZAUI,Rural,17,2563,2245,4808,Makueni,EASTERN,17483
NZAUI,Rural,18,2468,1932,4400,Makueni,EASTERN,17484
NZAUI,Rural,19,2237,1706,3943,Makueni,EASTERN,17485
NZAUI,Rural,20,1991,1716,3707,Makueni,EASTERN,17486
NZAUI,Rural,21,1500,1202,2702,Makueni,EASTERN,17487
NZAUI,Rural,22,1404,1266,2670,Makueni,EASTERN,17488
NZAUI,Rural,23,1241,1392,2633,Makueni,EASTERN,17489
NZAUI,Rural,24,1036,1148,2184,Makueni,EASTERN,17490
NZAUI,Rural,25,1304,1481,2785,Makueni,EASTERN,17491
NZAUI,Rural,26,967,1212,2179,Makueni,EASTERN,17492
NZAUI,Rural,27,1104,1456,2560,Makueni,EASTERN,17493
NZAUI,Rural,28,846,1164,2010,Makueni,EASTERN,17494
NZAUI,Rural,29,1065,1303,2368,Makueni,EASTERN,17495
NZAUI,Rural,30,1227,1499,2726,Makueni,EASTERN,17496
NZAUI,Rural,31,968,1052,2020,Makueni,EASTERN,17497
NZAUI,Rural,32,894,1059,1953,Makueni,EASTERN,17498
NZAUI,Rural,33,802,1005,1807,Makueni,EASTERN,17499
NZAUI,Rural,34,905,1139,2044,Makueni,EASTERN,17500
NZAUI,Rural,35,1143,1479,2622,Makueni,EASTERN,17501
NZAUI,Rural,36,756,936,1692,Makueni,EASTERN,17502
NZAUI,Rural,37,818,988,1806,Makueni,EASTERN,17503
NZAUI,Rural,38,656,829,1485,Makueni,EASTERN,17504
NZAUI,Rural,39,832,1019,1851,Makueni,EASTERN,17505
NZAUI,Rural,40,899,1230,2129,Makueni,EASTERN,17506
NZAUI,Rural,41,721,766,1487,Makueni,EASTERN,17507
NZAUI,Rural,42,594,713,1307,Makueni,EASTERN,17508
NZAUI,Rural,43,541,631,1172,Makueni,EASTERN,17509
NZAUI,Rural,44,516,556,1072,Makueni,EASTERN,17510
NZAUI,Rural,45,776,989,1765,Makueni,EASTERN,17511
NZAUI,Rural,46,601,777,1378,Makueni,EASTERN,17512
NZAUI,Rural,47,534,699,1233,Makueni,EASTERN,17513
NZAUI,Rural,48,434,581,1015,Makueni,EASTERN,17514
NZAUI,Rural,49,613,740,1353,Makueni,EASTERN,17515
NZAUI,Rural,50,717,906,1623,Makueni,EASTERN,17516
NZAUI,Rural,51,539,641,1180,Makueni,EASTERN,17517
NZAUI,Rural,52,494,579,1073,Makueni,EASTERN,17518
NZAUI,Rural,53,455,541,996,Makueni,EASTERN,17519
NZAUI,Rural,54,429,453,882,Makueni,EASTERN,17520
NZAUI,Rural,55,522,643,1165,Makueni,EASTERN,17521
NZAUI,Rural,56,424,462,886,Makueni,EASTERN,17522
NZAUI,Rural,57,620,740,1360,Makueni,EASTERN,17523
NZAUI,Rural,58,317,324,641,Makueni,EASTERN,17524
NZAUI,Rural,59,375,548,923,Makueni,EASTERN,17525
NZAUI,Rural,60,542,660,1202,Makueni,EASTERN,17526
NZAUI,Rural,61,383,429,812,Makueni,EASTERN,17527
NZAUI,Rural,62,283,294,577,Makueni,EASTERN,17528
NZAUI,Rural,63,303,318,621,Makueni,EASTERN,17529
NZAUI,Rural,64,320,435,755,Makueni,EASTERN,17530
NZAUI,Rural,65,256,327,583,Makueni,EASTERN,17531
NZAUI,Rural,66,167,204,371,Makueni,EASTERN,17532
NZAUI,Rural,67,302,322,624,Makueni,EASTERN,17533
NZAUI,Rural,68,164,189,353,Makueni,EASTERN,17534
NZAUI,Rural,69,228,425,653,Makueni,EASTERN,17535
NZAUI,Rural,70,334,553,887,Makueni,EASTERN,17536
NZAUI,Rural,71,203,215,418,Makueni,EASTERN,17537
NZAUI,Rural,72,171,167,338,Makueni,EASTERN,17538
NZAUI,Rural,73,194,188,382,Makueni,EASTERN,17539
NZAUI,Rural,74,177,248,425,Makueni,EASTERN,17540
NZAUI,Rural,75,149,240,389,Makueni,EASTERN,17541
NZAUI,Rural,76,110,96,206,Makueni,EASTERN,17542
NZAUI,Rural,77,123,139,262,Makueni,EASTERN,17543
NZAUI,Rural,78,129,149,278,Makueni,EASTERN,17544
NZAUI,Rural,79,156,359,515,Makueni,EASTERN,17545
NZAUI,Rural,80+,1530,2170,3700,Makueni,EASTERN,17546
NZAUI,Rural,Age NS,17,14,31,Makueni,EASTERN,17547
GARISSA,Rural,0,708,670,1378,Garissa,NORTH EASTERN,17548
GARISSA,Rural,1,621,513,1134,Garissa,NORTH EASTERN,17549
GARISSA,Rural,2,1437,1158,2595,Garissa,NORTH EASTERN,17550
GARISSA,Rural,3,993,836,1829,Garissa,NORTH EASTERN,17551
GARISSA,Rural,4,1513,1256,2769,Garissa,NORTH EASTERN,17552
GARISSA,Rural,5,1111,994,2105,Garissa,NORTH EASTERN,17553
GARISSA,Rural,6,1873,1454,3327,Garissa,NORTH EASTERN,17554
GARISSA,Rural,7,1035,874,1909,Garissa,NORTH EASTERN,17555
GARISSA,Rural,8,1972,1629,3601,Garissa,NORTH EASTERN,17556
GARISSA,Rural,9,1040,829,1869,Garissa,NORTH EASTERN,17557
GARISSA,Rural,10,2436,1795,4231,Garissa,NORTH EASTERN,17558
GARISSA,Rural,11,799,707,1506,Garissa,NORTH EASTERN,17559
GARISSA,Rural,12,1922,1387,3309,Garissa,NORTH EASTERN,17560
GARISSA,Rural,13,1009,709,1718,Garissa,NORTH EASTERN,17561
GARISSA,Rural,14,1548,987,2535,Garissa,NORTH EASTERN,17562
GARISSA,Rural,15,1292,839,2131,Garissa,NORTH EASTERN,17563
GARISSA,Rural,16,1461,913,2374,Garissa,NORTH EASTERN,17564
GARISSA,Rural,17,789,539,1328,Garissa,NORTH EASTERN,17565
GARISSA,Rural,18,1631,1095,2726,Garissa,NORTH EASTERN,17566
GARISSA,Rural,19,475,425,900,Garissa,NORTH EASTERN,17567
GARISSA,Rural,20,1678,1236,2914,Garissa,NORTH EASTERN,17568
GARISSA,Rural,21,428,272,700,Garissa,NORTH EASTERN,17569
GARISSA,Rural,22,664,482,1146,Garissa,NORTH EASTERN,17570
GARISSA,Rural,23,381,303,684,Garissa,NORTH EASTERN,17571
GARISSA,Rural,24,454,417,871,Garissa,NORTH EASTERN,17572
GARISSA,Rural,25,814,805,1619,Garissa,NORTH EASTERN,17573
GARISSA,Rural,26,435,478,913,Garissa,NORTH EASTERN,17574
GARISSA,Rural,27,269,316,585,Garissa,NORTH EASTERN,17575
GARISSA,Rural,28,647,676,1323,Garissa,NORTH EASTERN,17576
GARISSA,Rural,29,215,269,484,Garissa,NORTH EASTERN,17577
GARISSA,Rural,30,1191,1175,2366,Garissa,NORTH EASTERN,17578
GARISSA,Rural,31,125,159,284,Garissa,NORTH EASTERN,17579
GARISSA,Rural,32,315,411,726,Garissa,NORTH EASTERN,17580
GARISSA,Rural,33,143,168,311,Garissa,NORTH EASTERN,17581
GARISSA,Rural,34,183,165,348,Garissa,NORTH EASTERN,17582
GARISSA,Rural,35,581,674,1255,Garissa,NORTH EASTERN,17583
GARISSA,Rural,36,198,225,423,Garissa,NORTH EASTERN,17584
GARISSA,Rural,37,142,157,299,Garissa,NORTH EASTERN,17585
GARISSA,Rural,38,300,395,695,Garissa,NORTH EASTERN,17586
GARISSA,Rural,39,114,172,286,Garissa,NORTH EASTERN,17587
GARISSA,Rural,40,1066,871,1937,Garissa,NORTH EASTERN,17588
GARISSA,Rural,41,97,84,181,Garissa,NORTH EASTERN,17589
GARISSA,Rural,42,224,188,412,Garissa,NORTH EASTERN,17590
GARISSA,Rural,43,137,112,249,Garissa,NORTH EASTERN,17591
GARISSA,Rural,44,99,59,158,Garissa,NORTH EASTERN,17592
GARISSA,Rural,45,404,339,743,Garissa,NORTH EASTERN,17593
GARISSA,Rural,46,127,91,218,Garissa,NORTH EASTERN,17594
GARISSA,Rural,47,99,94,193,Garissa,NORTH EASTERN,17595
GARISSA,Rural,48,254,182,436,Garissa,NORTH EASTERN,17596
GARISSA,Rural,49,93,74,167,Garissa,NORTH EASTERN,17597
GARISSA,Rural,50,639,427,1066,Garissa,NORTH EASTERN,17598
GARISSA,Rural,51,59,28,87,Garissa,NORTH EASTERN,17599
GARISSA,Rural,52,151,81,232,Garissa,NORTH EASTERN,17600
GARISSA,Rural,53,66,31,97,Garissa,NORTH EASTERN,17601
GARISSA,Rural,54,85,46,131,Garissa,NORTH EASTERN,17602
GARISSA,Rural,55,197,103,300,Garissa,NORTH EASTERN,17603
GARISSA,Rural,56,114,44,158,Garissa,NORTH EASTERN,17604
GARISSA,Rural,57,56,15,71,Garissa,NORTH EASTERN,17605
GARISSA,Rural,58,96,57,153,Garissa,NORTH EASTERN,17606
GARISSA,Rural,59,47,20,67,Garissa,NORTH EASTERN,17607
GARISSA,Rural,60,464,226,690,Garissa,NORTH EASTERN,17608
GARISSA,Rural,61,24,9,33,Garissa,NORTH EASTERN,17609
GARISSA,Rural,62,59,25,84,Garissa,NORTH EASTERN,17610
GARISSA,Rural,63,48,23,71,Garissa,NORTH EASTERN,17611
GARISSA,Rural,64,42,19,61,Garissa,NORTH EASTERN,17612
GARISSA,Rural,65,109,58,167,Garissa,NORTH EASTERN,17613
GARISSA,Rural,66,15,5,20,Garissa,NORTH EASTERN,17614
GARISSA,Rural,67,29,10,39,Garissa,NORTH EASTERN,17615
GARISSA,Rural,68,65,25,90,Garissa,NORTH EASTERN,17616
GARISSA,Rural,69,20,8,28,Garissa,NORTH EASTERN,17617
GARISSA,Rural,70,296,122,418,Garissa,NORTH EASTERN,17618
GARISSA,Rural,71,24,7,31,Garissa,NORTH EASTERN,17619
GARISSA,Rural,72,47,28,75,Garissa,NORTH EASTERN,17620
GARISSA,Rural,73,23,11,34,Garissa,NORTH EASTERN,17621
GARISSA,Rural,74,23,11,34,Garissa,NORTH EASTERN,17622
GARISSA,Rural,75,54,28,82,Garissa,NORTH EASTERN,17623
GARISSA,Rural,76,20,5,25,Garissa,NORTH EASTERN,17624
GARISSA,Rural,77,14,13,27,Garissa,NORTH EASTERN,17625
GARISSA,Rural,78,18,5,23,Garissa,NORTH EASTERN,17626
GARISSA,Rural,79,6,4,10,Garissa,NORTH EASTERN,17627
GARISSA,Rural,80+,258,211,469,Garissa,NORTH EASTERN,17628
GARISSA,Rural,Age NS,23,13,36,Garissa,NORTH EASTERN,17629
LAGDERA,Rural,0,2532,2319,4851,Garissa,NORTH EASTERN,17630
LAGDERA,Rural,1,2300,2109,4409,Garissa,NORTH EASTERN,17631
LAGDERA,Rural,2,4440,3994,8434,Garissa,NORTH EASTERN,17632
LAGDERA,Rural,3,3454,3141,6595,Garissa,NORTH EASTERN,17633
LAGDERA,Rural,4,4856,4299,9155,Garissa,NORTH EASTERN,17634
LAGDERA,Rural,5,3940,3421,7361,Garissa,NORTH EASTERN,17635
LAGDERA,Rural,6,5394,4634,10028,Garissa,NORTH EASTERN,17636
LAGDERA,Rural,7,3722,3135,6857,Garissa,NORTH EASTERN,17637
LAGDERA,Rural,8,6178,5008,11186,Garissa,NORTH EASTERN,17638
LAGDERA,Rural,9,3213,2780,5993,Garissa,NORTH EASTERN,17639
LAGDERA,Rural,10,6874,5510,12384,Garissa,NORTH EASTERN,17640
LAGDERA,Rural,11,2514,2408,4922,Garissa,NORTH EASTERN,17641
LAGDERA,Rural,12,5682,3824,9506,Garissa,NORTH EASTERN,17642
LAGDERA,Rural,13,3323,2321,5644,Garissa,NORTH EASTERN,17643
LAGDERA,Rural,14,4653,3023,7676,Garissa,NORTH EASTERN,17644
LAGDERA,Rural,15,3979,2768,6747,Garissa,NORTH EASTERN,17645
LAGDERA,Rural,16,3974,2514,6488,Garissa,NORTH EASTERN,17646
LAGDERA,Rural,17,2313,1770,4083,Garissa,NORTH EASTERN,17647
LAGDERA,Rural,18,4962,3292,8254,Garissa,NORTH EASTERN,17648
LAGDERA,Rural,19,1854,1461,3315,Garissa,NORTH EASTERN,17649
LAGDERA,Rural,20,5122,4138,9260,Garissa,NORTH EASTERN,17650
LAGDERA,Rural,21,1366,967,2333,Garissa,NORTH EASTERN,17651
LAGDERA,Rural,22,2050,1650,3700,Garissa,NORTH EASTERN,17652
LAGDERA,Rural,23,1308,1174,2482,Garissa,NORTH EASTERN,17653
LAGDERA,Rural,24,1395,1183,2578,Garissa,NORTH EASTERN,17654
LAGDERA,Rural,25,2660,2989,5649,Garissa,NORTH EASTERN,17655
LAGDERA,Rural,26,1059,1098,2157,Garissa,NORTH EASTERN,17656
LAGDERA,Rural,27,897,1068,1965,Garissa,NORTH EASTERN,17657
LAGDERA,Rural,28,1490,1888,3378,Garissa,NORTH EASTERN,17658
LAGDERA,Rural,29,650,885,1535,Garissa,NORTH EASTERN,17659
LAGDERA,Rural,30,3568,3976,7544,Garissa,NORTH EASTERN,17660
LAGDERA,Rural,31,445,511,956,Garissa,NORTH EASTERN,17661
LAGDERA,Rural,32,891,1122,2013,Garissa,NORTH EASTERN,17662
LAGDERA,Rural,33,450,622,1072,Garissa,NORTH EASTERN,17663
LAGDERA,Rural,34,448,612,1060,Garissa,NORTH EASTERN,17664
LAGDERA,Rural,35,1992,2569,4561,Garissa,NORTH EASTERN,17665
LAGDERA,Rural,36,589,775,1364,Garissa,NORTH EASTERN,17666
LAGDERA,Rural,37,519,685,1204,Garissa,NORTH EASTERN,17667
LAGDERA,Rural,38,954,1163,2117,Garissa,NORTH EASTERN,17668
LAGDERA,Rural,39,508,550,1058,Garissa,NORTH EASTERN,17669
LAGDERA,Rural,40,3682,3136,6818,Garissa,NORTH EASTERN,17670
LAGDERA,Rural,41,382,310,692,Garissa,NORTH EASTERN,17671
LAGDERA,Rural,42,736,616,1352,Garissa,NORTH EASTERN,17672
LAGDERA,Rural,43,407,310,717,Garissa,NORTH EASTERN,17673
LAGDERA,Rural,44,320,289,609,Garissa,NORTH EASTERN,17674
LAGDERA,Rural,45,1346,1181,2527,Garissa,NORTH EASTERN,17675
LAGDERA,Rural,46,342,252,594,Garissa,NORTH EASTERN,17676
LAGDERA,Rural,47,347,250,597,Garissa,NORTH EASTERN,17677
LAGDERA,Rural,48,645,427,1072,Garissa,NORTH EASTERN,17678
LAGDERA,Rural,49,332,218,550,Garissa,NORTH EASTERN,17679
LAGDERA,Rural,50,2251,1423,3674,Garissa,NORTH EASTERN,17680
LAGDERA,Rural,51,186,92,278,Garissa,NORTH EASTERN,17681
LAGDERA,Rural,52,407,189,596,Garissa,NORTH EASTERN,17682
LAGDERA,Rural,53,223,109,332,Garissa,NORTH EASTERN,17683
LAGDERA,Rural,54,218,127,345,Garissa,NORTH EASTERN,17684
LAGDERA,Rural,55,700,415,1115,Garissa,NORTH EASTERN,17685
LAGDERA,Rural,56,226,113,339,Garissa,NORTH EASTERN,17686
LAGDERA,Rural,57,155,76,231,Garissa,NORTH EASTERN,17687
LAGDERA,Rural,58,225,99,324,Garissa,NORTH EASTERN,17688
LAGDERA,Rural,59,133,54,187,Garissa,NORTH EASTERN,17689
LAGDERA,Rural,60,1497,894,2391,Garissa,NORTH EASTERN,17690
LAGDERA,Rural,61,100,53,153,Garissa,NORTH EASTERN,17691
LAGDERA,Rural,62,136,78,214,Garissa,NORTH EASTERN,17692
LAGDERA,Rural,63,129,54,183,Garissa,NORTH EASTERN,17693
LAGDERA,Rural,64,106,47,153,Garissa,NORTH EASTERN,17694
LAGDERA,Rural,65,314,207,521,Garissa,NORTH EASTERN,17695
LAGDERA,Rural,66,77,37,114,Garissa,NORTH EASTERN,17696
LAGDERA,Rural,67,80,39,119,Garissa,NORTH EASTERN,17697
LAGDERA,Rural,68,116,63,179,Garissa,NORTH EASTERN,17698
LAGDERA,Rural,69,53,38,91,Garissa,NORTH EASTERN,17699
LAGDERA,Rural,70,756,489,1245,Garissa,NORTH EASTERN,17700
LAGDERA,Rural,71,35,36,71,Garissa,NORTH EASTERN,17701
LAGDERA,Rural,72,70,50,120,Garissa,NORTH EASTERN,17702
LAGDERA,Rural,73,60,22,82,Garissa,NORTH EASTERN,17703
LAGDERA,Rural,74,69,31,100,Garissa,NORTH EASTERN,17704
LAGDERA,Rural,75,128,78,206,Garissa,NORTH EASTERN,17705
LAGDERA,Rural,76,39,19,58,Garissa,NORTH EASTERN,17706
LAGDERA,Rural,77,44,25,69,Garissa,NORTH EASTERN,17707
LAGDERA,Rural,78,44,32,76,Garissa,NORTH EASTERN,17708
LAGDERA,Rural,79,37,28,65,Garissa,NORTH EASTERN,17709
LAGDERA,Rural,80+,839,762,1601,Garissa,NORTH EASTERN,17710
LAGDERA,Rural,Age NS,102,81,183,Garissa,NORTH EASTERN,17711
FAFI,Rural,0,1594,1462,3056,Garissa,NORTH EASTERN,17712
FAFI,Rural,1,1133,954,2087,Garissa,NORTH EASTERN,17713
FAFI,Rural,2,1947,1773,3720,Garissa,NORTH EASTERN,17714
FAFI,Rural,3,1767,1588,3355,Garissa,NORTH EASTERN,17715
FAFI,Rural,4,1923,1649,3572,Garissa,NORTH EASTERN,17716
FAFI,Rural,5,1767,1586,3353,Garissa,NORTH EASTERN,17717
FAFI,Rural,6,1921,1708,3629,Garissa,NORTH EASTERN,17718
FAFI,Rural,7,1681,1418,3099,Garissa,NORTH EASTERN,17719
FAFI,Rural,8,1938,1653,3591,Garissa,NORTH EASTERN,17720
FAFI,Rural,9,1399,1229,2628,Garissa,NORTH EASTERN,17721
FAFI,Rural,10,2220,1767,3987,Garissa,NORTH EASTERN,17722
FAFI,Rural,11,1070,950,2020,Garissa,NORTH EASTERN,17723
FAFI,Rural,12,1836,1276,3112,Garissa,NORTH EASTERN,17724
FAFI,Rural,13,1407,1075,2482,Garissa,NORTH EASTERN,17725
FAFI,Rural,14,1455,1072,2527,Garissa,NORTH EASTERN,17726
FAFI,Rural,15,1564,1125,2689,Garissa,NORTH EASTERN,17727
FAFI,Rural,16,1148,795,1943,Garissa,NORTH EASTERN,17728
FAFI,Rural,17,986,769,1755,Garissa,NORTH EASTERN,17729
FAFI,Rural,18,1633,1424,3057,Garissa,NORTH EASTERN,17730
FAFI,Rural,19,860,736,1596,Garissa,NORTH EASTERN,17731
FAFI,Rural,20,2080,1877,3957,Garissa,NORTH EASTERN,17732
FAFI,Rural,21,597,531,1128,Garissa,NORTH EASTERN,17733
FAFI,Rural,22,897,832,1729,Garissa,NORTH EASTERN,17734
FAFI,Rural,23,666,604,1270,Garissa,NORTH EASTERN,17735
FAFI,Rural,24,548,517,1065,Garissa,NORTH EASTERN,17736
FAFI,Rural,25,1165,1392,2557,Garissa,NORTH EASTERN,17737
FAFI,Rural,26,455,485,940,Garissa,NORTH EASTERN,17738
FAFI,Rural,27,408,488,896,Garissa,NORTH EASTERN,17739
FAFI,Rural,28,572,674,1246,Garissa,NORTH EASTERN,17740
FAFI,Rural,29,278,342,620,Garissa,NORTH EASTERN,17741
FAFI,Rural,30,1395,1562,2957,Garissa,NORTH EASTERN,17742
FAFI,Rural,31,168,191,359,Garissa,NORTH EASTERN,17743
FAFI,Rural,32,371,422,793,Garissa,NORTH EASTERN,17744
FAFI,Rural,33,212,240,452,Garissa,NORTH EASTERN,17745
FAFI,Rural,34,175,195,370,Garissa,NORTH EASTERN,17746
FAFI,Rural,35,778,986,1764,Garissa,NORTH EASTERN,17747
FAFI,Rural,36,240,287,527,Garissa,NORTH EASTERN,17748
FAFI,Rural,37,214,309,523,Garissa,NORTH EASTERN,17749
FAFI,Rural,38,307,387,694,Garissa,NORTH EASTERN,17750
FAFI,Rural,39,155,197,352,Garissa,NORTH EASTERN,17751
FAFI,Rural,40,1220,1232,2452,Garissa,NORTH EASTERN,17752
FAFI,Rural,41,107,100,207,Garissa,NORTH EASTERN,17753
FAFI,Rural,42,222,221,443,Garissa,NORTH EASTERN,17754
FAFI,Rural,43,115,125,240,Garissa,NORTH EASTERN,17755
FAFI,Rural,44,131,108,239,Garissa,NORTH EASTERN,17756
FAFI,Rural,45,548,493,1041,Garissa,NORTH EASTERN,17757
FAFI,Rural,46,124,86,210,Garissa,NORTH EASTERN,17758
FAFI,Rural,47,116,89,205,Garissa,NORTH EASTERN,17759
FAFI,Rural,48,187,150,337,Garissa,NORTH EASTERN,17760
FAFI,Rural,49,109,75,184,Garissa,NORTH EASTERN,17761
FAFI,Rural,50,809,691,1500,Garissa,NORTH EASTERN,17762
FAFI,Rural,51,57,43,100,Garissa,NORTH EASTERN,17763
FAFI,Rural,52,135,71,206,Garissa,NORTH EASTERN,17764
FAFI,Rural,53,92,52,144,Garissa,NORTH EASTERN,17765
FAFI,Rural,54,87,52,139,Garissa,NORTH EASTERN,17766
FAFI,Rural,55,263,234,497,Garissa,NORTH EASTERN,17767
FAFI,Rural,56,80,50,130,Garissa,NORTH EASTERN,17768
FAFI,Rural,57,68,36,104,Garissa,NORTH EASTERN,17769
FAFI,Rural,58,71,38,109,Garissa,NORTH EASTERN,17770
FAFI,Rural,59,48,21,69,Garissa,NORTH EASTERN,17771
FAFI,Rural,60,575,432,1007,Garissa,NORTH EASTERN,17772
FAFI,Rural,61,46,26,72,Garissa,NORTH EASTERN,17773
FAFI,Rural,62,55,33,88,Garissa,NORTH EASTERN,17774
FAFI,Rural,63,59,38,97,Garissa,NORTH EASTERN,17775
FAFI,Rural,64,45,29,74,Garissa,NORTH EASTERN,17776
FAFI,Rural,65,153,104,257,Garissa,NORTH EASTERN,17777
FAFI,Rural,66,42,18,60,Garissa,NORTH EASTERN,17778
FAFI,Rural,67,52,21,73,Garissa,NORTH EASTERN,17779
FAFI,Rural,68,50,33,83,Garissa,NORTH EASTERN,17780
FAFI,Rural,69,20,20,40,Garissa,NORTH EASTERN,17781
FAFI,Rural,70,317,256,573,Garissa,NORTH EASTERN,17782
FAFI,Rural,71,16,16,32,Garissa,NORTH EASTERN,17783
FAFI,Rural,72,35,22,57,Garissa,NORTH EASTERN,17784
FAFI,Rural,73,41,25,66,Garissa,NORTH EASTERN,17785
FAFI,Rural,74,30,18,48,Garissa,NORTH EASTERN,17786
FAFI,Rural,75,66,57,123,Garissa,NORTH EASTERN,17787
FAFI,Rural,76,19,15,34,Garissa,NORTH EASTERN,17788
FAFI,Rural,77,18,23,41,Garissa,NORTH EASTERN,17789
FAFI,Rural,78,24,7,31,Garissa,NORTH EASTERN,17790
FAFI,Rural,79,17,16,33,Garissa,NORTH EASTERN,17791
FAFI,Rural,80+,401,382,783,Garissa,NORTH EASTERN,17792
FAFI,Rural,Age NS,21,14,35,Garissa,NORTH EASTERN,17793
IJARA,Rural,0,695,636,1331,Garissa,NORTH EASTERN,17794
IJARA,Rural,1,754,686,1440,Garissa,NORTH EASTERN,17795
IJARA,Rural,2,1327,1262,2589,Garissa,NORTH EASTERN,17796
IJARA,Rural,3,1171,1073,2244,Garissa,NORTH EASTERN,17797
IJARA,Rural,4,1555,1450,3005,Garissa,NORTH EASTERN,17798
IJARA,Rural,5,1321,1124,2445,Garissa,NORTH EASTERN,17799
IJARA,Rural,6,1909,1606,3515,Garissa,NORTH EASTERN,17800
IJARA,Rural,7,1298,1038,2336,Garissa,NORTH EASTERN,17801
IJARA,Rural,8,2159,1796,3955,Garissa,NORTH EASTERN,17802
IJARA,Rural,9,1195,1056,2251,Garissa,NORTH EASTERN,17803
IJARA,Rural,10,2618,2000,4618,Garissa,NORTH EASTERN,17804
IJARA,Rural,11,836,824,1660,Garissa,NORTH EASTERN,17805
IJARA,Rural,12,2048,1485,3533,Garissa,NORTH EASTERN,17806
IJARA,Rural,13,1159,804,1963,Garissa,NORTH EASTERN,17807
IJARA,Rural,14,1567,1045,2612,Garissa,NORTH EASTERN,17808
IJARA,Rural,15,1480,1013,2493,Garissa,NORTH EASTERN,17809
IJARA,Rural,16,1412,958,2370,Garissa,NORTH EASTERN,17810
IJARA,Rural,17,805,533,1338,Garissa,NORTH EASTERN,17811
IJARA,Rural,18,1657,1112,2769,Garissa,NORTH EASTERN,17812
IJARA,Rural,19,490,366,856,Garissa,NORTH EASTERN,17813
IJARA,Rural,20,1577,1206,2783,Garissa,NORTH EASTERN,17814
IJARA,Rural,21,409,290,699,Garissa,NORTH EASTERN,17815
IJARA,Rural,22,598,451,1049,Garissa,NORTH EASTERN,17816
IJARA,Rural,23,385,317,702,Garissa,NORTH EASTERN,17817
IJARA,Rural,24,424,365,789,Garissa,NORTH EASTERN,17818
IJARA,Rural,25,829,907,1736,Garissa,NORTH EASTERN,17819
IJARA,Rural,26,352,375,727,Garissa,NORTH EASTERN,17820
IJARA,Rural,27,245,296,541,Garissa,NORTH EASTERN,17821
IJARA,Rural,28,531,654,1185,Garissa,NORTH EASTERN,17822
IJARA,Rural,29,191,297,488,Garissa,NORTH EASTERN,17823
IJARA,Rural,30,1105,1289,2394,Garissa,NORTH EASTERN,17824
IJARA,Rural,31,132,181,313,Garissa,NORTH EASTERN,17825
IJARA,Rural,32,262,367,629,Garissa,NORTH EASTERN,17826
IJARA,Rural,33,136,187,323,Garissa,NORTH EASTERN,17827
IJARA,Rural,34,147,172,319,Garissa,NORTH EASTERN,17828
IJARA,Rural,35,586,801,1387,Garissa,NORTH EASTERN,17829
IJARA,Rural,36,193,238,431,Garissa,NORTH EASTERN,17830
IJARA,Rural,37,138,163,301,Garissa,NORTH EASTERN,17831
IJARA,Rural,38,288,385,673,Garissa,NORTH EASTERN,17832
IJARA,Rural,39,141,144,285,Garissa,NORTH EASTERN,17833
IJARA,Rural,40,1048,900,1948,Garissa,NORTH EASTERN,17834
IJARA,Rural,41,113,88,201,Garissa,NORTH EASTERN,17835
IJARA,Rural,42,232,179,411,Garissa,NORTH EASTERN,17836
IJARA,Rural,43,139,143,282,Garissa,NORTH EASTERN,17837
IJARA,Rural,44,82,78,160,Garissa,NORTH EASTERN,17838
IJARA,Rural,45,464,384,848,Garissa,NORTH EASTERN,17839
IJARA,Rural,46,128,77,205,Garissa,NORTH EASTERN,17840
IJARA,Rural,47,105,70,175,Garissa,NORTH EASTERN,17841
IJARA,Rural,48,174,170,344,Garissa,NORTH EASTERN,17842
IJARA,Rural,49,107,82,189,Garissa,NORTH EASTERN,17843
IJARA,Rural,50,680,492,1172,Garissa,NORTH EASTERN,17844
IJARA,Rural,51,65,37,102,Garissa,NORTH EASTERN,17845
IJARA,Rural,52,153,69,222,Garissa,NORTH EASTERN,17846
IJARA,Rural,53,76,41,117,Garissa,NORTH EASTERN,17847
IJARA,Rural,54,72,31,103,Garissa,NORTH EASTERN,17848
IJARA,Rural,55,226,133,359,Garissa,NORTH EASTERN,17849
IJARA,Rural,56,93,44,137,Garissa,NORTH EASTERN,17850
IJARA,Rural,57,67,24,91,Garissa,NORTH EASTERN,17851
IJARA,Rural,58,72,40,112,Garissa,NORTH EASTERN,17852
IJARA,Rural,59,45,9,54,Garissa,NORTH EASTERN,17853
IJARA,Rural,60,419,275,694,Garissa,NORTH EASTERN,17854
IJARA,Rural,61,30,19,49,Garissa,NORTH EASTERN,17855
IJARA,Rural,62,70,23,93,Garissa,NORTH EASTERN,17856
IJARA,Rural,63,42,11,53,Garissa,NORTH EASTERN,17857
IJARA,Rural,64,26,12,38,Garissa,NORTH EASTERN,17858
IJARA,Rural,65,93,47,140,Garissa,NORTH EASTERN,17859
IJARA,Rural,66,25,12,37,Garissa,NORTH EASTERN,17860
IJARA,Rural,67,38,14,52,Garissa,NORTH EASTERN,17861
IJARA,Rural,68,37,17,54,Garissa,NORTH EASTERN,17862
IJARA,Rural,69,18,7,25,Garissa,NORTH EASTERN,17863
IJARA,Rural,70,194,168,362,Garissa,NORTH EASTERN,17864
IJARA,Rural,71,23,11,34,Garissa,NORTH EASTERN,17865
IJARA,Rural,72,32,10,42,Garissa,NORTH EASTERN,17866
IJARA,Rural,73,22,13,35,Garissa,NORTH EASTERN,17867
IJARA,Rural,74,21,4,25,Garissa,NORTH EASTERN,17868
IJARA,Rural,75,43,30,73,Garissa,NORTH EASTERN,17869
IJARA,Rural,76,23,5,28,Garissa,NORTH EASTERN,17870
IJARA,Rural,77,14,5,19,Garissa,NORTH EASTERN,17871
IJARA,Rural,78,23,15,38,Garissa,NORTH EASTERN,17872
IJARA,Rural,79,13,4,17,Garissa,NORTH EASTERN,17873
IJARA,Rural,80+,296,212,508,Garissa,NORTH EASTERN,17874
IJARA,Rural,Age NS,14,7,21,Garissa,NORTH EASTERN,17875
WAJIR SOUTH,Rural,0,1073,941,2014,Wajir,NORTH EASTERN,17876
WAJIR SOUTH,Rural,1,1176,988,2164,Wajir,NORTH EASTERN,17877
WAJIR SOUTH,Rural,2,2287,2099,4386,Wajir,NORTH EASTERN,17878
WAJIR SOUTH,Rural,3,1604,1531,3135,Wajir,NORTH EASTERN,17879
WAJIR SOUTH,Rural,4,2553,2287,4840,Wajir,NORTH EASTERN,17880
WAJIR SOUTH,Rural,5,1926,1713,3639,Wajir,NORTH EASTERN,17881
WAJIR SOUTH,Rural,6,3189,2612,5801,Wajir,NORTH EASTERN,17882
WAJIR SOUTH,Rural,7,1716,1605,3321,Wajir,NORTH EASTERN,17883
WAJIR SOUTH,Rural,8,3349,2927,6276,Wajir,NORTH EASTERN,17884
WAJIR SOUTH,Rural,9,1606,1426,3032,Wajir,NORTH EASTERN,17885
WAJIR SOUTH,Rural,10,3798,3003,6801,Wajir,NORTH EASTERN,17886
WAJIR SOUTH,Rural,11,1370,1230,2600,Wajir,NORTH EASTERN,17887
WAJIR SOUTH,Rural,12,3189,2328,5517,Wajir,NORTH EASTERN,17888
WAJIR SOUTH,Rural,13,1680,1274,2954,Wajir,NORTH EASTERN,17889
WAJIR SOUTH,Rural,14,2640,1860,4500,Wajir,NORTH EASTERN,17890
WAJIR SOUTH,Rural,15,2058,1437,3495,Wajir,NORTH EASTERN,17891
WAJIR SOUTH,Rural,16,2335,1593,3928,Wajir,NORTH EASTERN,17892
WAJIR SOUTH,Rural,17,1223,808,2031,Wajir,NORTH EASTERN,17893
WAJIR SOUTH,Rural,18,2646,1813,4459,Wajir,NORTH EASTERN,17894
WAJIR SOUTH,Rural,19,872,624,1496,Wajir,NORTH EASTERN,17895
WAJIR SOUTH,Rural,20,2584,1895,4479,Wajir,NORTH EASTERN,17896
WAJIR SOUTH,Rural,21,675,477,1152,Wajir,NORTH EASTERN,17897
WAJIR SOUTH,Rural,22,994,749,1743,Wajir,NORTH EASTERN,17898
WAJIR SOUTH,Rural,23,641,494,1135,Wajir,NORTH EASTERN,17899
WAJIR SOUTH,Rural,24,681,615,1296,Wajir,NORTH EASTERN,17900
WAJIR SOUTH,Rural,25,1229,1315,2544,Wajir,NORTH EASTERN,17901
WAJIR SOUTH,Rural,26,589,569,1158,Wajir,NORTH EASTERN,17902
WAJIR SOUTH,Rural,27,380,454,834,Wajir,NORTH EASTERN,17903
WAJIR SOUTH,Rural,28,890,1032,1922,Wajir,NORTH EASTERN,17904
WAJIR SOUTH,Rural,29,330,452,782,Wajir,NORTH EASTERN,17905
WAJIR SOUTH,Rural,30,1884,2008,3892,Wajir,NORTH EASTERN,17906
WAJIR SOUTH,Rural,31,184,229,413,Wajir,NORTH EASTERN,17907
WAJIR SOUTH,Rural,32,502,621,1123,Wajir,NORTH EASTERN,17908
WAJIR SOUTH,Rural,33,255,269,524,Wajir,NORTH EASTERN,17909
WAJIR SOUTH,Rural,34,255,295,550,Wajir,NORTH EASTERN,17910
WAJIR SOUTH,Rural,35,821,971,1792,Wajir,NORTH EASTERN,17911
WAJIR SOUTH,Rural,36,338,399,737,Wajir,NORTH EASTERN,17912
WAJIR SOUTH,Rural,37,221,265,486,Wajir,NORTH EASTERN,17913
WAJIR SOUTH,Rural,38,552,605,1157,Wajir,NORTH EASTERN,17914
WAJIR SOUTH,Rural,39,219,275,494,Wajir,NORTH EASTERN,17915
WAJIR SOUTH,Rural,40,1859,1473,3332,Wajir,NORTH EASTERN,17916
WAJIR SOUTH,Rural,41,179,146,325,Wajir,NORTH EASTERN,17917
WAJIR SOUTH,Rural,42,428,335,763,Wajir,NORTH EASTERN,17918
WAJIR SOUTH,Rural,43,178,162,340,Wajir,NORTH EASTERN,17919
WAJIR SOUTH,Rural,44,177,130,307,Wajir,NORTH EASTERN,17920
WAJIR SOUTH,Rural,45,665,584,1249,Wajir,NORTH EASTERN,17921
WAJIR SOUTH,Rural,46,225,153,378,Wajir,NORTH EASTERN,17922
WAJIR SOUTH,Rural,47,163,136,299,Wajir,NORTH EASTERN,17923
WAJIR SOUTH,Rural,48,435,269,704,Wajir,NORTH EASTERN,17924
WAJIR SOUTH,Rural,49,181,126,307,Wajir,NORTH EASTERN,17925
WAJIR SOUTH,Rural,50,1258,757,2015,Wajir,NORTH EASTERN,17926
WAJIR SOUTH,Rural,51,92,53,145,Wajir,NORTH EASTERN,17927
WAJIR SOUTH,Rural,52,268,81,349,Wajir,NORTH EASTERN,17928
WAJIR SOUTH,Rural,53,139,64,203,Wajir,NORTH EASTERN,17929
WAJIR SOUTH,Rural,54,159,83,242,Wajir,NORTH EASTERN,17930
WAJIR SOUTH,Rural,55,359,169,528,Wajir,NORTH EASTERN,17931
WAJIR SOUTH,Rural,56,224,76,300,Wajir,NORTH EASTERN,17932
WAJIR SOUTH,Rural,57,70,39,109,Wajir,NORTH EASTERN,17933
WAJIR SOUTH,Rural,58,171,59,230,Wajir,NORTH EASTERN,17934
WAJIR SOUTH,Rural,59,58,19,77,Wajir,NORTH EASTERN,17935
WAJIR SOUTH,Rural,60,967,460,1427,Wajir,NORTH EASTERN,17936
WAJIR SOUTH,Rural,61,56,21,77,Wajir,NORTH EASTERN,17937
WAJIR SOUTH,Rural,62,105,30,135,Wajir,NORTH EASTERN,17938
WAJIR SOUTH,Rural,63,98,34,132,Wajir,NORTH EASTERN,17939
WAJIR SOUTH,Rural,64,84,32,116,Wajir,NORTH EASTERN,17940
WAJIR SOUTH,Rural,65,197,111,308,Wajir,NORTH EASTERN,17941
WAJIR SOUTH,Rural,66,56,20,76,Wajir,NORTH EASTERN,17942
WAJIR SOUTH,Rural,67,77,35,112,Wajir,NORTH EASTERN,17943
WAJIR SOUTH,Rural,68,95,44,139,Wajir,NORTH EASTERN,17944
WAJIR SOUTH,Rural,69,36,18,54,Wajir,NORTH EASTERN,17945
WAJIR SOUTH,Rural,70,493,253,746,Wajir,NORTH EASTERN,17946
WAJIR SOUTH,Rural,71,29,26,55,Wajir,NORTH EASTERN,17947
WAJIR SOUTH,Rural,72,55,26,81,Wajir,NORTH EASTERN,17948
WAJIR SOUTH,Rural,73,39,17,56,Wajir,NORTH EASTERN,17949
WAJIR SOUTH,Rural,74,29,17,46,Wajir,NORTH EASTERN,17950
WAJIR SOUTH,Rural,75,69,60,129,Wajir,NORTH EASTERN,17951
WAJIR SOUTH,Rural,76,24,28,52,Wajir,NORTH EASTERN,17952
WAJIR SOUTH,Rural,77,16,13,29,Wajir,NORTH EASTERN,17953
WAJIR SOUTH,Rural,78,47,23,70,Wajir,NORTH EASTERN,17954
WAJIR SOUTH,Rural,79,19,20,39,Wajir,NORTH EASTERN,17955
WAJIR SOUTH,Rural,80+,424,424,848,Wajir,NORTH EASTERN,17956
WAJIR SOUTH,Rural,Age NS,25,14,39,Wajir,NORTH EASTERN,17957
WAJIR NORTH,Rural,0,1190,1246,2436,Wajir,NORTH EASTERN,17958
WAJIR NORTH,Rural,1,1160,1199,2359,Wajir,NORTH EASTERN,17959
WAJIR NORTH,Rural,2,2690,2644,5334,Wajir,NORTH EASTERN,17960
WAJIR NORTH,Rural,3,1760,1834,3594,Wajir,NORTH EASTERN,17961
WAJIR NORTH,Rural,4,3016,3049,6065,Wajir,NORTH EASTERN,17962
WAJIR NORTH,Rural,5,1998,1997,3995,Wajir,NORTH EASTERN,17963
WAJIR NORTH,Rural,6,3745,3397,7142,Wajir,NORTH EASTERN,17964
WAJIR NORTH,Rural,7,2066,1745,3811,Wajir,NORTH EASTERN,17965
WAJIR NORTH,Rural,8,4311,3536,7847,Wajir,NORTH EASTERN,17966
WAJIR NORTH,Rural,9,1993,1815,3808,Wajir,NORTH EASTERN,17967
WAJIR NORTH,Rural,10,4660,3795,8455,Wajir,NORTH EASTERN,17968
WAJIR NORTH,Rural,11,1613,1599,3212,Wajir,NORTH EASTERN,17969
WAJIR NORTH,Rural,12,3922,2748,6670,Wajir,NORTH EASTERN,17970
WAJIR NORTH,Rural,13,1944,1258,3202,Wajir,NORTH EASTERN,17971
WAJIR NORTH,Rural,14,3326,2002,5328,Wajir,NORTH EASTERN,17972
WAJIR NORTH,Rural,15,2219,1432,3651,Wajir,NORTH EASTERN,17973
WAJIR NORTH,Rural,16,2851,1682,4533,Wajir,NORTH EASTERN,17974
WAJIR NORTH,Rural,17,1412,796,2208,Wajir,NORTH EASTERN,17975
WAJIR NORTH,Rural,18,2720,1681,4401,Wajir,NORTH EASTERN,17976
WAJIR NORTH,Rural,19,882,545,1427,Wajir,NORTH EASTERN,17977
WAJIR NORTH,Rural,20,2328,1549,3877,Wajir,NORTH EASTERN,17978
WAJIR NORTH,Rural,21,708,513,1221,Wajir,NORTH EASTERN,17979
WAJIR NORTH,Rural,22,895,658,1553,Wajir,NORTH EASTERN,17980
WAJIR NORTH,Rural,23,601,462,1063,Wajir,NORTH EASTERN,17981
WAJIR NORTH,Rural,24,705,722,1427,Wajir,NORTH EASTERN,17982
WAJIR NORTH,Rural,25,1012,1122,2134,Wajir,NORTH EASTERN,17983
WAJIR NORTH,Rural,26,551,663,1214,Wajir,NORTH EASTERN,17984
WAJIR NORTH,Rural,27,361,511,872,Wajir,NORTH EASTERN,17985
WAJIR NORTH,Rural,28,854,1163,2017,Wajir,NORTH EASTERN,17986
WAJIR NORTH,Rural,29,334,573,907,Wajir,NORTH EASTERN,17987
WAJIR NORTH,Rural,30,1528,1827,3355,Wajir,NORTH EASTERN,17988
WAJIR NORTH,Rural,31,288,398,686,Wajir,NORTH EASTERN,17989
WAJIR NORTH,Rural,32,580,783,1363,Wajir,NORTH EASTERN,17990
WAJIR NORTH,Rural,33,244,382,626,Wajir,NORTH EASTERN,17991
WAJIR NORTH,Rural,34,330,465,795,Wajir,NORTH EASTERN,17992
WAJIR NORTH,Rural,35,884,1110,1994,Wajir,NORTH EASTERN,17993
WAJIR NORTH,Rural,36,407,625,1032,Wajir,NORTH EASTERN,17994
WAJIR NORTH,Rural,37,277,380,657,Wajir,NORTH EASTERN,17995
WAJIR NORTH,Rural,38,626,764,1390,Wajir,NORTH EASTERN,17996
WAJIR NORTH,Rural,39,318,394,712,Wajir,NORTH EASTERN,17997
WAJIR NORTH,Rural,40,1658,1360,3018,Wajir,NORTH EASTERN,17998
WAJIR NORTH,Rural,41,268,222,490,Wajir,NORTH EASTERN,17999
WAJIR NORTH,Rural,42,562,469,1031,Wajir,NORTH EASTERN,18000
WAJIR NORTH,Rural,43,254,216,470,Wajir,NORTH EASTERN,18001
WAJIR NORTH,Rural,44,196,152,348,Wajir,NORTH EASTERN,18002
WAJIR NORTH,Rural,45,636,518,1154,Wajir,NORTH EASTERN,18003
WAJIR NORTH,Rural,46,258,207,465,Wajir,NORTH EASTERN,18004
WAJIR NORTH,Rural,47,236,186,422,Wajir,NORTH EASTERN,18005
WAJIR NORTH,Rural,48,454,332,786,Wajir,NORTH EASTERN,18006
WAJIR NORTH,Rural,49,225,175,400,Wajir,NORTH EASTERN,18007
WAJIR NORTH,Rural,50,1039,606,1645,Wajir,NORTH EASTERN,18008
WAJIR NORTH,Rural,51,179,72,251,Wajir,NORTH EASTERN,18009
WAJIR NORTH,Rural,52,265,146,411,Wajir,NORTH EASTERN,18010
WAJIR NORTH,Rural,53,155,77,232,Wajir,NORTH EASTERN,18011
WAJIR NORTH,Rural,54,165,87,252,Wajir,NORTH EASTERN,18012
WAJIR NORTH,Rural,55,307,175,482,Wajir,NORTH EASTERN,18013
WAJIR NORTH,Rural,56,244,110,354,Wajir,NORTH EASTERN,18014
WAJIR NORTH,Rural,57,125,54,179,Wajir,NORTH EASTERN,18015
WAJIR NORTH,Rural,58,196,103,299,Wajir,NORTH EASTERN,18016
WAJIR NORTH,Rural,59,125,46,171,Wajir,NORTH EASTERN,18017
WAJIR NORTH,Rural,60,772,321,1093,Wajir,NORTH EASTERN,18018
WAJIR NORTH,Rural,61,84,39,123,Wajir,NORTH EASTERN,18019
WAJIR NORTH,Rural,62,117,46,163,Wajir,NORTH EASTERN,18020
WAJIR NORTH,Rural,63,87,38,125,Wajir,NORTH EASTERN,18021
WAJIR NORTH,Rural,64,90,33,123,Wajir,NORTH EASTERN,18022
WAJIR NORTH,Rural,65,171,57,228,Wajir,NORTH EASTERN,18023
WAJIR NORTH,Rural,66,47,14,61,Wajir,NORTH EASTERN,18024
WAJIR NORTH,Rural,67,62,29,91,Wajir,NORTH EASTERN,18025
WAJIR NORTH,Rural,68,93,46,139,Wajir,NORTH EASTERN,18026
WAJIR NORTH,Rural,69,49,33,82,Wajir,NORTH EASTERN,18027
WAJIR NORTH,Rural,70,380,233,613,Wajir,NORTH EASTERN,18028
WAJIR NORTH,Rural,71,33,21,54,Wajir,NORTH EASTERN,18029
WAJIR NORTH,Rural,72,69,36,105,Wajir,NORTH EASTERN,18030
WAJIR NORTH,Rural,73,43,25,68,Wajir,NORTH EASTERN,18031
WAJIR NORTH,Rural,74,35,20,55,Wajir,NORTH EASTERN,18032
WAJIR NORTH,Rural,75,69,57,126,Wajir,NORTH EASTERN,18033
WAJIR NORTH,Rural,76,48,27,75,Wajir,NORTH EASTERN,18034
WAJIR NORTH,Rural,77,25,25,50,Wajir,NORTH EASTERN,18035
WAJIR NORTH,Rural,78,42,33,75,Wajir,NORTH EASTERN,18036
WAJIR NORTH,Rural,79,33,20,53,Wajir,NORTH EASTERN,18037
WAJIR NORTH,Rural,80+,405,336,741,Wajir,NORTH EASTERN,18038
WAJIR NORTH,Rural,Age NS,18,11,29,Wajir,NORTH EASTERN,18039
WAJIR EAST,Rural,0,1249,1176,2425,Wajir,NORTH EASTERN,18040
WAJIR EAST,Rural,1,1171,1002,2173,Wajir,NORTH EASTERN,18041
WAJIR EAST,Rural,2,2749,2509,5258,Wajir,NORTH EASTERN,18042
WAJIR EAST,Rural,3,1942,1727,3669,Wajir,NORTH EASTERN,18043
WAJIR EAST,Rural,4,3008,2895,5903,Wajir,NORTH EASTERN,18044
WAJIR EAST,Rural,5,2372,2128,4500,Wajir,NORTH EASTERN,18045
WAJIR EAST,Rural,6,3744,3305,7049,Wajir,NORTH EASTERN,18046
WAJIR EAST,Rural,7,2278,2048,4326,Wajir,NORTH EASTERN,18047
WAJIR EAST,Rural,8,4385,3617,8002,Wajir,NORTH EASTERN,18048
WAJIR EAST,Rural,9,2323,1858,4181,Wajir,NORTH EASTERN,18049
WAJIR EAST,Rural,10,4928,3614,8542,Wajir,NORTH EASTERN,18050
WAJIR EAST,Rural,11,1929,1666,3595,Wajir,NORTH EASTERN,18051
WAJIR EAST,Rural,12,4167,2931,7098,Wajir,NORTH EASTERN,18052
WAJIR EAST,Rural,13,2249,1543,3792,Wajir,NORTH EASTERN,18053
WAJIR EAST,Rural,14,3484,2228,5712,Wajir,NORTH EASTERN,18054
WAJIR EAST,Rural,15,2720,1592,4312,Wajir,NORTH EASTERN,18055
WAJIR EAST,Rural,16,3041,1810,4851,Wajir,NORTH EASTERN,18056
WAJIR EAST,Rural,17,1624,959,2583,Wajir,NORTH EASTERN,18057
WAJIR EAST,Rural,18,3108,1783,4891,Wajir,NORTH EASTERN,18058
WAJIR EAST,Rural,19,941,560,1501,Wajir,NORTH EASTERN,18059
WAJIR EAST,Rural,20,2735,1836,4571,Wajir,NORTH EASTERN,18060
WAJIR EAST,Rural,21,632,404,1036,Wajir,NORTH EASTERN,18061
WAJIR EAST,Rural,22,958,700,1658,Wajir,NORTH EASTERN,18062
WAJIR EAST,Rural,23,591,422,1013,Wajir,NORTH EASTERN,18063
WAJIR EAST,Rural,24,616,532,1148,Wajir,NORTH EASTERN,18064
WAJIR EAST,Rural,25,1099,1237,2336,Wajir,NORTH EASTERN,18065
WAJIR EAST,Rural,26,465,569,1034,Wajir,NORTH EASTERN,18066
WAJIR EAST,Rural,27,401,475,876,Wajir,NORTH EASTERN,18067
WAJIR EAST,Rural,28,687,1049,1736,Wajir,NORTH EASTERN,18068
WAJIR EAST,Rural,29,274,397,671,Wajir,NORTH EASTERN,18069
WAJIR EAST,Rural,30,1809,2079,3888,Wajir,NORTH EASTERN,18070
WAJIR EAST,Rural,31,203,248,451,Wajir,NORTH EASTERN,18071
WAJIR EAST,Rural,32,496,745,1241,Wajir,NORTH EASTERN,18072
WAJIR EAST,Rural,33,217,354,571,Wajir,NORTH EASTERN,18073
WAJIR EAST,Rural,34,255,394,649,Wajir,NORTH EASTERN,18074
WAJIR EAST,Rural,35,917,1303,2220,Wajir,NORTH EASTERN,18075
WAJIR EAST,Rural,36,368,612,980,Wajir,NORTH EASTERN,18076
WAJIR EAST,Rural,37,297,424,721,Wajir,NORTH EASTERN,18077
WAJIR EAST,Rural,38,645,879,1524,Wajir,NORTH EASTERN,18078
WAJIR EAST,Rural,39,283,400,683,Wajir,NORTH EASTERN,18079
WAJIR EAST,Rural,40,2178,1775,3953,Wajir,NORTH EASTERN,18080
WAJIR EAST,Rural,41,200,198,398,Wajir,NORTH EASTERN,18081
WAJIR EAST,Rural,42,539,453,992,Wajir,NORTH EASTERN,18082
WAJIR EAST,Rural,43,228,219,447,Wajir,NORTH EASTERN,18083
WAJIR EAST,Rural,44,153,118,271,Wajir,NORTH EASTERN,18084
WAJIR EAST,Rural,45,811,657,1468,Wajir,NORTH EASTERN,18085
WAJIR EAST,Rural,46,333,220,553,Wajir,NORTH EASTERN,18086
WAJIR EAST,Rural,47,243,155,398,Wajir,NORTH EASTERN,18087
WAJIR EAST,Rural,48,544,348,892,Wajir,NORTH EASTERN,18088
WAJIR EAST,Rural,49,226,123,349,Wajir,NORTH EASTERN,18089
WAJIR EAST,Rural,50,1371,735,2106,Wajir,NORTH EASTERN,18090
WAJIR EAST,Rural,51,118,69,187,Wajir,NORTH EASTERN,18091
WAJIR EAST,Rural,52,254,114,368,Wajir,NORTH EASTERN,18092
WAJIR EAST,Rural,53,150,40,190,Wajir,NORTH EASTERN,18093
WAJIR EAST,Rural,54,142,66,208,Wajir,NORTH EASTERN,18094
WAJIR EAST,Rural,55,351,218,569,Wajir,NORTH EASTERN,18095
WAJIR EAST,Rural,56,233,79,312,Wajir,NORTH EASTERN,18096
WAJIR EAST,Rural,57,119,43,162,Wajir,NORTH EASTERN,18097
WAJIR EAST,Rural,58,151,73,224,Wajir,NORTH EASTERN,18098
WAJIR EAST,Rural,59,73,33,106,Wajir,NORTH EASTERN,18099
WAJIR EAST,Rural,60,809,371,1180,Wajir,NORTH EASTERN,18100
WAJIR EAST,Rural,61,52,17,69,Wajir,NORTH EASTERN,18101
WAJIR EAST,Rural,62,128,42,170,Wajir,NORTH EASTERN,18102
WAJIR EAST,Rural,63,56,22,78,Wajir,NORTH EASTERN,18103
WAJIR EAST,Rural,64,82,31,113,Wajir,NORTH EASTERN,18104
WAJIR EAST,Rural,65,172,80,252,Wajir,NORTH EASTERN,18105
WAJIR EAST,Rural,66,29,27,56,Wajir,NORTH EASTERN,18106
WAJIR EAST,Rural,67,48,25,73,Wajir,NORTH EASTERN,18107
WAJIR EAST,Rural,68,79,46,125,Wajir,NORTH EASTERN,18108
WAJIR EAST,Rural,69,29,16,45,Wajir,NORTH EASTERN,18109
WAJIR EAST,Rural,70,418,228,646,Wajir,NORTH EASTERN,18110
WAJIR EAST,Rural,71,18,14,32,Wajir,NORTH EASTERN,18111
WAJIR EAST,Rural,72,53,34,87,Wajir,NORTH EASTERN,18112
WAJIR EAST,Rural,73,25,26,51,Wajir,NORTH EASTERN,18113
WAJIR EAST,Rural,74,39,21,60,Wajir,NORTH EASTERN,18114
WAJIR EAST,Rural,75,89,55,144,Wajir,NORTH EASTERN,18115
WAJIR EAST,Rural,76,26,16,42,Wajir,NORTH EASTERN,18116
WAJIR EAST,Rural,77,24,19,43,Wajir,NORTH EASTERN,18117
WAJIR EAST,Rural,78,42,38,80,Wajir,NORTH EASTERN,18118
WAJIR EAST,Rural,79,20,22,42,Wajir,NORTH EASTERN,18119
WAJIR EAST,Rural,80+,371,312,683,Wajir,NORTH EASTERN,18120
WAJIR EAST,Rural,Age NS,13,11,24,Wajir,NORTH EASTERN,18121
WAJIR WEST,Rural,0,1500,1336,2836,Wajir,NORTH EASTERN,18122
WAJIR WEST,Rural,1,1341,1228,2569,Wajir,NORTH EASTERN,18123
WAJIR WEST,Rural,2,3047,2812,5859,Wajir,NORTH EASTERN,18124
WAJIR WEST,Rural,3,2195,1951,4146,Wajir,NORTH EASTERN,18125
WAJIR WEST,Rural,4,3742,3312,7054,Wajir,NORTH EASTERN,18126
WAJIR WEST,Rural,5,2662,2325,4987,Wajir,NORTH EASTERN,18127
WAJIR WEST,Rural,6,4602,3809,8411,Wajir,NORTH EASTERN,18128
WAJIR WEST,Rural,7,2590,2198,4788,Wajir,NORTH EASTERN,18129
WAJIR WEST,Rural,8,5023,4026,9049,Wajir,NORTH EASTERN,18130
WAJIR WEST,Rural,9,2601,1996,4597,Wajir,NORTH EASTERN,18131
WAJIR WEST,Rural,10,5667,4198,9865,Wajir,NORTH EASTERN,18132
WAJIR WEST,Rural,11,2264,1735,3999,Wajir,NORTH EASTERN,18133
WAJIR WEST,Rural,12,5079,3307,8386,Wajir,NORTH EASTERN,18134
WAJIR WEST,Rural,13,2649,1670,4319,Wajir,NORTH EASTERN,18135
WAJIR WEST,Rural,14,4263,2575,6838,Wajir,NORTH EASTERN,18136
WAJIR WEST,Rural,15,3044,1897,4941,Wajir,NORTH EASTERN,18137
WAJIR WEST,Rural,16,3832,2182,6014,Wajir,NORTH EASTERN,18138
WAJIR WEST,Rural,17,1875,1107,2982,Wajir,NORTH EASTERN,18139
WAJIR WEST,Rural,18,3759,2110,5869,Wajir,NORTH EASTERN,18140
WAJIR WEST,Rural,19,1229,730,1959,Wajir,NORTH EASTERN,18141
WAJIR WEST,Rural,20,3309,2097,5406,Wajir,NORTH EASTERN,18142
WAJIR WEST,Rural,21,825,510,1335,Wajir,NORTH EASTERN,18143
WAJIR WEST,Rural,22,1188,885,2073,Wajir,NORTH EASTERN,18144
WAJIR WEST,Rural,23,785,554,1339,Wajir,NORTH EASTERN,18145
WAJIR WEST,Rural,24,766,580,1346,Wajir,NORTH EASTERN,18146
WAJIR WEST,Rural,25,1392,1481,2873,Wajir,NORTH EASTERN,18147
WAJIR WEST,Rural,26,602,712,1314,Wajir,NORTH EASTERN,18148
WAJIR WEST,Rural,27,483,559,1042,Wajir,NORTH EASTERN,18149
WAJIR WEST,Rural,28,918,1208,2126,Wajir,NORTH EASTERN,18150
WAJIR WEST,Rural,29,337,554,891,Wajir,NORTH EASTERN,18151
WAJIR WEST,Rural,30,2031,2413,4444,Wajir,NORTH EASTERN,18152
WAJIR WEST,Rural,31,220,324,544,Wajir,NORTH EASTERN,18153
WAJIR WEST,Rural,32,578,853,1431,Wajir,NORTH EASTERN,18154
WAJIR WEST,Rural,33,354,457,811,Wajir,NORTH EASTERN,18155
WAJIR WEST,Rural,34,315,423,738,Wajir,NORTH EASTERN,18156
WAJIR WEST,Rural,35,1016,1466,2482,Wajir,NORTH EASTERN,18157
WAJIR WEST,Rural,36,428,664,1092,Wajir,NORTH EASTERN,18158
WAJIR WEST,Rural,37,361,463,824,Wajir,NORTH EASTERN,18159
WAJIR WEST,Rural,38,643,952,1595,Wajir,NORTH EASTERN,18160
WAJIR WEST,Rural,39,381,492,873,Wajir,NORTH EASTERN,18161
WAJIR WEST,Rural,40,2375,2056,4431,Wajir,NORTH EASTERN,18162
WAJIR WEST,Rural,41,213,191,404,Wajir,NORTH EASTERN,18163
WAJIR WEST,Rural,42,542,514,1056,Wajir,NORTH EASTERN,18164
WAJIR WEST,Rural,43,277,269,546,Wajir,NORTH EASTERN,18165
WAJIR WEST,Rural,44,256,180,436,Wajir,NORTH EASTERN,18166
WAJIR WEST,Rural,45,997,850,1847,Wajir,NORTH EASTERN,18167
WAJIR WEST,Rural,46,329,223,552,Wajir,NORTH EASTERN,18168
WAJIR WEST,Rural,47,294,216,510,Wajir,NORTH EASTERN,18169
WAJIR WEST,Rural,48,544,350,894,Wajir,NORTH EASTERN,18170
WAJIR WEST,Rural,49,334,209,543,Wajir,NORTH EASTERN,18171
WAJIR WEST,Rural,50,1692,940,2632,Wajir,NORTH EASTERN,18172
WAJIR WEST,Rural,51,131,65,196,Wajir,NORTH EASTERN,18173
WAJIR WEST,Rural,52,365,144,509,Wajir,NORTH EASTERN,18174
WAJIR WEST,Rural,53,143,75,218,Wajir,NORTH EASTERN,18175
WAJIR WEST,Rural,54,186,89,275,Wajir,NORTH EASTERN,18176
WAJIR WEST,Rural,55,491,270,761,Wajir,NORTH EASTERN,18177
WAJIR WEST,Rural,56,306,101,407,Wajir,NORTH EASTERN,18178
WAJIR WEST,Rural,57,149,70,219,Wajir,NORTH EASTERN,18179
WAJIR WEST,Rural,58,253,106,359,Wajir,NORTH EASTERN,18180
WAJIR WEST,Rural,59,148,31,179,Wajir,NORTH EASTERN,18181
WAJIR WEST,Rural,60,1081,451,1532,Wajir,NORTH EASTERN,18182
WAJIR WEST,Rural,61,71,30,101,Wajir,NORTH EASTERN,18183
WAJIR WEST,Rural,62,151,45,196,Wajir,NORTH EASTERN,18184
WAJIR WEST,Rural,63,111,46,157,Wajir,NORTH EASTERN,18185
WAJIR WEST,Rural,64,120,26,146,Wajir,NORTH EASTERN,18186
WAJIR WEST,Rural,65,233,136,369,Wajir,NORTH EASTERN,18187
WAJIR WEST,Rural,66,91,37,128,Wajir,NORTH EASTERN,18188
WAJIR WEST,Rural,67,85,29,114,Wajir,NORTH EASTERN,18189
WAJIR WEST,Rural,68,102,46,148,Wajir,NORTH EASTERN,18190
WAJIR WEST,Rural,69,49,14,63,Wajir,NORTH EASTERN,18191
WAJIR WEST,Rural,70,577,274,851,Wajir,NORTH EASTERN,18192
WAJIR WEST,Rural,71,38,14,52,Wajir,NORTH EASTERN,18193
WAJIR WEST,Rural,72,87,38,125,Wajir,NORTH EASTERN,18194
WAJIR WEST,Rural,73,40,25,65,Wajir,NORTH EASTERN,18195
WAJIR WEST,Rural,74,48,22,70,Wajir,NORTH EASTERN,18196
WAJIR WEST,Rural,75,122,73,195,Wajir,NORTH EASTERN,18197
WAJIR WEST,Rural,76,43,14,57,Wajir,NORTH EASTERN,18198
WAJIR WEST,Rural,77,41,17,58,Wajir,NORTH EASTERN,18199
WAJIR WEST,Rural,78,46,24,70,Wajir,NORTH EASTERN,18200
WAJIR WEST,Rural,79,31,17,48,Wajir,NORTH EASTERN,18201
WAJIR WEST,Rural,80+,496,309,805,Wajir,NORTH EASTERN,18202
WAJIR WEST,Rural,Age NS,13,9,22,Wajir,NORTH EASTERN,18203
MANDERA CENTRAL,Rural,0,2746,2992,5738,Mandera,NORTH EASTERN,18204
MANDERA CENTRAL,Rural,1,2748,2870,5618,Mandera,NORTH EASTERN,18205
MANDERA CENTRAL,Rural,2,6612,6695,13307,Mandera,NORTH EASTERN,18206
MANDERA CENTRAL,Rural,3,4564,4560,9124,Mandera,NORTH EASTERN,18207
MANDERA CENTRAL,Rural,4,7416,7277,14693,Mandera,NORTH EASTERN,18208
MANDERA CENTRAL,Rural,5,5249,5084,10333,Mandera,NORTH EASTERN,18209
MANDERA CENTRAL,Rural,6,9126,8155,17281,Mandera,NORTH EASTERN,18210
MANDERA CENTRAL,Rural,7,5337,5022,10359,Mandera,NORTH EASTERN,18211
MANDERA CENTRAL,Rural,8,10342,8972,19314,Mandera,NORTH EASTERN,18212
MANDERA CENTRAL,Rural,9,5430,4927,10357,Mandera,NORTH EASTERN,18213
MANDERA CENTRAL,Rural,10,11283,9578,20861,Mandera,NORTH EASTERN,18214
MANDERA CENTRAL,Rural,11,4476,3973,8449,Mandera,NORTH EASTERN,18215
MANDERA CENTRAL,Rural,12,9784,7719,17503,Mandera,NORTH EASTERN,18216
MANDERA CENTRAL,Rural,13,5118,3858,8976,Mandera,NORTH EASTERN,18217
MANDERA CENTRAL,Rural,14,8229,5799,14028,Mandera,NORTH EASTERN,18218
MANDERA CENTRAL,Rural,15,6238,4055,10293,Mandera,NORTH EASTERN,18219
MANDERA CENTRAL,Rural,16,7220,4780,12000,Mandera,NORTH EASTERN,18220
MANDERA CENTRAL,Rural,17,4002,2579,6581,Mandera,NORTH EASTERN,18221
MANDERA CENTRAL,Rural,18,7415,4504,11919,Mandera,NORTH EASTERN,18222
MANDERA CENTRAL,Rural,19,2626,1590,4216,Mandera,NORTH EASTERN,18223
MANDERA CENTRAL,Rural,20,6102,3798,9900,Mandera,NORTH EASTERN,18224
MANDERA CENTRAL,Rural,21,1982,1193,3175,Mandera,NORTH EASTERN,18225
MANDERA CENTRAL,Rural,22,2409,1719,4128,Mandera,NORTH EASTERN,18226
MANDERA CENTRAL,Rural,23,1372,1086,2458,Mandera,NORTH EASTERN,18227
MANDERA CENTRAL,Rural,24,1538,1452,2990,Mandera,NORTH EASTERN,18228
MANDERA CENTRAL,Rural,25,2211,2356,4567,Mandera,NORTH EASTERN,18229
MANDERA CENTRAL,Rural,26,1256,1512,2768,Mandera,NORTH EASTERN,18230
MANDERA CENTRAL,Rural,27,972,1278,2250,Mandera,NORTH EASTERN,18231
MANDERA CENTRAL,Rural,28,1716,2649,4365,Mandera,NORTH EASTERN,18232
MANDERA CENTRAL,Rural,29,819,1465,2284,Mandera,NORTH EASTERN,18233
MANDERA CENTRAL,Rural,30,3256,4145,7401,Mandera,NORTH EASTERN,18234
MANDERA CENTRAL,Rural,31,642,953,1595,Mandera,NORTH EASTERN,18235
MANDERA CENTRAL,Rural,32,1159,2024,3183,Mandera,NORTH EASTERN,18236
MANDERA CENTRAL,Rural,33,641,1048,1689,Mandera,NORTH EASTERN,18237
MANDERA CENTRAL,Rural,34,736,1136,1872,Mandera,NORTH EASTERN,18238
MANDERA CENTRAL,Rural,35,2093,2824,4917,Mandera,NORTH EASTERN,18239
MANDERA CENTRAL,Rural,36,888,1455,2343,Mandera,NORTH EASTERN,18240
MANDERA CENTRAL,Rural,37,745,1084,1829,Mandera,NORTH EASTERN,18241
MANDERA CENTRAL,Rural,38,1613,2237,3850,Mandera,NORTH EASTERN,18242
MANDERA CENTRAL,Rural,39,836,1194,2030,Mandera,NORTH EASTERN,18243
MANDERA CENTRAL,Rural,40,3817,3202,7019,Mandera,NORTH EASTERN,18244
MANDERA CENTRAL,Rural,41,624,679,1303,Mandera,NORTH EASTERN,18245
MANDERA CENTRAL,Rural,42,1347,1231,2578,Mandera,NORTH EASTERN,18246
MANDERA CENTRAL,Rural,43,709,682,1391,Mandera,NORTH EASTERN,18247
MANDERA CENTRAL,Rural,44,547,480,1027,Mandera,NORTH EASTERN,18248
MANDERA CENTRAL,Rural,45,1853,1397,3250,Mandera,NORTH EASTERN,18249
MANDERA CENTRAL,Rural,46,798,544,1342,Mandera,NORTH EASTERN,18250
MANDERA CENTRAL,Rural,47,646,486,1132,Mandera,NORTH EASTERN,18251
MANDERA CENTRAL,Rural,48,1313,931,2244,Mandera,NORTH EASTERN,18252
MANDERA CENTRAL,Rural,49,782,500,1282,Mandera,NORTH EASTERN,18253
MANDERA CENTRAL,Rural,50,2371,1311,3682,Mandera,NORTH EASTERN,18254
MANDERA CENTRAL,Rural,51,408,218,626,Mandera,NORTH EASTERN,18255
MANDERA CENTRAL,Rural,52,790,355,1145,Mandera,NORTH EASTERN,18256
MANDERA CENTRAL,Rural,53,420,201,621,Mandera,NORTH EASTERN,18257
MANDERA CENTRAL,Rural,54,440,212,652,Mandera,NORTH EASTERN,18258
MANDERA CENTRAL,Rural,55,973,485,1458,Mandera,NORTH EASTERN,18259
MANDERA CENTRAL,Rural,56,628,235,863,Mandera,NORTH EASTERN,18260
MANDERA CENTRAL,Rural,57,335,131,466,Mandera,NORTH EASTERN,18261
MANDERA CENTRAL,Rural,58,481,226,707,Mandera,NORTH EASTERN,18262
MANDERA CENTRAL,Rural,59,237,127,364,Mandera,NORTH EASTERN,18263
MANDERA CENTRAL,Rural,60,1745,655,2400,Mandera,NORTH EASTERN,18264
MANDERA CENTRAL,Rural,61,211,83,294,Mandera,NORTH EASTERN,18265
MANDERA CENTRAL,Rural,62,353,142,495,Mandera,NORTH EASTERN,18266
MANDERA CENTRAL,Rural,63,214,95,309,Mandera,NORTH EASTERN,18267
MANDERA CENTRAL,Rural,64,195,88,283,Mandera,NORTH EASTERN,18268
MANDERA CENTRAL,Rural,65,426,220,646,Mandera,NORTH EASTERN,18269
MANDERA CENTRAL,Rural,66,118,53,171,Mandera,NORTH EASTERN,18270
MANDERA CENTRAL,Rural,67,158,68,226,Mandera,NORTH EASTERN,18271
MANDERA CENTRAL,Rural,68,204,102,306,Mandera,NORTH EASTERN,18272
MANDERA CENTRAL,Rural,69,108,64,172,Mandera,NORTH EASTERN,18273
MANDERA CENTRAL,Rural,70,866,396,1262,Mandera,NORTH EASTERN,18274
MANDERA CENTRAL,Rural,71,88,54,142,Mandera,NORTH EASTERN,18275
MANDERA CENTRAL,Rural,72,147,110,257,Mandera,NORTH EASTERN,18276
MANDERA CENTRAL,Rural,73,93,56,149,Mandera,NORTH EASTERN,18277
MANDERA CENTRAL,Rural,74,84,65,149,Mandera,NORTH EASTERN,18278
MANDERA CENTRAL,Rural,75,178,123,301,Mandera,NORTH EASTERN,18279
MANDERA CENTRAL,Rural,76,65,57,122,Mandera,NORTH EASTERN,18280
MANDERA CENTRAL,Rural,77,58,59,117,Mandera,NORTH EASTERN,18281
MANDERA CENTRAL,Rural,78,131,78,209,Mandera,NORTH EASTERN,18282
MANDERA CENTRAL,Rural,79,63,69,132,Mandera,NORTH EASTERN,18283
MANDERA CENTRAL,Rural,80+,906,764,1670,Mandera,NORTH EASTERN,18284
MANDERA CENTRAL,Rural,Age NS,14,21,35,Mandera,NORTH EASTERN,18285
MANDERA EAST,Rural,0,1545,1336,2881,Mandera,NORTH EASTERN,18286
MANDERA EAST,Rural,1,1550,1404,2954,Mandera,NORTH EASTERN,18287
MANDERA EAST,Rural,2,3840,3549,7389,Mandera,NORTH EASTERN,18288
MANDERA EAST,Rural,3,2716,2488,5204,Mandera,NORTH EASTERN,18289
MANDERA EAST,Rural,4,4553,4074,8627,Mandera,NORTH EASTERN,18290
MANDERA EAST,Rural,5,3146,2634,5780,Mandera,NORTH EASTERN,18291
MANDERA EAST,Rural,6,5702,4683,10385,Mandera,NORTH EASTERN,18292
MANDERA EAST,Rural,7,3096,2538,5634,Mandera,NORTH EASTERN,18293
MANDERA EAST,Rural,8,6300,4943,11243,Mandera,NORTH EASTERN,18294
MANDERA EAST,Rural,9,3251,2518,5769,Mandera,NORTH EASTERN,18295
MANDERA EAST,Rural,10,6952,5015,11967,Mandera,NORTH EASTERN,18296
MANDERA EAST,Rural,11,2578,2118,4696,Mandera,NORTH EASTERN,18297
MANDERA EAST,Rural,12,5996,3905,9901,Mandera,NORTH EASTERN,18298
MANDERA EAST,Rural,13,2997,1970,4967,Mandera,NORTH EASTERN,18299
MANDERA EAST,Rural,14,5034,3101,8135,Mandera,NORTH EASTERN,18300
MANDERA EAST,Rural,15,3744,2055,5799,Mandera,NORTH EASTERN,18301
MANDERA EAST,Rural,16,4669,2501,7170,Mandera,NORTH EASTERN,18302
MANDERA EAST,Rural,17,2087,1271,3358,Mandera,NORTH EASTERN,18303
MANDERA EAST,Rural,18,4751,2549,7300,Mandera,NORTH EASTERN,18304
MANDERA EAST,Rural,19,1538,827,2365,Mandera,NORTH EASTERN,18305
MANDERA EAST,Rural,20,4168,2459,6627,Mandera,NORTH EASTERN,18306
MANDERA EAST,Rural,21,1230,734,1964,Mandera,NORTH EASTERN,18307
MANDERA EAST,Rural,22,1471,973,2444,Mandera,NORTH EASTERN,18308
MANDERA EAST,Rural,23,915,651,1566,Mandera,NORTH EASTERN,18309
MANDERA EAST,Rural,24,966,832,1798,Mandera,NORTH EASTERN,18310
MANDERA EAST,Rural,25,1691,1697,3388,Mandera,NORTH EASTERN,18311
MANDERA EAST,Rural,26,763,798,1561,Mandera,NORTH EASTERN,18312
MANDERA EAST,Rural,27,593,770,1363,Mandera,NORTH EASTERN,18313
MANDERA EAST,Rural,28,1236,1613,2849,Mandera,NORTH EASTERN,18314
MANDERA EAST,Rural,29,500,804,1304,Mandera,NORTH EASTERN,18315
MANDERA EAST,Rural,30,2609,2865,5474,Mandera,NORTH EASTERN,18316
MANDERA EAST,Rural,31,393,590,983,Mandera,NORTH EASTERN,18317
MANDERA EAST,Rural,32,798,1185,1983,Mandera,NORTH EASTERN,18318
MANDERA EAST,Rural,33,363,523,886,Mandera,NORTH EASTERN,18319
MANDERA EAST,Rural,34,392,659,1051,Mandera,NORTH EASTERN,18320
MANDERA EAST,Rural,35,1367,1871,3238,Mandera,NORTH EASTERN,18321
MANDERA EAST,Rural,36,514,777,1291,Mandera,NORTH EASTERN,18322
MANDERA EAST,Rural,37,459,675,1134,Mandera,NORTH EASTERN,18323
MANDERA EAST,Rural,38,903,1397,2300,Mandera,NORTH EASTERN,18324
MANDERA EAST,Rural,39,466,642,1108,Mandera,NORTH EASTERN,18325
MANDERA EAST,Rural,40,2865,2192,5057,Mandera,NORTH EASTERN,18326
MANDERA EAST,Rural,41,372,376,748,Mandera,NORTH EASTERN,18327
MANDERA EAST,Rural,42,742,609,1351,Mandera,NORTH EASTERN,18328
MANDERA EAST,Rural,43,367,320,687,Mandera,NORTH EASTERN,18329
MANDERA EAST,Rural,44,261,187,448,Mandera,NORTH EASTERN,18330
MANDERA EAST,Rural,45,1127,955,2082,Mandera,NORTH EASTERN,18331
MANDERA EAST,Rural,46,341,276,617,Mandera,NORTH EASTERN,18332
MANDERA EAST,Rural,47,295,238,533,Mandera,NORTH EASTERN,18333
MANDERA EAST,Rural,48,731,513,1244,Mandera,NORTH EASTERN,18334
MANDERA EAST,Rural,49,354,238,592,Mandera,NORTH EASTERN,18335
MANDERA EAST,Rural,50,1805,931,2736,Mandera,NORTH EASTERN,18336
MANDERA EAST,Rural,51,182,104,286,Mandera,NORTH EASTERN,18337
MANDERA EAST,Rural,52,417,186,603,Mandera,NORTH EASTERN,18338
MANDERA EAST,Rural,53,176,85,261,Mandera,NORTH EASTERN,18339
MANDERA EAST,Rural,54,198,97,295,Mandera,NORTH EASTERN,18340
MANDERA EAST,Rural,55,496,255,751,Mandera,NORTH EASTERN,18341
MANDERA EAST,Rural,56,249,107,356,Mandera,NORTH EASTERN,18342
MANDERA EAST,Rural,57,180,79,259,Mandera,NORTH EASTERN,18343
MANDERA EAST,Rural,58,253,122,375,Mandera,NORTH EASTERN,18344
MANDERA EAST,Rural,59,126,40,166,Mandera,NORTH EASTERN,18345
MANDERA EAST,Rural,60,1192,407,1599,Mandera,NORTH EASTERN,18346
MANDERA EAST,Rural,61,147,45,192,Mandera,NORTH EASTERN,18347
MANDERA EAST,Rural,62,222,61,283,Mandera,NORTH EASTERN,18348
MANDERA EAST,Rural,63,124,25,149,Mandera,NORTH EASTERN,18349
MANDERA EAST,Rural,64,118,36,154,Mandera,NORTH EASTERN,18350
MANDERA EAST,Rural,65,286,113,399,Mandera,NORTH EASTERN,18351
MANDERA EAST,Rural,66,64,20,84,Mandera,NORTH EASTERN,18352
MANDERA EAST,Rural,67,96,28,124,Mandera,NORTH EASTERN,18353
MANDERA EAST,Rural,68,145,39,184,Mandera,NORTH EASTERN,18354
MANDERA EAST,Rural,69,68,28,96,Mandera,NORTH EASTERN,18355
MANDERA EAST,Rural,70,600,231,831,Mandera,NORTH EASTERN,18356
MANDERA EAST,Rural,71,53,18,71,Mandera,NORTH EASTERN,18357
MANDERA EAST,Rural,72,84,40,124,Mandera,NORTH EASTERN,18358
MANDERA EAST,Rural,73,47,13,60,Mandera,NORTH EASTERN,18359
MANDERA EAST,Rural,74,53,14,67,Mandera,NORTH EASTERN,18360
MANDERA EAST,Rural,75,128,44,172,Mandera,NORTH EASTERN,18361
MANDERA EAST,Rural,76,49,11,60,Mandera,NORTH EASTERN,18362
MANDERA EAST,Rural,77,30,7,37,Mandera,NORTH EASTERN,18363
MANDERA EAST,Rural,78,55,31,86,Mandera,NORTH EASTERN,18364
MANDERA EAST,Rural,79,19,18,37,Mandera,NORTH EASTERN,18365
MANDERA EAST,Rural,80+,552,306,858,Mandera,NORTH EASTERN,18366
MANDERA EAST,Rural,Age NS,24,21,45,Mandera,NORTH EASTERN,18367
MANDERA WEST,Rural,0,2748,2785,5533,Mandera,NORTH EASTERN,18368
MANDERA WEST,Rural,1,2311,2258,4569,Mandera,NORTH EASTERN,18369
MANDERA WEST,Rural,2,6181,6073,12254,Mandera,NORTH EASTERN,18370
MANDERA WEST,Rural,3,3621,3586,7207,Mandera,NORTH EASTERN,18371
MANDERA WEST,Rural,4,7211,7089,14300,Mandera,NORTH EASTERN,18372
MANDERA WEST,Rural,5,4137,4058,8195,Mandera,NORTH EASTERN,18373
MANDERA WEST,Rural,6,8570,7887,16457,Mandera,NORTH EASTERN,18374
MANDERA WEST,Rural,7,4301,3961,8262,Mandera,NORTH EASTERN,18375
MANDERA WEST,Rural,8,9722,8276,17998,Mandera,NORTH EASTERN,18376
MANDERA WEST,Rural,9,4637,3862,8499,Mandera,NORTH EASTERN,18377
MANDERA WEST,Rural,10,10593,8483,19076,Mandera,NORTH EASTERN,18378
MANDERA WEST,Rural,11,3949,3236,7185,Mandera,NORTH EASTERN,18379
MANDERA WEST,Rural,12,9338,6784,16122,Mandera,NORTH EASTERN,18380
MANDERA WEST,Rural,13,4439,3267,7706,Mandera,NORTH EASTERN,18381
MANDERA WEST,Rural,14,7698,5224,12922,Mandera,NORTH EASTERN,18382
MANDERA WEST,Rural,15,5455,3280,8735,Mandera,NORTH EASTERN,18383
MANDERA WEST,Rural,16,6688,3936,10624,Mandera,NORTH EASTERN,18384
MANDERA WEST,Rural,17,3190,1915,5105,Mandera,NORTH EASTERN,18385
MANDERA WEST,Rural,18,6301,3581,9882,Mandera,NORTH EASTERN,18386
MANDERA WEST,Rural,19,1899,1141,3040,Mandera,NORTH EASTERN,18387
MANDERA WEST,Rural,20,5143,2749,7892,Mandera,NORTH EASTERN,18388
MANDERA WEST,Rural,21,1468,864,2332,Mandera,NORTH EASTERN,18389
MANDERA WEST,Rural,22,1731,1166,2897,Mandera,NORTH EASTERN,18390
MANDERA WEST,Rural,23,1020,699,1719,Mandera,NORTH EASTERN,18391
MANDERA WEST,Rural,24,1144,1081,2225,Mandera,NORTH EASTERN,18392
MANDERA WEST,Rural,25,1576,1653,3229,Mandera,NORTH EASTERN,18393
MANDERA WEST,Rural,26,836,1116,1952,Mandera,NORTH EASTERN,18394
MANDERA WEST,Rural,27,582,980,1562,Mandera,NORTH EASTERN,18395
MANDERA WEST,Rural,28,1231,2175,3406,Mandera,NORTH EASTERN,18396
MANDERA WEST,Rural,29,543,1055,1598,Mandera,NORTH EASTERN,18397
MANDERA WEST,Rural,30,2815,3710,6525,Mandera,NORTH EASTERN,18398
MANDERA WEST,Rural,31,420,764,1184,Mandera,NORTH EASTERN,18399
MANDERA WEST,Rural,32,955,1945,2900,Mandera,NORTH EASTERN,18400
MANDERA WEST,Rural,33,448,838,1286,Mandera,NORTH EASTERN,18401
MANDERA WEST,Rural,34,530,898,1428,Mandera,NORTH EASTERN,18402
MANDERA WEST,Rural,35,1599,2427,4026,Mandera,NORTH EASTERN,18403
MANDERA WEST,Rural,36,652,1326,1978,Mandera,NORTH EASTERN,18404
MANDERA WEST,Rural,37,535,853,1388,Mandera,NORTH EASTERN,18405
MANDERA WEST,Rural,38,1359,1998,3357,Mandera,NORTH EASTERN,18406
MANDERA WEST,Rural,39,706,960,1666,Mandera,NORTH EASTERN,18407
MANDERA WEST,Rural,40,3633,3084,6717,Mandera,NORTH EASTERN,18408
MANDERA WEST,Rural,41,513,532,1045,Mandera,NORTH EASTERN,18409
MANDERA WEST,Rural,42,1066,1060,2126,Mandera,NORTH EASTERN,18410
MANDERA WEST,Rural,43,579,511,1090,Mandera,NORTH EASTERN,18411
MANDERA WEST,Rural,44,428,370,798,Mandera,NORTH EASTERN,18412
MANDERA WEST,Rural,45,1657,1194,2851,Mandera,NORTH EASTERN,18413
MANDERA WEST,Rural,46,596,422,1018,Mandera,NORTH EASTERN,18414
MANDERA WEST,Rural,47,531,332,863,Mandera,NORTH EASTERN,18415
MANDERA WEST,Rural,48,1185,715,1900,Mandera,NORTH EASTERN,18416
MANDERA WEST,Rural,49,613,438,1051,Mandera,NORTH EASTERN,18417
MANDERA WEST,Rural,50,2477,1294,3771,Mandera,NORTH EASTERN,18418
MANDERA WEST,Rural,51,359,157,516,Mandera,NORTH EASTERN,18419
MANDERA WEST,Rural,52,623,292,915,Mandera,NORTH EASTERN,18420
MANDERA WEST,Rural,53,339,146,485,Mandera,NORTH EASTERN,18421
MANDERA WEST,Rural,54,422,167,589,Mandera,NORTH EASTERN,18422
MANDERA WEST,Rural,55,759,328,1087,Mandera,NORTH EASTERN,18423
MANDERA WEST,Rural,56,458,167,625,Mandera,NORTH EASTERN,18424
MANDERA WEST,Rural,57,235,85,320,Mandera,NORTH EASTERN,18425
MANDERA WEST,Rural,58,423,146,569,Mandera,NORTH EASTERN,18426
MANDERA WEST,Rural,59,184,72,256,Mandera,NORTH EASTERN,18427
MANDERA WEST,Rural,60,1832,619,2451,Mandera,NORTH EASTERN,18428
MANDERA WEST,Rural,61,163,47,210,Mandera,NORTH EASTERN,18429
MANDERA WEST,Rural,62,270,104,374,Mandera,NORTH EASTERN,18430
MANDERA WEST,Rural,63,227,85,312,Mandera,NORTH EASTERN,18431
MANDERA WEST,Rural,64,174,61,235,Mandera,NORTH EASTERN,18432
MANDERA WEST,Rural,65,424,120,544,Mandera,NORTH EASTERN,18433
MANDERA WEST,Rural,66,95,25,120,Mandera,NORTH EASTERN,18434
MANDERA WEST,Rural,67,121,34,155,Mandera,NORTH EASTERN,18435
MANDERA WEST,Rural,68,172,79,251,Mandera,NORTH EASTERN,18436
MANDERA WEST,Rural,69,79,37,116,Mandera,NORTH EASTERN,18437
MANDERA WEST,Rural,70,987,373,1360,Mandera,NORTH EASTERN,18438
MANDERA WEST,Rural,71,83,25,108,Mandera,NORTH EASTERN,18439
MANDERA WEST,Rural,72,140,80,220,Mandera,NORTH EASTERN,18440
MANDERA WEST,Rural,73,86,30,116,Mandera,NORTH EASTERN,18441
MANDERA WEST,Rural,74,77,39,116,Mandera,NORTH EASTERN,18442
MANDERA WEST,Rural,75,159,71,230,Mandera,NORTH EASTERN,18443
MANDERA WEST,Rural,76,50,29,79,Mandera,NORTH EASTERN,18444
MANDERA WEST,Rural,77,37,25,62,Mandera,NORTH EASTERN,18445
MANDERA WEST,Rural,78,88,50,138,Mandera,NORTH EASTERN,18446
MANDERA WEST,Rural,79,32,36,68,Mandera,NORTH EASTERN,18447
MANDERA WEST,Rural,80+,939,572,1511,Mandera,NORTH EASTERN,18448
MANDERA WEST,Rural,Age NS,31,30,61,Mandera,NORTH EASTERN,18449
SIAYA,Rural,0,8901,8828,17729,Siaya,NYANZA,18450
SIAYA,Rural,1,8000,7953,15953,Siaya,NYANZA,18451
SIAYA,Rural,2,8884,8824,17708,Siaya,NYANZA,18452
SIAYA,Rural,3,8652,8609,17261,Siaya,NYANZA,18453
SIAYA,Rural,4,8220,7921,16141,Siaya,NYANZA,18454
SIAYA,Rural,5,8119,7938,16057,Siaya,NYANZA,18455
SIAYA,Rural,6,7645,7400,15045,Siaya,NYANZA,18456
SIAYA,Rural,7,7110,7057,14167,Siaya,NYANZA,18457
SIAYA,Rural,8,6748,7035,13783,Siaya,NYANZA,18458
SIAYA,Rural,9,7517,7347,14864,Siaya,NYANZA,18459
SIAYA,Rural,10,8026,7774,15800,Siaya,NYANZA,18460
SIAYA,Rural,11,6217,6325,12542,Siaya,NYANZA,18461
SIAYA,Rural,12,7777,7174,14951,Siaya,NYANZA,18462
SIAYA,Rural,13,7228,6921,14149,Siaya,NYANZA,18463
SIAYA,Rural,14,6656,6314,12970,Siaya,NYANZA,18464
SIAYA,Rural,15,6889,6510,13399,Siaya,NYANZA,18465
SIAYA,Rural,16,6125,5865,11990,Siaya,NYANZA,18466
SIAYA,Rural,17,6676,6219,12895,Siaya,NYANZA,18467
SIAYA,Rural,18,5815,5358,11173,Siaya,NYANZA,18468
SIAYA,Rural,19,4471,4760,9231,Siaya,NYANZA,18469
SIAYA,Rural,20,4841,6059,10900,Siaya,NYANZA,18470
SIAYA,Rural,21,3381,4027,7408,Siaya,NYANZA,18471
SIAYA,Rural,22,3373,4533,7906,Siaya,NYANZA,18472
SIAYA,Rural,23,3195,4448,7643,Siaya,NYANZA,18473
SIAYA,Rural,24,2916,3893,6809,Siaya,NYANZA,18474
SIAYA,Rural,25,3482,4679,8161,Siaya,NYANZA,18475
SIAYA,Rural,26,2614,3373,5987,Siaya,NYANZA,18476
SIAYA,Rural,27,2855,3399,6254,Siaya,NYANZA,18477
SIAYA,Rural,28,2179,2957,5136,Siaya,NYANZA,18478
SIAYA,Rural,29,2243,2744,4987,Siaya,NYANZA,18479
SIAYA,Rural,30,3258,4430,7688,Siaya,NYANZA,18480
SIAYA,Rural,31,1909,2121,4030,Siaya,NYANZA,18481
SIAYA,Rural,32,2243,2657,4900,Siaya,NYANZA,18482
SIAYA,Rural,33,1767,1926,3693,Siaya,NYANZA,18483
SIAYA,Rural,34,1914,2124,4038,Siaya,NYANZA,18484
SIAYA,Rural,35,2598,3326,5924,Siaya,NYANZA,18485
SIAYA,Rural,36,1632,1985,3617,Siaya,NYANZA,18486
SIAYA,Rural,37,1637,1859,3496,Siaya,NYANZA,18487
SIAYA,Rural,38,1332,1961,3293,Siaya,NYANZA,18488
SIAYA,Rural,39,1291,1816,3107,Siaya,NYANZA,18489
SIAYA,Rural,40,2186,3816,6002,Siaya,NYANZA,18490
SIAYA,Rural,41,1147,1746,2893,Siaya,NYANZA,18491
SIAYA,Rural,42,1136,1770,2906,Siaya,NYANZA,18492
SIAYA,Rural,43,975,1490,2465,Siaya,NYANZA,18493
SIAYA,Rural,44,1039,1410,2449,Siaya,NYANZA,18494
SIAYA,Rural,45,1801,2830,4631,Siaya,NYANZA,18495
SIAYA,Rural,46,1247,1927,3174,Siaya,NYANZA,18496
SIAYA,Rural,47,1185,2036,3221,Siaya,NYANZA,18497
SIAYA,Rural,48,988,1604,2592,Siaya,NYANZA,18498
SIAYA,Rural,49,1043,1705,2748,Siaya,NYANZA,18499
SIAYA,Rural,50,1657,3245,4902,Siaya,NYANZA,18500
SIAYA,Rural,51,1012,1685,2697,Siaya,NYANZA,18501
SIAYA,Rural,52,1068,1683,2751,Siaya,NYANZA,18502
SIAYA,Rural,53,946,1568,2514,Siaya,NYANZA,18503
SIAYA,Rural,54,999,1586,2585,Siaya,NYANZA,18504
SIAYA,Rural,55,1287,2081,3368,Siaya,NYANZA,18505
SIAYA,Rural,56,1203,1785,2988,Siaya,NYANZA,18506
SIAYA,Rural,57,1282,2096,3378,Siaya,NYANZA,18507
SIAYA,Rural,58,716,976,1692,Siaya,NYANZA,18508
SIAYA,Rural,59,1016,1468,2484,Siaya,NYANZA,18509
SIAYA,Rural,60,1625,2919,4544,Siaya,NYANZA,18510
SIAYA,Rural,61,960,1451,2411,Siaya,NYANZA,18511
SIAYA,Rural,62,889,1034,1923,Siaya,NYANZA,18512
SIAYA,Rural,63,819,1096,1915,Siaya,NYANZA,18513
SIAYA,Rural,64,810,1310,2120,Siaya,NYANZA,18514
SIAYA,Rural,65,904,1369,2273,Siaya,NYANZA,18515
SIAYA,Rural,66,580,837,1417,Siaya,NYANZA,18516
SIAYA,Rural,67,928,1329,2257,Siaya,NYANZA,18517
SIAYA,Rural,68,482,674,1156,Siaya,NYANZA,18518
SIAYA,Rural,69,657,1222,1879,Siaya,NYANZA,18519
SIAYA,Rural,70,1171,1882,3053,Siaya,NYANZA,18520
SIAYA,Rural,71,617,843,1460,Siaya,NYANZA,18521
SIAYA,Rural,72,687,833,1520,Siaya,NYANZA,18522
SIAYA,Rural,73,648,703,1351,Siaya,NYANZA,18523
SIAYA,Rural,74,566,784,1350,Siaya,NYANZA,18524
SIAYA,Rural,75,633,898,1531,Siaya,NYANZA,18525
SIAYA,Rural,76,504,503,1007,Siaya,NYANZA,18526
SIAYA,Rural,77,550,700,1250,Siaya,NYANZA,18527
SIAYA,Rural,78,432,673,1105,Siaya,NYANZA,18528
SIAYA,Rural,79,465,1022,1487,Siaya,NYANZA,18529
SIAYA,Rural,80+,2866,4147,7013,Siaya,NYANZA,18530
SIAYA,Rural,Age NS,191,231,422,Siaya,NYANZA,18531
BONDO,Rural,0,2046,2070,4116,Siaya,NYANZA,18532
BONDO,Rural,1,1886,1866,3752,Siaya,NYANZA,18533
BONDO,Rural,2,2064,2060,4124,Siaya,NYANZA,18534
BONDO,Rural,3,1951,2037,3988,Siaya,NYANZA,18535
BONDO,Rural,4,1870,1878,3748,Siaya,NYANZA,18536
BONDO,Rural,5,1789,1765,3554,Siaya,NYANZA,18537
BONDO,Rural,6,1618,1635,3253,Siaya,NYANZA,18538
BONDO,Rural,7,1521,1516,3037,Siaya,NYANZA,18539
BONDO,Rural,8,1511,1426,2937,Siaya,NYANZA,18540
BONDO,Rural,9,1597,1592,3189,Siaya,NYANZA,18541
BONDO,Rural,10,1641,1635,3276,Siaya,NYANZA,18542
BONDO,Rural,11,1315,1287,2602,Siaya,NYANZA,18543
BONDO,Rural,12,1648,1487,3135,Siaya,NYANZA,18544
BONDO,Rural,13,1416,1353,2769,Siaya,NYANZA,18545
BONDO,Rural,14,1276,1255,2531,Siaya,NYANZA,18546
BONDO,Rural,15,1488,1305,2793,Siaya,NYANZA,18547
BONDO,Rural,16,1218,1147,2365,Siaya,NYANZA,18548
BONDO,Rural,17,1338,1258,2596,Siaya,NYANZA,18549
BONDO,Rural,18,1291,1145,2436,Siaya,NYANZA,18550
BONDO,Rural,19,1081,962,2043,Siaya,NYANZA,18551
BONDO,Rural,20,1348,1629,2977,Siaya,NYANZA,18552
BONDO,Rural,21,910,1038,1948,Siaya,NYANZA,18553
BONDO,Rural,22,993,1158,2151,Siaya,NYANZA,18554
BONDO,Rural,23,975,1142,2117,Siaya,NYANZA,18555
BONDO,Rural,24,1022,1025,2047,Siaya,NYANZA,18556
BONDO,Rural,25,1127,1206,2333,Siaya,NYANZA,18557
BONDO,Rural,26,802,836,1638,Siaya,NYANZA,18558
BONDO,Rural,27,902,843,1745,Siaya,NYANZA,18559
BONDO,Rural,28,715,669,1384,Siaya,NYANZA,18560
BONDO,Rural,29,732,596,1328,Siaya,NYANZA,18561
BONDO,Rural,30,951,983,1934,Siaya,NYANZA,18562
BONDO,Rural,31,566,418,984,Siaya,NYANZA,18563
BONDO,Rural,32,606,631,1237,Siaya,NYANZA,18564
BONDO,Rural,33,434,426,860,Siaya,NYANZA,18565
BONDO,Rural,34,473,450,923,Siaya,NYANZA,18566
BONDO,Rural,35,642,746,1388,Siaya,NYANZA,18567
BONDO,Rural,36,400,431,831,Siaya,NYANZA,18568
BONDO,Rural,37,380,386,766,Siaya,NYANZA,18569
BONDO,Rural,38,322,354,676,Siaya,NYANZA,18570
BONDO,Rural,39,301,299,600,Siaya,NYANZA,18571
BONDO,Rural,40,524,723,1247,Siaya,NYANZA,18572
BONDO,Rural,41,260,341,601,Siaya,NYANZA,18573
BONDO,Rural,42,274,328,602,Siaya,NYANZA,18574
BONDO,Rural,43,199,288,487,Siaya,NYANZA,18575
BONDO,Rural,44,201,232,433,Siaya,NYANZA,18576
BONDO,Rural,45,380,536,916,Siaya,NYANZA,18577
BONDO,Rural,46,229,328,557,Siaya,NYANZA,18578
BONDO,Rural,47,275,379,654,Siaya,NYANZA,18579
BONDO,Rural,48,180,265,445,Siaya,NYANZA,18580
BONDO,Rural,49,234,311,545,Siaya,NYANZA,18581
BONDO,Rural,50,334,521,855,Siaya,NYANZA,18582
BONDO,Rural,51,223,268,491,Siaya,NYANZA,18583
BONDO,Rural,52,223,273,496,Siaya,NYANZA,18584
BONDO,Rural,53,192,255,447,Siaya,NYANZA,18585
BONDO,Rural,54,178,254,432,Siaya,NYANZA,18586
BONDO,Rural,55,262,342,604,Siaya,NYANZA,18587
BONDO,Rural,56,209,319,528,Siaya,NYANZA,18588
BONDO,Rural,57,220,343,563,Siaya,NYANZA,18589
BONDO,Rural,58,147,135,282,Siaya,NYANZA,18590
BONDO,Rural,59,178,207,385,Siaya,NYANZA,18591
BONDO,Rural,60,305,460,765,Siaya,NYANZA,18592
BONDO,Rural,61,196,222,418,Siaya,NYANZA,18593
BONDO,Rural,62,128,180,308,Siaya,NYANZA,18594
BONDO,Rural,63,124,159,283,Siaya,NYANZA,18595
BONDO,Rural,64,134,182,316,Siaya,NYANZA,18596
BONDO,Rural,65,129,170,299,Siaya,NYANZA,18597
BONDO,Rural,66,93,120,213,Siaya,NYANZA,18598
BONDO,Rural,67,147,209,356,Siaya,NYANZA,18599
BONDO,Rural,68,66,107,173,Siaya,NYANZA,18600
BONDO,Rural,69,101,179,280,Siaya,NYANZA,18601
BONDO,Rural,70,164,283,447,Siaya,NYANZA,18602
BONDO,Rural,71,83,114,197,Siaya,NYANZA,18603
BONDO,Rural,72,87,150,237,Siaya,NYANZA,18604
BONDO,Rural,73,87,92,179,Siaya,NYANZA,18605
BONDO,Rural,74,63,110,173,Siaya,NYANZA,18606
BONDO,Rural,75,69,138,207,Siaya,NYANZA,18607
BONDO,Rural,76,60,86,146,Siaya,NYANZA,18608
BONDO,Rural,77,68,146,214,Siaya,NYANZA,18609
BONDO,Rural,78,58,91,149,Siaya,NYANZA,18610
BONDO,Rural,79,52,136,188,Siaya,NYANZA,18611
BONDO,Rural,80+,499,706,1205,Siaya,NYANZA,18612
BONDO,Rural,Age NS,22,10,32,Siaya,NYANZA,18613
RARIEDA,Rural,0,2383,2267,4650,Siaya,NYANZA,18614
RARIEDA,Rural,1,1997,1988,3985,Siaya,NYANZA,18615
RARIEDA,Rural,2,2267,2192,4459,Siaya,NYANZA,18616
RARIEDA,Rural,3,2326,2275,4601,Siaya,NYANZA,18617
RARIEDA,Rural,4,2110,2115,4225,Siaya,NYANZA,18618
RARIEDA,Rural,5,2133,2037,4170,Siaya,NYANZA,18619
RARIEDA,Rural,6,2047,1958,4005,Siaya,NYANZA,18620
RARIEDA,Rural,7,1916,1823,3739,Siaya,NYANZA,18621
RARIEDA,Rural,8,1789,1930,3719,Siaya,NYANZA,18622
RARIEDA,Rural,9,2008,1945,3953,Siaya,NYANZA,18623
RARIEDA,Rural,10,2094,2026,4120,Siaya,NYANZA,18624
RARIEDA,Rural,11,1597,1684,3281,Siaya,NYANZA,18625
RARIEDA,Rural,12,2044,1866,3910,Siaya,NYANZA,18626
RARIEDA,Rural,13,1870,1696,3566,Siaya,NYANZA,18627
RARIEDA,Rural,14,1672,1625,3297,Siaya,NYANZA,18628
RARIEDA,Rural,15,1775,1733,3508,Siaya,NYANZA,18629
RARIEDA,Rural,16,1512,1581,3093,Siaya,NYANZA,18630
RARIEDA,Rural,17,1737,1601,3338,Siaya,NYANZA,18631
RARIEDA,Rural,18,1616,1443,3059,Siaya,NYANZA,18632
RARIEDA,Rural,19,1255,1167,2422,Siaya,NYANZA,18633
RARIEDA,Rural,20,1369,1664,3033,Siaya,NYANZA,18634
RARIEDA,Rural,21,988,1165,2153,Siaya,NYANZA,18635
RARIEDA,Rural,22,1049,1280,2329,Siaya,NYANZA,18636
RARIEDA,Rural,23,1025,1269,2294,Siaya,NYANZA,18637
RARIEDA,Rural,24,930,1105,2035,Siaya,NYANZA,18638
RARIEDA,Rural,25,1095,1256,2351,Siaya,NYANZA,18639
RARIEDA,Rural,26,847,932,1779,Siaya,NYANZA,18640
RARIEDA,Rural,27,909,905,1814,Siaya,NYANZA,18641
RARIEDA,Rural,28,684,746,1430,Siaya,NYANZA,18642
RARIEDA,Rural,29,658,680,1338,Siaya,NYANZA,18643
RARIEDA,Rural,30,985,1178,2163,Siaya,NYANZA,18644
RARIEDA,Rural,31,537,529,1066,Siaya,NYANZA,18645
RARIEDA,Rural,32,621,668,1289,Siaya,NYANZA,18646
RARIEDA,Rural,33,522,480,1002,Siaya,NYANZA,18647
RARIEDA,Rural,34,527,544,1071,Siaya,NYANZA,18648
RARIEDA,Rural,35,702,897,1599,Siaya,NYANZA,18649
RARIEDA,Rural,36,456,507,963,Siaya,NYANZA,18650
RARIEDA,Rural,37,407,470,877,Siaya,NYANZA,18651
RARIEDA,Rural,38,297,466,763,Siaya,NYANZA,18652
RARIEDA,Rural,39,309,403,712,Siaya,NYANZA,18653
RARIEDA,Rural,40,569,918,1487,Siaya,NYANZA,18654
RARIEDA,Rural,41,293,401,694,Siaya,NYANZA,18655
RARIEDA,Rural,42,316,387,703,Siaya,NYANZA,18656
RARIEDA,Rural,43,261,348,609,Siaya,NYANZA,18657
RARIEDA,Rural,44,245,292,537,Siaya,NYANZA,18658
RARIEDA,Rural,45,459,637,1096,Siaya,NYANZA,18659
RARIEDA,Rural,46,295,444,739,Siaya,NYANZA,18660
RARIEDA,Rural,47,342,438,780,Siaya,NYANZA,18661
RARIEDA,Rural,48,251,344,595,Siaya,NYANZA,18662
RARIEDA,Rural,49,261,398,659,Siaya,NYANZA,18663
RARIEDA,Rural,50,411,823,1234,Siaya,NYANZA,18664
RARIEDA,Rural,51,266,358,624,Siaya,NYANZA,18665
RARIEDA,Rural,52,264,397,661,Siaya,NYANZA,18666
RARIEDA,Rural,53,225,358,583,Siaya,NYANZA,18667
RARIEDA,Rural,54,237,344,581,Siaya,NYANZA,18668
RARIEDA,Rural,55,302,392,694,Siaya,NYANZA,18669
RARIEDA,Rural,56,286,476,762,Siaya,NYANZA,18670
RARIEDA,Rural,57,323,476,799,Siaya,NYANZA,18671
RARIEDA,Rural,58,168,205,373,Siaya,NYANZA,18672
RARIEDA,Rural,59,208,257,465,Siaya,NYANZA,18673
RARIEDA,Rural,60,397,559,956,Siaya,NYANZA,18674
RARIEDA,Rural,61,244,303,547,Siaya,NYANZA,18675
RARIEDA,Rural,62,232,224,456,Siaya,NYANZA,18676
RARIEDA,Rural,63,194,227,421,Siaya,NYANZA,18677
RARIEDA,Rural,64,199,229,428,Siaya,NYANZA,18678
RARIEDA,Rural,65,198,288,486,Siaya,NYANZA,18679
RARIEDA,Rural,66,132,202,334,Siaya,NYANZA,18680
RARIEDA,Rural,67,192,291,483,Siaya,NYANZA,18681
RARIEDA,Rural,68,105,162,267,Siaya,NYANZA,18682
RARIEDA,Rural,69,132,255,387,Siaya,NYANZA,18683
RARIEDA,Rural,70,260,398,658,Siaya,NYANZA,18684
RARIEDA,Rural,71,137,203,340,Siaya,NYANZA,18685
RARIEDA,Rural,72,140,171,311,Siaya,NYANZA,18686
RARIEDA,Rural,73,133,137,270,Siaya,NYANZA,18687
RARIEDA,Rural,74,112,172,284,Siaya,NYANZA,18688
RARIEDA,Rural,75,128,171,299,Siaya,NYANZA,18689
RARIEDA,Rural,76,107,115,222,Siaya,NYANZA,18690
RARIEDA,Rural,77,124,230,354,Siaya,NYANZA,18691
RARIEDA,Rural,78,76,154,230,Siaya,NYANZA,18692
RARIEDA,Rural,79,78,188,266,Siaya,NYANZA,18693
RARIEDA,Rural,80+,613,1016,1629,Siaya,NYANZA,18694
RARIEDA,Rural,Age NS,40,38,78,Siaya,NYANZA,18695
KISUMU EAST,Rural,0,1547,1488,3035,Kisumu,NYANZA,18696
KISUMU EAST,Rural,1,1339,1326,2665,Kisumu,NYANZA,18697
KISUMU EAST,Rural,2,1514,1497,3011,Kisumu,NYANZA,18698
KISUMU EAST,Rural,3,1459,1512,2971,Kisumu,NYANZA,18699
KISUMU EAST,Rural,4,1425,1369,2794,Kisumu,NYANZA,18700
KISUMU EAST,Rural,5,1355,1331,2686,Kisumu,NYANZA,18701
KISUMU EAST,Rural,6,1205,1220,2425,Kisumu,NYANZA,18702
KISUMU EAST,Rural,7,1160,1225,2385,Kisumu,NYANZA,18703
KISUMU EAST,Rural,8,1147,1197,2344,Kisumu,NYANZA,18704
KISUMU EAST,Rural,9,1199,1240,2439,Kisumu,NYANZA,18705
KISUMU EAST,Rural,10,1336,1271,2607,Kisumu,NYANZA,18706
KISUMU EAST,Rural,11,981,924,1905,Kisumu,NYANZA,18707
KISUMU EAST,Rural,12,1259,1250,2509,Kisumu,NYANZA,18708
KISUMU EAST,Rural,13,1190,1088,2278,Kisumu,NYANZA,18709
KISUMU EAST,Rural,14,1056,1131,2187,Kisumu,NYANZA,18710
KISUMU EAST,Rural,15,1118,1072,2190,Kisumu,NYANZA,18711
KISUMU EAST,Rural,16,1013,947,1960,Kisumu,NYANZA,18712
KISUMU EAST,Rural,17,1013,958,1971,Kisumu,NYANZA,18713
KISUMU EAST,Rural,18,972,927,1899,Kisumu,NYANZA,18714
KISUMU EAST,Rural,19,742,788,1530,Kisumu,NYANZA,18715
KISUMU EAST,Rural,20,896,1153,2049,Kisumu,NYANZA,18716
KISUMU EAST,Rural,21,626,690,1316,Kisumu,NYANZA,18717
KISUMU EAST,Rural,22,715,807,1522,Kisumu,NYANZA,18718
KISUMU EAST,Rural,23,665,765,1430,Kisumu,NYANZA,18719
KISUMU EAST,Rural,24,664,743,1407,Kisumu,NYANZA,18720
KISUMU EAST,Rural,25,802,753,1555,Kisumu,NYANZA,18721
KISUMU EAST,Rural,26,617,573,1190,Kisumu,NYANZA,18722
KISUMU EAST,Rural,27,622,573,1195,Kisumu,NYANZA,18723
KISUMU EAST,Rural,28,550,510,1060,Kisumu,NYANZA,18724
KISUMU EAST,Rural,29,512,392,904,Kisumu,NYANZA,18725
KISUMU EAST,Rural,30,697,764,1461,Kisumu,NYANZA,18726
KISUMU EAST,Rural,31,405,313,718,Kisumu,NYANZA,18727
KISUMU EAST,Rural,32,497,438,935,Kisumu,NYANZA,18728
KISUMU EAST,Rural,33,331,292,623,Kisumu,NYANZA,18729
KISUMU EAST,Rural,34,328,279,607,Kisumu,NYANZA,18730
KISUMU EAST,Rural,35,516,511,1027,Kisumu,NYANZA,18731
KISUMU EAST,Rural,36,281,300,581,Kisumu,NYANZA,18732
KISUMU EAST,Rural,37,315,263,578,Kisumu,NYANZA,18733
KISUMU EAST,Rural,38,294,324,618,Kisumu,NYANZA,18734
KISUMU EAST,Rural,39,244,236,480,Kisumu,NYANZA,18735
KISUMU EAST,Rural,40,419,671,1090,Kisumu,NYANZA,18736
KISUMU EAST,Rural,41,209,246,455,Kisumu,NYANZA,18737
KISUMU EAST,Rural,42,233,246,479,Kisumu,NYANZA,18738
KISUMU EAST,Rural,43,175,209,384,Kisumu,NYANZA,18739
KISUMU EAST,Rural,44,184,192,376,Kisumu,NYANZA,18740
KISUMU EAST,Rural,45,324,481,805,Kisumu,NYANZA,18741
KISUMU EAST,Rural,46,206,238,444,Kisumu,NYANZA,18742
KISUMU EAST,Rural,47,236,292,528,Kisumu,NYANZA,18743
KISUMU EAST,Rural,48,197,217,414,Kisumu,NYANZA,18744
KISUMU EAST,Rural,49,206,205,411,Kisumu,NYANZA,18745
KISUMU EAST,Rural,50,293,430,723,Kisumu,NYANZA,18746
KISUMU EAST,Rural,51,173,194,367,Kisumu,NYANZA,18747
KISUMU EAST,Rural,52,198,192,390,Kisumu,NYANZA,18748
KISUMU EAST,Rural,53,172,185,357,Kisumu,NYANZA,18749
KISUMU EAST,Rural,54,184,215,399,Kisumu,NYANZA,18750
KISUMU EAST,Rural,55,240,271,511,Kisumu,NYANZA,18751
KISUMU EAST,Rural,56,184,196,380,Kisumu,NYANZA,18752
KISUMU EAST,Rural,57,205,237,442,Kisumu,NYANZA,18753
KISUMU EAST,Rural,58,124,121,245,Kisumu,NYANZA,18754
KISUMU EAST,Rural,59,151,156,307,Kisumu,NYANZA,18755
KISUMU EAST,Rural,60,241,314,555,Kisumu,NYANZA,18756
KISUMU EAST,Rural,61,135,110,245,Kisumu,NYANZA,18757
KISUMU EAST,Rural,62,134,118,252,Kisumu,NYANZA,18758
KISUMU EAST,Rural,63,107,96,203,Kisumu,NYANZA,18759
KISUMU EAST,Rural,64,118,135,253,Kisumu,NYANZA,18760
KISUMU EAST,Rural,65,116,179,295,Kisumu,NYANZA,18761
KISUMU EAST,Rural,66,71,147,218,Kisumu,NYANZA,18762
KISUMU EAST,Rural,67,120,118,238,Kisumu,NYANZA,18763
KISUMU EAST,Rural,68,47,72,119,Kisumu,NYANZA,18764
KISUMU EAST,Rural,69,88,119,207,Kisumu,NYANZA,18765
KISUMU EAST,Rural,70,136,219,355,Kisumu,NYANZA,18766
KISUMU EAST,Rural,71,74,66,140,Kisumu,NYANZA,18767
KISUMU EAST,Rural,72,82,71,153,Kisumu,NYANZA,18768
KISUMU EAST,Rural,73,67,68,135,Kisumu,NYANZA,18769
KISUMU EAST,Rural,74,53,78,131,Kisumu,NYANZA,18770
KISUMU EAST,Rural,75,88,91,179,Kisumu,NYANZA,18771
KISUMU EAST,Rural,76,53,60,113,Kisumu,NYANZA,18772
KISUMU EAST,Rural,77,68,78,146,Kisumu,NYANZA,18773
KISUMU EAST,Rural,78,39,82,121,Kisumu,NYANZA,18774
KISUMU EAST,Rural,79,30,67,97,Kisumu,NYANZA,18775
KISUMU EAST,Rural,80+,292,469,761,Kisumu,NYANZA,18776
KISUMU EAST,Rural,Age NS,12,3,15,Kisumu,NYANZA,18777
KISUMU WEST,Rural,0,2446,2404,4850,Kisumu,NYANZA,18778
KISUMU WEST,Rural,1,2253,2099,4352,Kisumu,NYANZA,18779
KISUMU WEST,Rural,2,2453,2550,5003,Kisumu,NYANZA,18780
KISUMU WEST,Rural,3,2403,2407,4810,Kisumu,NYANZA,18781
KISUMU WEST,Rural,4,2122,2158,4280,Kisumu,NYANZA,18782
KISUMU WEST,Rural,5,2215,2108,4323,Kisumu,NYANZA,18783
KISUMU WEST,Rural,6,2095,2116,4211,Kisumu,NYANZA,18784
KISUMU WEST,Rural,7,1898,1876,3774,Kisumu,NYANZA,18785
KISUMU WEST,Rural,8,1891,1892,3783,Kisumu,NYANZA,18786
KISUMU WEST,Rural,9,2152,2157,4309,Kisumu,NYANZA,18787
KISUMU WEST,Rural,10,2169,2250,4419,Kisumu,NYANZA,18788
KISUMU WEST,Rural,11,1826,1780,3606,Kisumu,NYANZA,18789
KISUMU WEST,Rural,12,2218,2048,4266,Kisumu,NYANZA,18790
KISUMU WEST,Rural,13,2004,1901,3905,Kisumu,NYANZA,18791
KISUMU WEST,Rural,14,1835,1764,3599,Kisumu,NYANZA,18792
KISUMU WEST,Rural,15,1824,1780,3604,Kisumu,NYANZA,18793
KISUMU WEST,Rural,16,1758,1578,3336,Kisumu,NYANZA,18794
KISUMU WEST,Rural,17,1852,1591,3443,Kisumu,NYANZA,18795
KISUMU WEST,Rural,18,1637,1486,3123,Kisumu,NYANZA,18796
KISUMU WEST,Rural,19,1260,1275,2535,Kisumu,NYANZA,18797
KISUMU WEST,Rural,20,1404,1725,3129,Kisumu,NYANZA,18798
KISUMU WEST,Rural,21,899,1138,2037,Kisumu,NYANZA,18799
KISUMU WEST,Rural,22,984,1296,2280,Kisumu,NYANZA,18800
KISUMU WEST,Rural,23,920,1311,2231,Kisumu,NYANZA,18801
KISUMU WEST,Rural,24,856,1202,2058,Kisumu,NYANZA,18802
KISUMU WEST,Rural,25,989,1215,2204,Kisumu,NYANZA,18803
KISUMU WEST,Rural,26,739,945,1684,Kisumu,NYANZA,18804
KISUMU WEST,Rural,27,813,906,1719,Kisumu,NYANZA,18805
KISUMU WEST,Rural,28,669,800,1469,Kisumu,NYANZA,18806
KISUMU WEST,Rural,29,647,728,1375,Kisumu,NYANZA,18807
KISUMU WEST,Rural,30,917,1258,2175,Kisumu,NYANZA,18808
KISUMU WEST,Rural,31,552,517,1069,Kisumu,NYANZA,18809
KISUMU WEST,Rural,32,642,722,1364,Kisumu,NYANZA,18810
KISUMU WEST,Rural,33,491,536,1027,Kisumu,NYANZA,18811
KISUMU WEST,Rural,34,490,531,1021,Kisumu,NYANZA,18812
KISUMU WEST,Rural,35,673,974,1647,Kisumu,NYANZA,18813
KISUMU WEST,Rural,36,471,558,1029,Kisumu,NYANZA,18814
KISUMU WEST,Rural,37,441,523,964,Kisumu,NYANZA,18815
KISUMU WEST,Rural,38,352,528,880,Kisumu,NYANZA,18816
KISUMU WEST,Rural,39,317,436,753,Kisumu,NYANZA,18817
KISUMU WEST,Rural,40,599,1067,1666,Kisumu,NYANZA,18818
KISUMU WEST,Rural,41,317,420,737,Kisumu,NYANZA,18819
KISUMU WEST,Rural,42,341,483,824,Kisumu,NYANZA,18820
KISUMU WEST,Rural,43,256,396,652,Kisumu,NYANZA,18821
KISUMU WEST,Rural,44,262,370,632,Kisumu,NYANZA,18822
KISUMU WEST,Rural,45,462,768,1230,Kisumu,NYANZA,18823
KISUMU WEST,Rural,46,335,527,862,Kisumu,NYANZA,18824
KISUMU WEST,Rural,47,343,515,858,Kisumu,NYANZA,18825
KISUMU WEST,Rural,48,240,407,647,Kisumu,NYANZA,18826
KISUMU WEST,Rural,49,289,428,717,Kisumu,NYANZA,18827
KISUMU WEST,Rural,50,483,910,1393,Kisumu,NYANZA,18828
KISUMU WEST,Rural,51,272,397,669,Kisumu,NYANZA,18829
KISUMU WEST,Rural,52,307,427,734,Kisumu,NYANZA,18830
KISUMU WEST,Rural,53,278,395,673,Kisumu,NYANZA,18831
KISUMU WEST,Rural,54,274,339,613,Kisumu,NYANZA,18832
KISUMU WEST,Rural,55,351,493,844,Kisumu,NYANZA,18833
KISUMU WEST,Rural,56,349,433,782,Kisumu,NYANZA,18834
KISUMU WEST,Rural,57,345,450,795,Kisumu,NYANZA,18835
KISUMU WEST,Rural,58,195,238,433,Kisumu,NYANZA,18836
KISUMU WEST,Rural,59,262,288,550,Kisumu,NYANZA,18837
KISUMU WEST,Rural,60,475,652,1127,Kisumu,NYANZA,18838
KISUMU WEST,Rural,61,318,317,635,Kisumu,NYANZA,18839
KISUMU WEST,Rural,62,226,218,444,Kisumu,NYANZA,18840
KISUMU WEST,Rural,63,206,202,408,Kisumu,NYANZA,18841
KISUMU WEST,Rural,64,186,298,484,Kisumu,NYANZA,18842
KISUMU WEST,Rural,65,225,304,529,Kisumu,NYANZA,18843
KISUMU WEST,Rural,66,181,251,432,Kisumu,NYANZA,18844
KISUMU WEST,Rural,67,210,245,455,Kisumu,NYANZA,18845
KISUMU WEST,Rural,68,105,150,255,Kisumu,NYANZA,18846
KISUMU WEST,Rural,69,159,263,422,Kisumu,NYANZA,18847
KISUMU WEST,Rural,70,272,423,695,Kisumu,NYANZA,18848
KISUMU WEST,Rural,71,143,162,305,Kisumu,NYANZA,18849
KISUMU WEST,Rural,72,140,167,307,Kisumu,NYANZA,18850
KISUMU WEST,Rural,73,127,120,247,Kisumu,NYANZA,18851
KISUMU WEST,Rural,74,109,174,283,Kisumu,NYANZA,18852
KISUMU WEST,Rural,75,143,196,339,Kisumu,NYANZA,18853
KISUMU WEST,Rural,76,89,120,209,Kisumu,NYANZA,18854
KISUMU WEST,Rural,77,138,150,288,Kisumu,NYANZA,18855
KISUMU WEST,Rural,78,71,180,251,Kisumu,NYANZA,18856
KISUMU WEST,Rural,79,84,159,243,Kisumu,NYANZA,18857
KISUMU WEST,Rural,80+,622,1001,1623,Kisumu,NYANZA,18858
KISUMU WEST,Rural,Age NS,18,19,37,Kisumu,NYANZA,18859
NYANDO,Rural,0,4355,4224,8579,Kisumu,NYANZA,18860
NYANDO,Rural,1,3917,3736,7653,Kisumu,NYANZA,18861
NYANDO,Rural,2,4486,4474,8960,Kisumu,NYANZA,18862
NYANDO,Rural,3,4358,4316,8674,Kisumu,NYANZA,18863
NYANDO,Rural,4,4113,3989,8102,Kisumu,NYANZA,18864
NYANDO,Rural,5,4086,3956,8042,Kisumu,NYANZA,18865
NYANDO,Rural,6,3672,3703,7375,Kisumu,NYANZA,18866
NYANDO,Rural,7,3545,3555,7100,Kisumu,NYANZA,18867
NYANDO,Rural,8,3468,3534,7002,Kisumu,NYANZA,18868
NYANDO,Rural,9,3632,3643,7275,Kisumu,NYANZA,18869
NYANDO,Rural,10,3973,3873,7846,Kisumu,NYANZA,18870
NYANDO,Rural,11,2893,2961,5854,Kisumu,NYANZA,18871
NYANDO,Rural,12,3815,3578,7393,Kisumu,NYANZA,18872
NYANDO,Rural,13,3434,3331,6765,Kisumu,NYANZA,18873
NYANDO,Rural,14,3141,3093,6234,Kisumu,NYANZA,18874
NYANDO,Rural,15,3319,3034,6353,Kisumu,NYANZA,18875
NYANDO,Rural,16,3005,2775,5780,Kisumu,NYANZA,18876
NYANDO,Rural,17,3291,2823,6114,Kisumu,NYANZA,18877
NYANDO,Rural,18,2917,2509,5426,Kisumu,NYANZA,18878
NYANDO,Rural,19,2071,2068,4139,Kisumu,NYANZA,18879
NYANDO,Rural,20,2580,3189,5769,Kisumu,NYANZA,18880
NYANDO,Rural,21,1594,2025,3619,Kisumu,NYANZA,18881
NYANDO,Rural,22,1852,2228,4080,Kisumu,NYANZA,18882
NYANDO,Rural,23,1712,2115,3827,Kisumu,NYANZA,18883
NYANDO,Rural,24,1658,2003,3661,Kisumu,NYANZA,18884
NYANDO,Rural,25,1933,2408,4341,Kisumu,NYANZA,18885
NYANDO,Rural,26,1445,1604,3049,Kisumu,NYANZA,18886
NYANDO,Rural,27,1479,1668,3147,Kisumu,NYANZA,18887
NYANDO,Rural,28,1080,1406,2486,Kisumu,NYANZA,18888
NYANDO,Rural,29,1171,1225,2396,Kisumu,NYANZA,18889
NYANDO,Rural,30,1757,2203,3960,Kisumu,NYANZA,18890
NYANDO,Rural,31,989,941,1930,Kisumu,NYANZA,18891
NYANDO,Rural,32,1175,1226,2401,Kisumu,NYANZA,18892
NYANDO,Rural,33,865,877,1742,Kisumu,NYANZA,18893
NYANDO,Rural,34,915,930,1845,Kisumu,NYANZA,18894
NYANDO,Rural,35,1328,1606,2934,Kisumu,NYANZA,18895
NYANDO,Rural,36,789,864,1653,Kisumu,NYANZA,18896
NYANDO,Rural,37,759,868,1627,Kisumu,NYANZA,18897
NYANDO,Rural,38,553,869,1422,Kisumu,NYANZA,18898
NYANDO,Rural,39,604,714,1318,Kisumu,NYANZA,18899
NYANDO,Rural,40,986,1831,2817,Kisumu,NYANZA,18900
NYANDO,Rural,41,548,717,1265,Kisumu,NYANZA,18901
NYANDO,Rural,42,526,755,1281,Kisumu,NYANZA,18902
NYANDO,Rural,43,440,603,1043,Kisumu,NYANZA,18903
NYANDO,Rural,44,402,547,949,Kisumu,NYANZA,18904
NYANDO,Rural,45,776,1210,1986,Kisumu,NYANZA,18905
NYANDO,Rural,46,521,770,1291,Kisumu,NYANZA,18906
NYANDO,Rural,47,539,889,1428,Kisumu,NYANZA,18907
NYANDO,Rural,48,481,694,1175,Kisumu,NYANZA,18908
NYANDO,Rural,49,512,695,1207,Kisumu,NYANZA,18909
NYANDO,Rural,50,779,1433,2212,Kisumu,NYANZA,18910
NYANDO,Rural,51,550,646,1196,Kisumu,NYANZA,18911
NYANDO,Rural,52,538,609,1147,Kisumu,NYANZA,18912
NYANDO,Rural,53,471,523,994,Kisumu,NYANZA,18913
NYANDO,Rural,54,439,605,1044,Kisumu,NYANZA,18914
NYANDO,Rural,55,618,806,1424,Kisumu,NYANZA,18915
NYANDO,Rural,56,501,627,1128,Kisumu,NYANZA,18916
NYANDO,Rural,57,563,759,1322,Kisumu,NYANZA,18917
NYANDO,Rural,58,304,371,675,Kisumu,NYANZA,18918
NYANDO,Rural,59,422,413,835,Kisumu,NYANZA,18919
NYANDO,Rural,60,766,1027,1793,Kisumu,NYANZA,18920
NYANDO,Rural,61,410,380,790,Kisumu,NYANZA,18921
NYANDO,Rural,62,366,361,727,Kisumu,NYANZA,18922
NYANDO,Rural,63,324,331,655,Kisumu,NYANZA,18923
NYANDO,Rural,64,298,398,696,Kisumu,NYANZA,18924
NYANDO,Rural,65,386,505,891,Kisumu,NYANZA,18925
NYANDO,Rural,66,239,320,559,Kisumu,NYANZA,18926
NYANDO,Rural,67,332,371,703,Kisumu,NYANZA,18927
NYANDO,Rural,68,151,235,386,Kisumu,NYANZA,18928
NYANDO,Rural,69,234,377,611,Kisumu,NYANZA,18929
NYANDO,Rural,70,433,726,1159,Kisumu,NYANZA,18930
NYANDO,Rural,71,198,243,441,Kisumu,NYANZA,18931
NYANDO,Rural,72,238,246,484,Kisumu,NYANZA,18932
NYANDO,Rural,73,212,188,400,Kisumu,NYANZA,18933
NYANDO,Rural,74,198,243,441,Kisumu,NYANZA,18934
NYANDO,Rural,75,242,319,561,Kisumu,NYANZA,18935
NYANDO,Rural,76,155,128,283,Kisumu,NYANZA,18936
NYANDO,Rural,77,165,161,326,Kisumu,NYANZA,18937
NYANDO,Rural,78,138,250,388,Kisumu,NYANZA,18938
NYANDO,Rural,79,132,245,377,Kisumu,NYANZA,18939
NYANDO,Rural,80+,990,1658,2648,Kisumu,NYANZA,18940
NYANDO,Rural,Age NS,62,56,118,Kisumu,NYANZA,18941
HOMABAY,Rural,0,6199,6162,12361,Homa Bay,NYANZA,18942
HOMABAY,Rural,1,5397,5183,10580,Homa Bay,NYANZA,18943
HOMABAY,Rural,2,6141,6208,12349,Homa Bay,NYANZA,18944
HOMABAY,Rural,3,5844,5815,11659,Homa Bay,NYANZA,18945
HOMABAY,Rural,4,5623,5673,11296,Homa Bay,NYANZA,18946
HOMABAY,Rural,5,5579,5645,11224,Homa Bay,NYANZA,18947
HOMABAY,Rural,6,5259,5218,10477,Homa Bay,NYANZA,18948
HOMABAY,Rural,7,4721,4587,9308,Homa Bay,NYANZA,18949
HOMABAY,Rural,8,4781,4944,9725,Homa Bay,NYANZA,18950
HOMABAY,Rural,9,4658,4637,9295,Homa Bay,NYANZA,18951
HOMABAY,Rural,10,5509,5275,10784,Homa Bay,NYANZA,18952
HOMABAY,Rural,11,3651,3726,7377,Homa Bay,NYANZA,18953
HOMABAY,Rural,12,5047,4616,9663,Homa Bay,NYANZA,18954
HOMABAY,Rural,13,4271,4185,8456,Homa Bay,NYANZA,18955
HOMABAY,Rural,14,3977,3692,7669,Homa Bay,NYANZA,18956
HOMABAY,Rural,15,4271,3708,7979,Homa Bay,NYANZA,18957
HOMABAY,Rural,16,3736,3415,7151,Homa Bay,NYANZA,18958
HOMABAY,Rural,17,3817,3408,7225,Homa Bay,NYANZA,18959
HOMABAY,Rural,18,3673,3463,7136,Homa Bay,NYANZA,18960
HOMABAY,Rural,19,2548,2688,5236,Homa Bay,NYANZA,18961
HOMABAY,Rural,20,3216,4446,7662,Homa Bay,NYANZA,18962
HOMABAY,Rural,21,2058,2605,4663,Homa Bay,NYANZA,18963
HOMABAY,Rural,22,2169,2909,5078,Homa Bay,NYANZA,18964
HOMABAY,Rural,23,2195,2914,5109,Homa Bay,NYANZA,18965
HOMABAY,Rural,24,1986,2588,4574,Homa Bay,NYANZA,18966
HOMABAY,Rural,25,2303,3398,5701,Homa Bay,NYANZA,18967
HOMABAY,Rural,26,1656,2137,3793,Homa Bay,NYANZA,18968
HOMABAY,Rural,27,1846,2172,4018,Homa Bay,NYANZA,18969
HOMABAY,Rural,28,1346,1946,3292,Homa Bay,NYANZA,18970
HOMABAY,Rural,29,1410,1664,3074,Homa Bay,NYANZA,18971
HOMABAY,Rural,30,2108,3099,5207,Homa Bay,NYANZA,18972
HOMABAY,Rural,31,1225,1219,2444,Homa Bay,NYANZA,18973
HOMABAY,Rural,32,1331,1710,3041,Homa Bay,NYANZA,18974
HOMABAY,Rural,33,1001,1092,2093,Homa Bay,NYANZA,18975
HOMABAY,Rural,34,1077,1328,2405,Homa Bay,NYANZA,18976
HOMABAY,Rural,35,1502,2090,3592,Homa Bay,NYANZA,18977
HOMABAY,Rural,36,893,1141,2034,Homa Bay,NYANZA,18978
HOMABAY,Rural,37,894,1122,2016,Homa Bay,NYANZA,18979
HOMABAY,Rural,38,653,1063,1716,Homa Bay,NYANZA,18980
HOMABAY,Rural,39,651,877,1528,Homa Bay,NYANZA,18981
HOMABAY,Rural,40,1210,2214,3424,Homa Bay,NYANZA,18982
HOMABAY,Rural,41,613,841,1454,Homa Bay,NYANZA,18983
HOMABAY,Rural,42,643,950,1593,Homa Bay,NYANZA,18984
HOMABAY,Rural,43,542,707,1249,Homa Bay,NYANZA,18985
HOMABAY,Rural,44,512,642,1154,Homa Bay,NYANZA,18986
HOMABAY,Rural,45,983,1443,2426,Homa Bay,NYANZA,18987
HOMABAY,Rural,46,716,958,1674,Homa Bay,NYANZA,18988
HOMABAY,Rural,47,707,1025,1732,Homa Bay,NYANZA,18989
HOMABAY,Rural,48,472,709,1181,Homa Bay,NYANZA,18990
HOMABAY,Rural,49,553,727,1280,Homa Bay,NYANZA,18991
HOMABAY,Rural,50,915,1583,2498,Homa Bay,NYANZA,18992
HOMABAY,Rural,51,576,719,1295,Homa Bay,NYANZA,18993
HOMABAY,Rural,52,559,694,1253,Homa Bay,NYANZA,18994
HOMABAY,Rural,53,489,627,1116,Homa Bay,NYANZA,18995
HOMABAY,Rural,54,469,697,1166,Homa Bay,NYANZA,18996
HOMABAY,Rural,55,670,877,1547,Homa Bay,NYANZA,18997
HOMABAY,Rural,56,532,671,1203,Homa Bay,NYANZA,18998
HOMABAY,Rural,57,621,834,1455,Homa Bay,NYANZA,18999
HOMABAY,Rural,58,344,418,762,Homa Bay,NYANZA,19000
HOMABAY,Rural,59,419,551,970,Homa Bay,NYANZA,19001
HOMABAY,Rural,60,759,1206,1965,Homa Bay,NYANZA,19002
HOMABAY,Rural,61,428,449,877,Homa Bay,NYANZA,19003
HOMABAY,Rural,62,405,384,789,Homa Bay,NYANZA,19004
HOMABAY,Rural,63,331,363,694,Homa Bay,NYANZA,19005
HOMABAY,Rural,64,332,468,800,Homa Bay,NYANZA,19006
HOMABAY,Rural,65,382,522,904,Homa Bay,NYANZA,19007
HOMABAY,Rural,66,207,292,499,Homa Bay,NYANZA,19008
HOMABAY,Rural,67,383,458,841,Homa Bay,NYANZA,19009
HOMABAY,Rural,68,159,255,414,Homa Bay,NYANZA,19010
HOMABAY,Rural,69,226,466,692,Homa Bay,NYANZA,19011
HOMABAY,Rural,70,421,757,1178,Homa Bay,NYANZA,19012
HOMABAY,Rural,71,188,228,416,Homa Bay,NYANZA,19013
HOMABAY,Rural,72,255,275,530,Homa Bay,NYANZA,19014
HOMABAY,Rural,73,216,215,431,Homa Bay,NYANZA,19015
HOMABAY,Rural,74,197,231,428,Homa Bay,NYANZA,19016
HOMABAY,Rural,75,223,337,560,Homa Bay,NYANZA,19017
HOMABAY,Rural,76,178,172,350,Homa Bay,NYANZA,19018
HOMABAY,Rural,77,216,189,405,Homa Bay,NYANZA,19019
HOMABAY,Rural,78,164,314,478,Homa Bay,NYANZA,19020
HOMABAY,Rural,79,144,263,407,Homa Bay,NYANZA,19021
HOMABAY,Rural,80+,1344,1795,3139,Homa Bay,NYANZA,19022
HOMABAY,Rural,Age NS,56,52,108,Homa Bay,NYANZA,19023
SUBA,Rural,0,3881,3843,7724,Homa Bay,NYANZA,19024
SUBA,Rural,1,3415,3309,6724,Homa Bay,NYANZA,19025
SUBA,Rural,2,3996,4006,8002,Homa Bay,NYANZA,19026
SUBA,Rural,3,3728,3721,7449,Homa Bay,NYANZA,19027
SUBA,Rural,4,3611,3557,7168,Homa Bay,NYANZA,19028
SUBA,Rural,5,3446,3380,6826,Homa Bay,NYANZA,19029
SUBA,Rural,6,3236,3254,6490,Homa Bay,NYANZA,19030
SUBA,Rural,7,2821,2861,5682,Homa Bay,NYANZA,19031
SUBA,Rural,8,3028,2978,6006,Homa Bay,NYANZA,19032
SUBA,Rural,9,2830,2837,5667,Homa Bay,NYANZA,19033
SUBA,Rural,10,3299,3127,6426,Homa Bay,NYANZA,19034
SUBA,Rural,11,2282,2274,4556,Homa Bay,NYANZA,19035
SUBA,Rural,12,2820,2620,5440,Homa Bay,NYANZA,19036
SUBA,Rural,13,2491,2417,4908,Homa Bay,NYANZA,19037
SUBA,Rural,14,2422,2294,4716,Homa Bay,NYANZA,19038
SUBA,Rural,15,2515,2297,4812,Homa Bay,NYANZA,19039
SUBA,Rural,16,2358,2203,4561,Homa Bay,NYANZA,19040
SUBA,Rural,17,2289,2191,4480,Homa Bay,NYANZA,19041
SUBA,Rural,18,2370,2144,4514,Homa Bay,NYANZA,19042
SUBA,Rural,19,1788,1812,3600,Homa Bay,NYANZA,19043
SUBA,Rural,20,2350,2987,5337,Homa Bay,NYANZA,19044
SUBA,Rural,21,1645,1809,3454,Homa Bay,NYANZA,19045
SUBA,Rural,22,1794,2005,3799,Homa Bay,NYANZA,19046
SUBA,Rural,23,1796,1987,3783,Homa Bay,NYANZA,19047
SUBA,Rural,24,1767,1835,3602,Homa Bay,NYANZA,19048
SUBA,Rural,25,1976,2194,4170,Homa Bay,NYANZA,19049
SUBA,Rural,26,1544,1463,3007,Homa Bay,NYANZA,19050
SUBA,Rural,27,1463,1366,2829,Homa Bay,NYANZA,19051
SUBA,Rural,28,1258,1272,2530,Homa Bay,NYANZA,19052
SUBA,Rural,29,1167,1088,2255,Homa Bay,NYANZA,19053
SUBA,Rural,30,1789,1858,3647,Homa Bay,NYANZA,19054
SUBA,Rural,31,879,790,1669,Homa Bay,NYANZA,19055
SUBA,Rural,32,1118,1061,2179,Homa Bay,NYANZA,19056
SUBA,Rural,33,788,690,1478,Homa Bay,NYANZA,19057
SUBA,Rural,34,873,822,1695,Homa Bay,NYANZA,19058
SUBA,Rural,35,1137,1254,2391,Homa Bay,NYANZA,19059
SUBA,Rural,36,677,717,1394,Homa Bay,NYANZA,19060
SUBA,Rural,37,706,692,1398,Homa Bay,NYANZA,19061
SUBA,Rural,38,573,664,1237,Homa Bay,NYANZA,19062
SUBA,Rural,39,514,552,1066,Homa Bay,NYANZA,19063
SUBA,Rural,40,922,1186,2108,Homa Bay,NYANZA,19064
SUBA,Rural,41,415,466,881,Homa Bay,NYANZA,19065
SUBA,Rural,42,465,540,1005,Homa Bay,NYANZA,19066
SUBA,Rural,43,395,435,830,Homa Bay,NYANZA,19067
SUBA,Rural,44,319,422,741,Homa Bay,NYANZA,19068
SUBA,Rural,45,601,872,1473,Homa Bay,NYANZA,19069
SUBA,Rural,46,473,589,1062,Homa Bay,NYANZA,19070
SUBA,Rural,47,420,533,953,Homa Bay,NYANZA,19071
SUBA,Rural,48,336,466,802,Homa Bay,NYANZA,19072
SUBA,Rural,49,330,374,704,Homa Bay,NYANZA,19073
SUBA,Rural,50,498,800,1298,Homa Bay,NYANZA,19074
SUBA,Rural,51,334,413,747,Homa Bay,NYANZA,19075
SUBA,Rural,52,326,404,730,Homa Bay,NYANZA,19076
SUBA,Rural,53,300,365,665,Homa Bay,NYANZA,19077
SUBA,Rural,54,331,403,734,Homa Bay,NYANZA,19078
SUBA,Rural,55,362,460,822,Homa Bay,NYANZA,19079
SUBA,Rural,56,305,394,699,Homa Bay,NYANZA,19080
SUBA,Rural,57,317,458,775,Homa Bay,NYANZA,19081
SUBA,Rural,58,192,250,442,Homa Bay,NYANZA,19082
SUBA,Rural,59,240,345,585,Homa Bay,NYANZA,19083
SUBA,Rural,60,448,626,1074,Homa Bay,NYANZA,19084
SUBA,Rural,61,220,279,499,Homa Bay,NYANZA,19085
SUBA,Rural,62,194,248,442,Homa Bay,NYANZA,19086
SUBA,Rural,63,207,210,417,Homa Bay,NYANZA,19087
SUBA,Rural,64,199,250,449,Homa Bay,NYANZA,19088
SUBA,Rural,65,203,339,542,Homa Bay,NYANZA,19089
SUBA,Rural,66,134,178,312,Homa Bay,NYANZA,19090
SUBA,Rural,67,208,225,433,Homa Bay,NYANZA,19091
SUBA,Rural,68,115,155,270,Homa Bay,NYANZA,19092
SUBA,Rural,69,131,248,379,Homa Bay,NYANZA,19093
SUBA,Rural,70,229,400,629,Homa Bay,NYANZA,19094
SUBA,Rural,71,143,133,276,Homa Bay,NYANZA,19095
SUBA,Rural,72,125,162,287,Homa Bay,NYANZA,19096
SUBA,Rural,73,140,121,261,Homa Bay,NYANZA,19097
SUBA,Rural,74,110,134,244,Homa Bay,NYANZA,19098
SUBA,Rural,75,127,164,291,Homa Bay,NYANZA,19099
SUBA,Rural,76,90,125,215,Homa Bay,NYANZA,19100
SUBA,Rural,77,100,106,206,Homa Bay,NYANZA,19101
SUBA,Rural,78,94,160,254,Homa Bay,NYANZA,19102
SUBA,Rural,79,94,155,249,Homa Bay,NYANZA,19103
SUBA,Rural,80+,631,918,1549,Homa Bay,NYANZA,19104
SUBA,Rural,Age NS,65,43,108,Homa Bay,NYANZA,19105
RACHUONYO,Rural,0,5711,5756,11467,Homa Bay,NYANZA,19106
RACHUONYO,Rural,1,5261,5067,10328,Homa Bay,NYANZA,19107
RACHUONYO,Rural,2,6128,6038,12166,Homa Bay,NYANZA,19108
RACHUONYO,Rural,3,5777,5792,11569,Homa Bay,NYANZA,19109
RACHUONYO,Rural,4,5588,5518,11106,Homa Bay,NYANZA,19110
RACHUONYO,Rural,5,5778,5434,11212,Homa Bay,NYANZA,19111
RACHUONYO,Rural,6,5320,5247,10567,Homa Bay,NYANZA,19112
RACHUONYO,Rural,7,4692,4803,9495,Homa Bay,NYANZA,19113
RACHUONYO,Rural,8,4946,4982,9928,Homa Bay,NYANZA,19114
RACHUONYO,Rural,9,4832,4876,9708,Homa Bay,NYANZA,19115
RACHUONYO,Rural,10,5644,5515,11159,Homa Bay,NYANZA,19116
RACHUONYO,Rural,11,3817,3990,7807,Homa Bay,NYANZA,19117
RACHUONYO,Rural,12,5121,4806,9927,Homa Bay,NYANZA,19118
RACHUONYO,Rural,13,4669,4530,9199,Homa Bay,NYANZA,19119
RACHUONYO,Rural,14,4483,4216,8699,Homa Bay,NYANZA,19120
RACHUONYO,Rural,15,4751,4199,8950,Homa Bay,NYANZA,19121
RACHUONYO,Rural,16,4179,3909,8088,Homa Bay,NYANZA,19122
RACHUONYO,Rural,17,4433,3712,8145,Homa Bay,NYANZA,19123
RACHUONYO,Rural,18,4160,3641,7801,Homa Bay,NYANZA,19124
RACHUONYO,Rural,19,2785,2771,5556,Homa Bay,NYANZA,19125
RACHUONYO,Rural,20,3723,4441,8164,Homa Bay,NYANZA,19126
RACHUONYO,Rural,21,2239,2612,4851,Homa Bay,NYANZA,19127
RACHUONYO,Rural,22,2331,2951,5282,Homa Bay,NYANZA,19128
RACHUONYO,Rural,23,2175,2850,5025,Homa Bay,NYANZA,19129
RACHUONYO,Rural,24,1992,2629,4621,Homa Bay,NYANZA,19130
RACHUONYO,Rural,25,2437,3279,5716,Homa Bay,NYANZA,19131
RACHUONYO,Rural,26,1748,2199,3947,Homa Bay,NYANZA,19132
RACHUONYO,Rural,27,1922,2159,4081,Homa Bay,NYANZA,19133
RACHUONYO,Rural,28,1371,2096,3467,Homa Bay,NYANZA,19134
RACHUONYO,Rural,29,1391,1569,2960,Homa Bay,NYANZA,19135
RACHUONYO,Rural,30,2299,3144,5443,Homa Bay,NYANZA,19136
RACHUONYO,Rural,31,1106,1216,2322,Homa Bay,NYANZA,19137
RACHUONYO,Rural,32,1411,1733,3144,Homa Bay,NYANZA,19138
RACHUONYO,Rural,33,1029,1145,2174,Homa Bay,NYANZA,19139
RACHUONYO,Rural,34,1078,1308,2386,Homa Bay,NYANZA,19140
RACHUONYO,Rural,35,1656,2235,3891,Homa Bay,NYANZA,19141
RACHUONYO,Rural,36,975,1222,2197,Homa Bay,NYANZA,19142
RACHUONYO,Rural,37,923,1283,2206,Homa Bay,NYANZA,19143
RACHUONYO,Rural,38,761,1179,1940,Homa Bay,NYANZA,19144
RACHUONYO,Rural,39,716,948,1664,Homa Bay,NYANZA,19145
RACHUONYO,Rural,40,1406,2374,3780,Homa Bay,NYANZA,19146
RACHUONYO,Rural,41,644,811,1455,Homa Bay,NYANZA,19147
RACHUONYO,Rural,42,734,1030,1764,Homa Bay,NYANZA,19148
RACHUONYO,Rural,43,566,794,1360,Homa Bay,NYANZA,19149
RACHUONYO,Rural,44,527,785,1312,Homa Bay,NYANZA,19150
RACHUONYO,Rural,45,1087,1720,2807,Homa Bay,NYANZA,19151
RACHUONYO,Rural,46,800,1064,1864,Homa Bay,NYANZA,19152
RACHUONYO,Rural,47,772,1090,1862,Homa Bay,NYANZA,19153
RACHUONYO,Rural,48,554,884,1438,Homa Bay,NYANZA,19154
RACHUONYO,Rural,49,606,837,1443,Homa Bay,NYANZA,19155
RACHUONYO,Rural,50,1117,1751,2868,Homa Bay,NYANZA,19156
RACHUONYO,Rural,51,670,800,1470,Homa Bay,NYANZA,19157
RACHUONYO,Rural,52,638,759,1397,Homa Bay,NYANZA,19158
RACHUONYO,Rural,53,555,708,1263,Homa Bay,NYANZA,19159
RACHUONYO,Rural,54,584,692,1276,Homa Bay,NYANZA,19160
RACHUONYO,Rural,55,786,939,1725,Homa Bay,NYANZA,19161
RACHUONYO,Rural,56,658,753,1411,Homa Bay,NYANZA,19162
RACHUONYO,Rural,57,801,864,1665,Homa Bay,NYANZA,19163
RACHUONYO,Rural,58,418,466,884,Homa Bay,NYANZA,19164
RACHUONYO,Rural,59,496,563,1059,Homa Bay,NYANZA,19165
RACHUONYO,Rural,60,878,1302,2180,Homa Bay,NYANZA,19166
RACHUONYO,Rural,61,570,566,1136,Homa Bay,NYANZA,19167
RACHUONYO,Rural,62,421,489,910,Homa Bay,NYANZA,19168
RACHUONYO,Rural,63,350,417,767,Homa Bay,NYANZA,19169
RACHUONYO,Rural,64,403,477,880,Homa Bay,NYANZA,19170
RACHUONYO,Rural,65,531,635,1166,Homa Bay,NYANZA,19171
RACHUONYO,Rural,66,224,284,508,Homa Bay,NYANZA,19172
RACHUONYO,Rural,67,489,519,1008,Homa Bay,NYANZA,19173
RACHUONYO,Rural,68,256,324,580,Homa Bay,NYANZA,19174
RACHUONYO,Rural,69,244,490,734,Homa Bay,NYANZA,19175
RACHUONYO,Rural,70,565,943,1508,Homa Bay,NYANZA,19176
RACHUONYO,Rural,71,256,332,588,Homa Bay,NYANZA,19177
RACHUONYO,Rural,72,291,335,626,Homa Bay,NYANZA,19178
RACHUONYO,Rural,73,251,249,500,Homa Bay,NYANZA,19179
RACHUONYO,Rural,74,232,284,516,Homa Bay,NYANZA,19180
RACHUONYO,Rural,75,309,411,720,Homa Bay,NYANZA,19181
RACHUONYO,Rural,76,218,225,443,Homa Bay,NYANZA,19182
RACHUONYO,Rural,77,242,242,484,Homa Bay,NYANZA,19183
RACHUONYO,Rural,78,178,334,512,Homa Bay,NYANZA,19184
RACHUONYO,Rural,79,187,315,502,Homa Bay,NYANZA,19185
RACHUONYO,Rural,80+,1413,2072,3485,Homa Bay,NYANZA,19186
RACHUONYO,Rural,Age NS,40,49,89,Homa Bay,NYANZA,19187
MIGORI,Rural,0,5747,5735,11482,Migori,NYANZA,19188
MIGORI,Rural,1,4822,4682,9504,Migori,NYANZA,19189
MIGORI,Rural,2,5511,5427,10938,Migori,NYANZA,19190
MIGORI,Rural,3,5089,5040,10129,Migori,NYANZA,19191
MIGORI,Rural,4,4874,4750,9624,Migori,NYANZA,19192
MIGORI,Rural,5,4593,4602,9195,Migori,NYANZA,19193
MIGORI,Rural,6,4282,4427,8709,Migori,NYANZA,19194
MIGORI,Rural,7,3783,3825,7608,Migori,NYANZA,19195
MIGORI,Rural,8,3939,4038,7977,Migori,NYANZA,19196
MIGORI,Rural,9,3698,3697,7395,Migori,NYANZA,19197
MIGORI,Rural,10,4058,4089,8147,Migori,NYANZA,19198
MIGORI,Rural,11,3210,3242,6452,Migori,NYANZA,19199
MIGORI,Rural,12,3577,3313,6890,Migori,NYANZA,19200
MIGORI,Rural,13,3242,3084,6326,Migori,NYANZA,19201
MIGORI,Rural,14,3145,2932,6077,Migori,NYANZA,19202
MIGORI,Rural,15,3169,2970,6139,Migori,NYANZA,19203
MIGORI,Rural,16,2918,2866,5784,Migori,NYANZA,19204
MIGORI,Rural,17,2992,2794,5786,Migori,NYANZA,19205
MIGORI,Rural,18,2647,2585,5232,Migori,NYANZA,19206
MIGORI,Rural,19,2200,2255,4455,Migori,NYANZA,19207
MIGORI,Rural,20,2517,3318,5835,Migori,NYANZA,19208
MIGORI,Rural,21,1962,2256,4218,Migori,NYANZA,19209
MIGORI,Rural,22,1956,2403,4359,Migori,NYANZA,19210
MIGORI,Rural,23,1893,2579,4472,Migori,NYANZA,19211
MIGORI,Rural,24,1846,2263,4109,Migori,NYANZA,19212
MIGORI,Rural,25,1965,2603,4568,Migori,NYANZA,19213
MIGORI,Rural,26,1620,1989,3609,Migori,NYANZA,19214
MIGORI,Rural,27,1564,1797,3361,Migori,NYANZA,19215
MIGORI,Rural,28,1224,1544,2768,Migori,NYANZA,19216
MIGORI,Rural,29,1299,1357,2656,Migori,NYANZA,19217
MIGORI,Rural,30,1619,2103,3722,Migori,NYANZA,19218
MIGORI,Rural,31,1135,1290,2425,Migori,NYANZA,19219
MIGORI,Rural,32,1174,1391,2565,Migori,NYANZA,19220
MIGORI,Rural,33,1015,1140,2155,Migori,NYANZA,19221
MIGORI,Rural,34,985,1210,2195,Migori,NYANZA,19222
MIGORI,Rural,35,1270,1548,2818,Migori,NYANZA,19223
MIGORI,Rural,36,973,1186,2159,Migori,NYANZA,19224
MIGORI,Rural,37,809,984,1793,Migori,NYANZA,19225
MIGORI,Rural,38,627,835,1462,Migori,NYANZA,19226
MIGORI,Rural,39,638,845,1483,Migori,NYANZA,19227
MIGORI,Rural,40,1012,1446,2458,Migori,NYANZA,19228
MIGORI,Rural,41,669,797,1466,Migori,NYANZA,19229
MIGORI,Rural,42,534,739,1273,Migori,NYANZA,19230
MIGORI,Rural,43,497,629,1126,Migori,NYANZA,19231
MIGORI,Rural,44,513,706,1219,Migori,NYANZA,19232
MIGORI,Rural,45,805,1045,1850,Migori,NYANZA,19233
MIGORI,Rural,46,565,846,1411,Migori,NYANZA,19234
MIGORI,Rural,47,557,796,1353,Migori,NYANZA,19235
MIGORI,Rural,48,383,549,932,Migori,NYANZA,19236
MIGORI,Rural,49,468,642,1110,Migori,NYANZA,19237
MIGORI,Rural,50,737,1006,1743,Migori,NYANZA,19238
MIGORI,Rural,51,482,658,1140,Migori,NYANZA,19239
MIGORI,Rural,52,485,557,1042,Migori,NYANZA,19240
MIGORI,Rural,53,408,520,928,Migori,NYANZA,19241
MIGORI,Rural,54,422,573,995,Migori,NYANZA,19242
MIGORI,Rural,55,449,578,1027,Migori,NYANZA,19243
MIGORI,Rural,56,443,646,1089,Migori,NYANZA,19244
MIGORI,Rural,57,427,613,1040,Migori,NYANZA,19245
MIGORI,Rural,58,250,359,609,Migori,NYANZA,19246
MIGORI,Rural,59,306,448,754,Migori,NYANZA,19247
MIGORI,Rural,60,496,695,1191,Migori,NYANZA,19248
MIGORI,Rural,61,332,388,720,Migori,NYANZA,19249
MIGORI,Rural,62,290,310,600,Migori,NYANZA,19250
MIGORI,Rural,63,258,302,560,Migori,NYANZA,19251
MIGORI,Rural,64,239,372,611,Migori,NYANZA,19252
MIGORI,Rural,65,238,361,599,Migori,NYANZA,19253
MIGORI,Rural,66,219,313,532,Migori,NYANZA,19254
MIGORI,Rural,67,274,314,588,Migori,NYANZA,19255
MIGORI,Rural,68,143,261,404,Migori,NYANZA,19256
MIGORI,Rural,69,196,351,547,Migori,NYANZA,19257
MIGORI,Rural,70,298,389,687,Migori,NYANZA,19258
MIGORI,Rural,71,168,159,327,Migori,NYANZA,19259
MIGORI,Rural,72,212,182,394,Migori,NYANZA,19260
MIGORI,Rural,73,169,211,380,Migori,NYANZA,19261
MIGORI,Rural,74,147,206,353,Migori,NYANZA,19262
MIGORI,Rural,75,146,216,362,Migori,NYANZA,19263
MIGORI,Rural,76,147,175,322,Migori,NYANZA,19264
MIGORI,Rural,77,126,193,319,Migori,NYANZA,19265
MIGORI,Rural,78,113,275,388,Migori,NYANZA,19266
MIGORI,Rural,79,117,238,355,Migori,NYANZA,19267
MIGORI,Rural,80+,811,1126,1937,Migori,NYANZA,19268
MIGORI,Rural,Age NS,43,44,87,Migori,NYANZA,19269
RONGO,Rural,0,2854,2794,5648,Migori,NYANZA,19270
RONGO,Rural,1,2586,2537,5123,Migori,NYANZA,19271
RONGO,Rural,2,2849,2876,5725,Migori,NYANZA,19272
RONGO,Rural,3,2581,2598,5179,Migori,NYANZA,19273
RONGO,Rural,4,2482,2458,4940,Migori,NYANZA,19274
RONGO,Rural,5,2336,2418,4754,Migori,NYANZA,19275
RONGO,Rural,6,2268,2253,4521,Migori,NYANZA,19276
RONGO,Rural,7,1997,1914,3911,Migori,NYANZA,19277
RONGO,Rural,8,2200,2131,4331,Migori,NYANZA,19278
RONGO,Rural,9,1951,1991,3942,Migori,NYANZA,19279
RONGO,Rural,10,2215,2198,4413,Migori,NYANZA,19280
RONGO,Rural,11,1629,1658,3287,Migori,NYANZA,19281
RONGO,Rural,12,2019,1885,3904,Migori,NYANZA,19282
RONGO,Rural,13,1792,1638,3430,Migori,NYANZA,19283
RONGO,Rural,14,1753,1620,3373,Migori,NYANZA,19284
RONGO,Rural,15,1709,1635,3344,Migori,NYANZA,19285
RONGO,Rural,16,1709,1574,3283,Migori,NYANZA,19286
RONGO,Rural,17,1886,1441,3327,Migori,NYANZA,19287
RONGO,Rural,18,1598,1474,3072,Migori,NYANZA,19288
RONGO,Rural,19,1119,1249,2368,Migori,NYANZA,19289
RONGO,Rural,20,1335,1764,3099,Migori,NYANZA,19290
RONGO,Rural,21,960,1125,2085,Migori,NYANZA,19291
RONGO,Rural,22,1058,1298,2356,Migori,NYANZA,19292
RONGO,Rural,23,1027,1212,2239,Migori,NYANZA,19293
RONGO,Rural,24,961,1121,2082,Migori,NYANZA,19294
RONGO,Rural,25,1062,1340,2402,Migori,NYANZA,19295
RONGO,Rural,26,869,1028,1897,Migori,NYANZA,19296
RONGO,Rural,27,822,876,1698,Migori,NYANZA,19297
RONGO,Rural,28,670,783,1453,Migori,NYANZA,19298
RONGO,Rural,29,660,674,1334,Migori,NYANZA,19299
RONGO,Rural,30,968,1204,2172,Migori,NYANZA,19300
RONGO,Rural,31,586,593,1179,Migori,NYANZA,19301
RONGO,Rural,32,671,749,1420,Migori,NYANZA,19302
RONGO,Rural,33,496,521,1017,Migori,NYANZA,19303
RONGO,Rural,34,576,615,1191,Migori,NYANZA,19304
RONGO,Rural,35,665,810,1475,Migori,NYANZA,19305
RONGO,Rural,36,472,566,1038,Migori,NYANZA,19306
RONGO,Rural,37,425,453,878,Migori,NYANZA,19307
RONGO,Rural,38,382,471,853,Migori,NYANZA,19308
RONGO,Rural,39,308,433,741,Migori,NYANZA,19309
RONGO,Rural,40,526,777,1303,Migori,NYANZA,19310
RONGO,Rural,41,336,419,755,Migori,NYANZA,19311
RONGO,Rural,42,279,356,635,Migori,NYANZA,19312
RONGO,Rural,43,278,351,629,Migori,NYANZA,19313
RONGO,Rural,44,251,320,571,Migori,NYANZA,19314
RONGO,Rural,45,419,579,998,Migori,NYANZA,19315
RONGO,Rural,46,339,433,772,Migori,NYANZA,19316
RONGO,Rural,47,332,408,740,Migori,NYANZA,19317
RONGO,Rural,48,235,320,555,Migori,NYANZA,19318
RONGO,Rural,49,278,333,611,Migori,NYANZA,19319
RONGO,Rural,50,380,601,981,Migori,NYANZA,19320
RONGO,Rural,51,285,298,583,Migori,NYANZA,19321
RONGO,Rural,52,257,310,567,Migori,NYANZA,19322
RONGO,Rural,53,242,256,498,Migori,NYANZA,19323
RONGO,Rural,54,237,293,530,Migori,NYANZA,19324
RONGO,Rural,55,296,317,613,Migori,NYANZA,19325
RONGO,Rural,56,254,316,570,Migori,NYANZA,19326
RONGO,Rural,57,261,334,595,Migori,NYANZA,19327
RONGO,Rural,58,176,187,363,Migori,NYANZA,19328
RONGO,Rural,59,170,215,385,Migori,NYANZA,19329
RONGO,Rural,60,294,389,683,Migori,NYANZA,19330
RONGO,Rural,61,196,188,384,Migori,NYANZA,19331
RONGO,Rural,62,154,148,302,Migori,NYANZA,19332
RONGO,Rural,63,144,130,274,Migori,NYANZA,19333
RONGO,Rural,64,151,154,305,Migori,NYANZA,19334
RONGO,Rural,65,159,187,346,Migori,NYANZA,19335
RONGO,Rural,66,116,193,309,Migori,NYANZA,19336
RONGO,Rural,67,149,168,317,Migori,NYANZA,19337
RONGO,Rural,68,84,129,213,Migori,NYANZA,19338
RONGO,Rural,69,94,148,242,Migori,NYANZA,19339
RONGO,Rural,70,144,211,355,Migori,NYANZA,19340
RONGO,Rural,71,96,96,192,Migori,NYANZA,19341
RONGO,Rural,72,88,97,185,Migori,NYANZA,19342
RONGO,Rural,73,94,107,201,Migori,NYANZA,19343
RONGO,Rural,74,78,87,165,Migori,NYANZA,19344
RONGO,Rural,75,98,101,199,Migori,NYANZA,19345
RONGO,Rural,76,75,83,158,Migori,NYANZA,19346
RONGO,Rural,77,75,104,179,Migori,NYANZA,19347
RONGO,Rural,78,74,130,204,Migori,NYANZA,19348
RONGO,Rural,79,70,104,174,Migori,NYANZA,19349
RONGO,Rural,80+,427,531,958,Migori,NYANZA,19350
RONGO,Rural,Age NS,43,28,71,Migori,NYANZA,19351
KURIA WEST,Rural,0,2705,2811,5516,Migori,NYANZA,19352
KURIA WEST,Rural,1,2164,2171,4335,Migori,NYANZA,19353
KURIA WEST,Rural,2,2868,2971,5839,Migori,NYANZA,19354
KURIA WEST,Rural,3,2662,2516,5178,Migori,NYANZA,19355
KURIA WEST,Rural,4,2749,2712,5461,Migori,NYANZA,19356
KURIA WEST,Rural,5,2659,2461,5120,Migori,NYANZA,19357
KURIA WEST,Rural,6,2795,2759,5554,Migori,NYANZA,19358
KURIA WEST,Rural,7,2020,2050,4070,Migori,NYANZA,19359
KURIA WEST,Rural,8,2648,2670,5318,Migori,NYANZA,19360
KURIA WEST,Rural,9,2244,2134,4378,Migori,NYANZA,19361
KURIA WEST,Rural,10,2832,2790,5622,Migori,NYANZA,19362
KURIA WEST,Rural,11,1600,1670,3270,Migori,NYANZA,19363
KURIA WEST,Rural,12,2434,2268,4702,Migori,NYANZA,19364
KURIA WEST,Rural,13,1760,1662,3422,Migori,NYANZA,19365
KURIA WEST,Rural,14,1998,1785,3783,Migori,NYANZA,19366
KURIA WEST,Rural,15,1841,1575,3416,Migori,NYANZA,19367
KURIA WEST,Rural,16,1768,1793,3561,Migori,NYANZA,19368
KURIA WEST,Rural,17,1512,1364,2876,Migori,NYANZA,19369
KURIA WEST,Rural,18,1929,1885,3814,Migori,NYANZA,19370
KURIA WEST,Rural,19,1227,1280,2507,Migori,NYANZA,19371
KURIA WEST,Rural,20,1764,2225,3989,Migori,NYANZA,19372
KURIA WEST,Rural,21,915,939,1854,Migori,NYANZA,19373
KURIA WEST,Rural,22,1131,1210,2341,Migori,NYANZA,19374
KURIA WEST,Rural,23,893,1031,1924,Migori,NYANZA,19375
KURIA WEST,Rural,24,939,1069,2008,Migori,NYANZA,19376
KURIA WEST,Rural,25,1238,1483,2721,Migori,NYANZA,19377
KURIA WEST,Rural,26,777,858,1635,Migori,NYANZA,19378
KURIA WEST,Rural,27,698,783,1481,Migori,NYANZA,19379
KURIA WEST,Rural,28,798,1139,1937,Migori,NYANZA,19380
KURIA WEST,Rural,29,633,684,1317,Migori,NYANZA,19381
KURIA WEST,Rural,30,1171,1450,2621,Migori,NYANZA,19382
KURIA WEST,Rural,31,483,514,997,Migori,NYANZA,19383
KURIA WEST,Rural,32,589,752,1341,Migori,NYANZA,19384
KURIA WEST,Rural,33,427,455,882,Migori,NYANZA,19385
KURIA WEST,Rural,34,420,471,891,Migori,NYANZA,19386
KURIA WEST,Rural,35,878,987,1865,Migori,NYANZA,19387
KURIA WEST,Rural,36,469,504,973,Migori,NYANZA,19388
KURIA WEST,Rural,37,399,444,843,Migori,NYANZA,19389
KURIA WEST,Rural,38,387,541,928,Migori,NYANZA,19390
KURIA WEST,Rural,39,342,391,733,Migori,NYANZA,19391
KURIA WEST,Rural,40,714,913,1627,Migori,NYANZA,19392
KURIA WEST,Rural,41,326,335,661,Migori,NYANZA,19393
KURIA WEST,Rural,42,299,299,598,Migori,NYANZA,19394
KURIA WEST,Rural,43,180,241,421,Migori,NYANZA,19395
KURIA WEST,Rural,44,207,260,467,Migori,NYANZA,19396
KURIA WEST,Rural,45,460,533,993,Migori,NYANZA,19397
KURIA WEST,Rural,46,287,317,604,Migori,NYANZA,19398
KURIA WEST,Rural,47,253,280,533,Migori,NYANZA,19399
KURIA WEST,Rural,48,267,322,589,Migori,NYANZA,19400
KURIA WEST,Rural,49,215,244,459,Migori,NYANZA,19401
KURIA WEST,Rural,50,374,559,933,Migori,NYANZA,19402
KURIA WEST,Rural,51,161,146,307,Migori,NYANZA,19403
KURIA WEST,Rural,52,185,182,367,Migori,NYANZA,19404
KURIA WEST,Rural,53,104,156,260,Migori,NYANZA,19405
KURIA WEST,Rural,54,127,164,291,Migori,NYANZA,19406
KURIA WEST,Rural,55,232,266,498,Migori,NYANZA,19407
KURIA WEST,Rural,56,148,165,313,Migori,NYANZA,19408
KURIA WEST,Rural,57,134,146,280,Migori,NYANZA,19409
KURIA WEST,Rural,58,112,134,246,Migori,NYANZA,19410
KURIA WEST,Rural,59,121,137,258,Migori,NYANZA,19411
KURIA WEST,Rural,60,271,352,623,Migori,NYANZA,19412
KURIA WEST,Rural,61,94,69,163,Migori,NYANZA,19413
KURIA WEST,Rural,62,108,88,196,Migori,NYANZA,19414
KURIA WEST,Rural,63,70,53,123,Migori,NYANZA,19415
KURIA WEST,Rural,64,92,103,195,Migori,NYANZA,19416
KURIA WEST,Rural,65,148,169,317,Migori,NYANZA,19417
KURIA WEST,Rural,66,63,63,126,Migori,NYANZA,19418
KURIA WEST,Rural,67,97,68,165,Migori,NYANZA,19419
KURIA WEST,Rural,68,77,93,170,Migori,NYANZA,19420
KURIA WEST,Rural,69,66,78,144,Migori,NYANZA,19421
KURIA WEST,Rural,70,126,202,328,Migori,NYANZA,19422
KURIA WEST,Rural,71,51,62,113,Migori,NYANZA,19423
KURIA WEST,Rural,72,64,67,131,Migori,NYANZA,19424
KURIA WEST,Rural,73,48,47,95,Migori,NYANZA,19425
KURIA WEST,Rural,74,51,55,106,Migori,NYANZA,19426
KURIA WEST,Rural,75,60,111,171,Migori,NYANZA,19427
KURIA WEST,Rural,76,53,42,95,Migori,NYANZA,19428
KURIA WEST,Rural,77,41,39,80,Migori,NYANZA,19429
KURIA WEST,Rural,78,37,47,84,Migori,NYANZA,19430
KURIA WEST,Rural,79,49,60,109,Migori,NYANZA,19431
KURIA WEST,Rural,80+,369,498,867,Migori,NYANZA,19432
KURIA WEST,Rural,Age NS,59,74,133,Migori,NYANZA,19433
KURIA EAST,Rural,0,1692,1739,3431,Migori,NYANZA,19434
KURIA EAST,Rural,1,1296,1261,2557,Migori,NYANZA,19435
KURIA EAST,Rural,2,1698,1750,3448,Migori,NYANZA,19436
KURIA EAST,Rural,3,1574,1641,3215,Migori,NYANZA,19437
KURIA EAST,Rural,4,1630,1609,3239,Migori,NYANZA,19438
KURIA EAST,Rural,5,1552,1513,3065,Migori,NYANZA,19439
KURIA EAST,Rural,6,1597,1585,3182,Migori,NYANZA,19440
KURIA EAST,Rural,7,1296,1269,2565,Migori,NYANZA,19441
KURIA EAST,Rural,8,1582,1538,3120,Migori,NYANZA,19442
KURIA EAST,Rural,9,1349,1325,2674,Migori,NYANZA,19443
KURIA EAST,Rural,10,1611,1638,3249,Migori,NYANZA,19444
KURIA EAST,Rural,11,1002,1040,2042,Migori,NYANZA,19445
KURIA EAST,Rural,12,1401,1291,2692,Migori,NYANZA,19446
KURIA EAST,Rural,13,1084,1040,2124,Migori,NYANZA,19447
KURIA EAST,Rural,14,1219,1120,2339,Migori,NYANZA,19448
KURIA EAST,Rural,15,1043,1048,2091,Migori,NYANZA,19449
KURIA EAST,Rural,16,1105,946,2051,Migori,NYANZA,19450
KURIA EAST,Rural,17,883,785,1668,Migori,NYANZA,19451
KURIA EAST,Rural,18,1079,989,2068,Migori,NYANZA,19452
KURIA EAST,Rural,19,722,722,1444,Migori,NYANZA,19453
KURIA EAST,Rural,20,1068,1202,2270,Migori,NYANZA,19454
KURIA EAST,Rural,21,573,669,1242,Migori,NYANZA,19455
KURIA EAST,Rural,22,656,818,1474,Migori,NYANZA,19456
KURIA EAST,Rural,23,519,634,1153,Migori,NYANZA,19457
KURIA EAST,Rural,24,585,627,1212,Migori,NYANZA,19458
KURIA EAST,Rural,25,674,826,1500,Migori,NYANZA,19459
KURIA EAST,Rural,26,528,535,1063,Migori,NYANZA,19460
KURIA EAST,Rural,27,397,435,832,Migori,NYANZA,19461
KURIA EAST,Rural,28,563,637,1200,Migori,NYANZA,19462
KURIA EAST,Rural,29,341,382,723,Migori,NYANZA,19463
KURIA EAST,Rural,30,674,759,1433,Migori,NYANZA,19464
KURIA EAST,Rural,31,296,324,620,Migori,NYANZA,19465
KURIA EAST,Rural,32,343,432,775,Migori,NYANZA,19466
KURIA EAST,Rural,33,248,269,517,Migori,NYANZA,19467
KURIA EAST,Rural,34,273,324,597,Migori,NYANZA,19468
KURIA EAST,Rural,35,486,542,1028,Migori,NYANZA,19469
KURIA EAST,Rural,36,268,349,617,Migori,NYANZA,19470
KURIA EAST,Rural,37,252,271,523,Migori,NYANZA,19471
KURIA EAST,Rural,38,263,360,623,Migori,NYANZA,19472
KURIA EAST,Rural,39,206,231,437,Migori,NYANZA,19473
KURIA EAST,Rural,40,401,542,943,Migori,NYANZA,19474
KURIA EAST,Rural,41,195,195,390,Migori,NYANZA,19475
KURIA EAST,Rural,42,176,175,351,Migori,NYANZA,19476
KURIA EAST,Rural,43,147,153,300,Migori,NYANZA,19477
KURIA EAST,Rural,44,148,164,312,Migori,NYANZA,19478
KURIA EAST,Rural,45,285,340,625,Migori,NYANZA,19479
KURIA EAST,Rural,46,223,190,413,Migori,NYANZA,19480
KURIA EAST,Rural,47,137,146,283,Migori,NYANZA,19481
KURIA EAST,Rural,48,160,191,351,Migori,NYANZA,19482
KURIA EAST,Rural,49,158,161,319,Migori,NYANZA,19483
KURIA EAST,Rural,50,255,309,564,Migori,NYANZA,19484
KURIA EAST,Rural,51,124,145,269,Migori,NYANZA,19485
KURIA EAST,Rural,52,127,106,233,Migori,NYANZA,19486
KURIA EAST,Rural,53,112,97,209,Migori,NYANZA,19487
KURIA EAST,Rural,54,106,114,220,Migori,NYANZA,19488
KURIA EAST,Rural,55,152,142,294,Migori,NYANZA,19489
KURIA EAST,Rural,56,109,91,200,Migori,NYANZA,19490
KURIA EAST,Rural,57,92,76,168,Migori,NYANZA,19491
KURIA EAST,Rural,58,81,95,176,Migori,NYANZA,19492
KURIA EAST,Rural,59,85,69,154,Migori,NYANZA,19493
KURIA EAST,Rural,60,176,204,380,Migori,NYANZA,19494
KURIA EAST,Rural,61,67,64,131,Migori,NYANZA,19495
KURIA EAST,Rural,62,56,47,103,Migori,NYANZA,19496
KURIA EAST,Rural,63,48,47,95,Migori,NYANZA,19497
KURIA EAST,Rural,64,66,66,132,Migori,NYANZA,19498
KURIA EAST,Rural,65,80,120,200,Migori,NYANZA,19499
KURIA EAST,Rural,66,41,36,77,Migori,NYANZA,19500
KURIA EAST,Rural,67,52,52,104,Migori,NYANZA,19501
KURIA EAST,Rural,68,67,67,134,Migori,NYANZA,19502
KURIA EAST,Rural,69,60,70,130,Migori,NYANZA,19503
KURIA EAST,Rural,70,100,130,230,Migori,NYANZA,19504
KURIA EAST,Rural,71,33,56,89,Migori,NYANZA,19505
KURIA EAST,Rural,72,34,46,80,Migori,NYANZA,19506
KURIA EAST,Rural,73,33,24,57,Migori,NYANZA,19507
KURIA EAST,Rural,74,34,42,76,Migori,NYANZA,19508
KURIA EAST,Rural,75,51,64,115,Migori,NYANZA,19509
KURIA EAST,Rural,76,32,26,58,Migori,NYANZA,19510
KURIA EAST,Rural,77,19,31,50,Migori,NYANZA,19511
KURIA EAST,Rural,78,31,43,74,Migori,NYANZA,19512
KURIA EAST,Rural,79,31,35,66,Migori,NYANZA,19513
KURIA EAST,Rural,80+,220,317,537,Migori,NYANZA,19514
KURIA EAST,Rural,Age NS,16,22,38,Migori,NYANZA,19515
KISII CENTRAL,Rural,0,4770,4797,9567,Kisii,NYANZA,19516
KISII CENTRAL,Rural,1,4058,4025,8083,Kisii,NYANZA,19517
KISII CENTRAL,Rural,2,4923,4808,9731,Kisii,NYANZA,19518
KISII CENTRAL,Rural,3,4709,4881,9590,Kisii,NYANZA,19519
KISII CENTRAL,Rural,4,4774,4628,9402,Kisii,NYANZA,19520
KISII CENTRAL,Rural,5,4628,4398,9026,Kisii,NYANZA,19521
KISII CENTRAL,Rural,6,4367,4380,8747,Kisii,NYANZA,19522
KISII CENTRAL,Rural,7,4156,4098,8254,Kisii,NYANZA,19523
KISII CENTRAL,Rural,8,4103,4248,8351,Kisii,NYANZA,19524
KISII CENTRAL,Rural,9,4133,4096,8229,Kisii,NYANZA,19525
KISII CENTRAL,Rural,10,4541,4492,9033,Kisii,NYANZA,19526
KISII CENTRAL,Rural,11,2879,2938,5817,Kisii,NYANZA,19527
KISII CENTRAL,Rural,12,4243,4273,8516,Kisii,NYANZA,19528
KISII CENTRAL,Rural,13,3792,3578,7370,Kisii,NYANZA,19529
KISII CENTRAL,Rural,14,3717,3566,7283,Kisii,NYANZA,19530
KISII CENTRAL,Rural,15,3596,3534,7130,Kisii,NYANZA,19531
KISII CENTRAL,Rural,16,3529,3548,7077,Kisii,NYANZA,19532
KISII CENTRAL,Rural,17,3250,3061,6311,Kisii,NYANZA,19533
KISII CENTRAL,Rural,18,3746,3755,7501,Kisii,NYANZA,19534
KISII CENTRAL,Rural,19,2329,2561,4890,Kisii,NYANZA,19535
KISII CENTRAL,Rural,20,3148,4492,7640,Kisii,NYANZA,19536
KISII CENTRAL,Rural,21,1687,2298,3985,Kisii,NYANZA,19537
KISII CENTRAL,Rural,22,2184,3219,5403,Kisii,NYANZA,19538
KISII CENTRAL,Rural,23,1738,2563,4301,Kisii,NYANZA,19539
KISII CENTRAL,Rural,24,1728,2639,4367,Kisii,NYANZA,19540
KISII CENTRAL,Rural,25,2197,3510,5707,Kisii,NYANZA,19541
KISII CENTRAL,Rural,26,1492,2059,3551,Kisii,NYANZA,19542
KISII CENTRAL,Rural,27,1565,2153,3718,Kisii,NYANZA,19543
KISII CENTRAL,Rural,28,1517,2436,3953,Kisii,NYANZA,19544
KISII CENTRAL,Rural,29,1271,1519,2790,Kisii,NYANZA,19545
KISII CENTRAL,Rural,30,2278,3523,5801,Kisii,NYANZA,19546
KISII CENTRAL,Rural,31,1114,1097,2211,Kisii,NYANZA,19547
KISII CENTRAL,Rural,32,1305,1691,2996,Kisii,NYANZA,19548
KISII CENTRAL,Rural,33,1008,1055,2063,Kisii,NYANZA,19549
KISII CENTRAL,Rural,34,990,1092,2082,Kisii,NYANZA,19550
KISII CENTRAL,Rural,35,1974,2710,4684,Kisii,NYANZA,19551
KISII CENTRAL,Rural,36,958,1232,2190,Kisii,NYANZA,19552
KISII CENTRAL,Rural,37,1041,1228,2269,Kisii,NYANZA,19553
KISII CENTRAL,Rural,38,984,1410,2394,Kisii,NYANZA,19554
KISII CENTRAL,Rural,39,796,891,1687,Kisii,NYANZA,19555
KISII CENTRAL,Rural,40,1588,2616,4204,Kisii,NYANZA,19556
KISII CENTRAL,Rural,41,724,688,1412,Kisii,NYANZA,19557
KISII CENTRAL,Rural,42,745,921,1666,Kisii,NYANZA,19558
KISII CENTRAL,Rural,43,586,618,1204,Kisii,NYANZA,19559
KISII CENTRAL,Rural,44,596,597,1193,Kisii,NYANZA,19560
KISII CENTRAL,Rural,45,1324,1859,3183,Kisii,NYANZA,19561
KISII CENTRAL,Rural,46,840,884,1724,Kisii,NYANZA,19562
KISII CENTRAL,Rural,47,864,1012,1876,Kisii,NYANZA,19563
KISII CENTRAL,Rural,48,783,1112,1895,Kisii,NYANZA,19564
KISII CENTRAL,Rural,49,846,890,1736,Kisii,NYANZA,19565
KISII CENTRAL,Rural,50,1311,1923,3234,Kisii,NYANZA,19566
KISII CENTRAL,Rural,51,689,616,1305,Kisii,NYANZA,19567
KISII CENTRAL,Rural,52,660,634,1294,Kisii,NYANZA,19568
KISII CENTRAL,Rural,53,588,509,1097,Kisii,NYANZA,19569
KISII CENTRAL,Rural,54,542,581,1123,Kisii,NYANZA,19570
KISII CENTRAL,Rural,55,883,967,1850,Kisii,NYANZA,19571
KISII CENTRAL,Rural,56,560,457,1017,Kisii,NYANZA,19572
KISII CENTRAL,Rural,57,661,527,1188,Kisii,NYANZA,19573
KISII CENTRAL,Rural,58,392,413,805,Kisii,NYANZA,19574
KISII CENTRAL,Rural,59,453,446,899,Kisii,NYANZA,19575
KISII CENTRAL,Rural,60,868,1238,2106,Kisii,NYANZA,19576
KISII CENTRAL,Rural,61,453,351,804,Kisii,NYANZA,19577
KISII CENTRAL,Rural,62,362,262,624,Kisii,NYANZA,19578
KISII CENTRAL,Rural,63,322,224,546,Kisii,NYANZA,19579
KISII CENTRAL,Rural,64,295,306,601,Kisii,NYANZA,19580
KISII CENTRAL,Rural,65,469,635,1104,Kisii,NYANZA,19581
KISII CENTRAL,Rural,66,202,188,390,Kisii,NYANZA,19582
KISII CENTRAL,Rural,67,339,251,590,Kisii,NYANZA,19583
KISII CENTRAL,Rural,68,224,243,467,Kisii,NYANZA,19584
KISII CENTRAL,Rural,69,244,317,561,Kisii,NYANZA,19585
KISII CENTRAL,Rural,70,469,884,1353,Kisii,NYANZA,19586
KISII CENTRAL,Rural,71,176,170,346,Kisii,NYANZA,19587
KISII CENTRAL,Rural,72,211,192,403,Kisii,NYANZA,19588
KISII CENTRAL,Rural,73,163,136,299,Kisii,NYANZA,19589
KISII CENTRAL,Rural,74,185,216,401,Kisii,NYANZA,19590
KISII CENTRAL,Rural,75,237,331,568,Kisii,NYANZA,19591
KISII CENTRAL,Rural,76,141,136,277,Kisii,NYANZA,19592
KISII CENTRAL,Rural,77,149,102,251,Kisii,NYANZA,19593
KISII CENTRAL,Rural,78,129,162,291,Kisii,NYANZA,19594
KISII CENTRAL,Rural,79,148,245,393,Kisii,NYANZA,19595
KISII CENTRAL,Rural,80+,1146,1827,2973,Kisii,NYANZA,19596
KISII CENTRAL,Rural,Age NS,98,66,164,Kisii,NYANZA,19597
KISII SOUTH,Rural,0,1047,1027,2074,Kisii,NYANZA,19598
KISII SOUTH,Rural,1,951,1007,1958,Kisii,NYANZA,19599
KISII SOUTH,Rural,2,1114,1088,2202,Kisii,NYANZA,19600
KISII SOUTH,Rural,3,1013,1029,2042,Kisii,NYANZA,19601
KISII SOUTH,Rural,4,1063,1011,2074,Kisii,NYANZA,19602
KISII SOUTH,Rural,5,930,963,1893,Kisii,NYANZA,19603
KISII SOUTH,Rural,6,926,881,1807,Kisii,NYANZA,19604
KISII SOUTH,Rural,7,849,872,1721,Kisii,NYANZA,19605
KISII SOUTH,Rural,8,837,867,1704,Kisii,NYANZA,19606
KISII SOUTH,Rural,9,833,790,1623,Kisii,NYANZA,19607
KISII SOUTH,Rural,10,912,911,1823,Kisii,NYANZA,19608
KISII SOUTH,Rural,11,626,649,1275,Kisii,NYANZA,19609
KISII SOUTH,Rural,12,803,826,1629,Kisii,NYANZA,19610
KISII SOUTH,Rural,13,775,730,1505,Kisii,NYANZA,19611
KISII SOUTH,Rural,14,693,711,1404,Kisii,NYANZA,19612
KISII SOUTH,Rural,15,681,709,1390,Kisii,NYANZA,19613
KISII SOUTH,Rural,16,603,648,1251,Kisii,NYANZA,19614
KISII SOUTH,Rural,17,688,616,1304,Kisii,NYANZA,19615
KISII SOUTH,Rural,18,704,709,1413,Kisii,NYANZA,19616
KISII SOUTH,Rural,19,502,530,1032,Kisii,NYANZA,19617
KISII SOUTH,Rural,20,540,799,1339,Kisii,NYANZA,19618
KISII SOUTH,Rural,21,371,450,821,Kisii,NYANZA,19619
KISII SOUTH,Rural,22,412,599,1011,Kisii,NYANZA,19620
KISII SOUTH,Rural,23,327,493,820,Kisii,NYANZA,19621
KISII SOUTH,Rural,24,309,464,773,Kisii,NYANZA,19622
KISII SOUTH,Rural,25,433,634,1067,Kisii,NYANZA,19623
KISII SOUTH,Rural,26,246,394,640,Kisii,NYANZA,19624
KISII SOUTH,Rural,27,281,403,684,Kisii,NYANZA,19625
KISII SOUTH,Rural,28,258,383,641,Kisii,NYANZA,19626
KISII SOUTH,Rural,29,229,276,505,Kisii,NYANZA,19627
KISII SOUTH,Rural,30,346,543,889,Kisii,NYANZA,19628
KISII SOUTH,Rural,31,236,232,468,Kisii,NYANZA,19629
KISII SOUTH,Rural,32,235,306,541,Kisii,NYANZA,19630
KISII SOUTH,Rural,33,197,226,423,Kisii,NYANZA,19631
KISII SOUTH,Rural,34,184,231,415,Kisii,NYANZA,19632
KISII SOUTH,Rural,35,342,489,831,Kisii,NYANZA,19633
KISII SOUTH,Rural,36,210,232,442,Kisii,NYANZA,19634
KISII SOUTH,Rural,37,202,232,434,Kisii,NYANZA,19635
KISII SOUTH,Rural,38,158,251,409,Kisii,NYANZA,19636
KISII SOUTH,Rural,39,147,177,324,Kisii,NYANZA,19637
KISII SOUTH,Rural,40,246,448,694,Kisii,NYANZA,19638
KISII SOUTH,Rural,41,156,158,314,Kisii,NYANZA,19639
KISII SOUTH,Rural,42,135,149,284,Kisii,NYANZA,19640
KISII SOUTH,Rural,43,99,136,235,Kisii,NYANZA,19641
KISII SOUTH,Rural,44,104,97,201,Kisii,NYANZA,19642
KISII SOUTH,Rural,45,220,282,502,Kisii,NYANZA,19643
KISII SOUTH,Rural,46,181,148,329,Kisii,NYANZA,19644
KISII SOUTH,Rural,47,132,200,332,Kisii,NYANZA,19645
KISII SOUTH,Rural,48,121,187,308,Kisii,NYANZA,19646
KISII SOUTH,Rural,49,113,154,267,Kisii,NYANZA,19647
KISII SOUTH,Rural,50,201,365,566,Kisii,NYANZA,19648
KISII SOUTH,Rural,51,123,113,236,Kisii,NYANZA,19649
KISII SOUTH,Rural,52,107,106,213,Kisii,NYANZA,19650
KISII SOUTH,Rural,53,105,94,199,Kisii,NYANZA,19651
KISII SOUTH,Rural,54,115,120,235,Kisii,NYANZA,19652
KISII SOUTH,Rural,55,141,184,325,Kisii,NYANZA,19653
KISII SOUTH,Rural,56,98,70,168,Kisii,NYANZA,19654
KISII SOUTH,Rural,57,121,103,224,Kisii,NYANZA,19655
KISII SOUTH,Rural,58,64,71,135,Kisii,NYANZA,19656
KISII SOUTH,Rural,59,71,95,166,Kisii,NYANZA,19657
KISII SOUTH,Rural,60,139,189,328,Kisii,NYANZA,19658
KISII SOUTH,Rural,61,79,56,135,Kisii,NYANZA,19659
KISII SOUTH,Rural,62,64,31,95,Kisii,NYANZA,19660
KISII SOUTH,Rural,63,49,39,88,Kisii,NYANZA,19661
KISII SOUTH,Rural,64,52,50,102,Kisii,NYANZA,19662
KISII SOUTH,Rural,65,62,98,160,Kisii,NYANZA,19663
KISII SOUTH,Rural,66,26,19,45,Kisii,NYANZA,19664
KISII SOUTH,Rural,67,52,47,99,Kisii,NYANZA,19665
KISII SOUTH,Rural,68,35,34,69,Kisii,NYANZA,19666
KISII SOUTH,Rural,69,48,57,105,Kisii,NYANZA,19667
KISII SOUTH,Rural,70,73,144,217,Kisii,NYANZA,19668
KISII SOUTH,Rural,71,37,30,67,Kisii,NYANZA,19669
KISII SOUTH,Rural,72,37,29,66,Kisii,NYANZA,19670
KISII SOUTH,Rural,73,32,21,53,Kisii,NYANZA,19671
KISII SOUTH,Rural,74,20,27,47,Kisii,NYANZA,19672
KISII SOUTH,Rural,75,37,61,98,Kisii,NYANZA,19673
KISII SOUTH,Rural,76,23,21,44,Kisii,NYANZA,19674
KISII SOUTH,Rural,77,29,21,50,Kisii,NYANZA,19675
KISII SOUTH,Rural,78,26,31,57,Kisii,NYANZA,19676
KISII SOUTH,Rural,79,31,46,77,Kisii,NYANZA,19677
KISII SOUTH,Rural,80+,155,275,430,Kisii,NYANZA,19678
KISII SOUTH,Rural,Age NS,1,2,3,Kisii,NYANZA,19679
MASABA,Rural,0,2312,2349,4661,Kisii,NYANZA,19680
MASABA,Rural,1,2039,1963,4002,Kisii,NYANZA,19681
MASABA,Rural,2,2545,2553,5098,Kisii,NYANZA,19682
MASABA,Rural,3,2316,2396,4712,Kisii,NYANZA,19683
MASABA,Rural,4,2365,2415,4780,Kisii,NYANZA,19684
MASABA,Rural,5,2367,2294,4661,Kisii,NYANZA,19685
MASABA,Rural,6,2101,2178,4279,Kisii,NYANZA,19686
MASABA,Rural,7,2034,2024,4058,Kisii,NYANZA,19687
MASABA,Rural,8,2078,2238,4316,Kisii,NYANZA,19688
MASABA,Rural,9,2027,2031,4058,Kisii,NYANZA,19689
MASABA,Rural,10,2353,2357,4710,Kisii,NYANZA,19690
MASABA,Rural,11,1440,1455,2895,Kisii,NYANZA,19691
MASABA,Rural,12,2275,2293,4568,Kisii,NYANZA,19692
MASABA,Rural,13,1786,1823,3609,Kisii,NYANZA,19693
MASABA,Rural,14,2072,1870,3942,Kisii,NYANZA,19694
MASABA,Rural,15,1837,1710,3547,Kisii,NYANZA,19695
MASABA,Rural,16,1853,1765,3618,Kisii,NYANZA,19696
MASABA,Rural,17,1615,1507,3122,Kisii,NYANZA,19697
MASABA,Rural,18,1954,1885,3839,Kisii,NYANZA,19698
MASABA,Rural,19,1137,1182,2319,Kisii,NYANZA,19699
MASABA,Rural,20,1574,2203,3777,Kisii,NYANZA,19700
MASABA,Rural,21,869,1100,1969,Kisii,NYANZA,19701
MASABA,Rural,22,1127,1599,2726,Kisii,NYANZA,19702
MASABA,Rural,23,823,1318,2141,Kisii,NYANZA,19703
MASABA,Rural,24,867,1398,2265,Kisii,NYANZA,19704
MASABA,Rural,25,1094,1903,2997,Kisii,NYANZA,19705
MASABA,Rural,26,730,999,1729,Kisii,NYANZA,19706
MASABA,Rural,27,788,1070,1858,Kisii,NYANZA,19707
MASABA,Rural,28,777,1323,2100,Kisii,NYANZA,19708
MASABA,Rural,29,592,754,1346,Kisii,NYANZA,19709
MASABA,Rural,30,1223,1794,3017,Kisii,NYANZA,19710
MASABA,Rural,31,536,518,1054,Kisii,NYANZA,19711
MASABA,Rural,32,689,905,1594,Kisii,NYANZA,19712
MASABA,Rural,33,474,558,1032,Kisii,NYANZA,19713
MASABA,Rural,34,564,631,1195,Kisii,NYANZA,19714
MASABA,Rural,35,1071,1374,2445,Kisii,NYANZA,19715
MASABA,Rural,36,494,593,1087,Kisii,NYANZA,19716
MASABA,Rural,37,466,587,1053,Kisii,NYANZA,19717
MASABA,Rural,38,488,747,1235,Kisii,NYANZA,19718
MASABA,Rural,39,423,440,863,Kisii,NYANZA,19719
MASABA,Rural,40,829,1302,2131,Kisii,NYANZA,19720
MASABA,Rural,41,365,342,707,Kisii,NYANZA,19721
MASABA,Rural,42,389,414,803,Kisii,NYANZA,19722
MASABA,Rural,43,293,295,588,Kisii,NYANZA,19723
MASABA,Rural,44,256,270,526,Kisii,NYANZA,19724
MASABA,Rural,45,653,908,1561,Kisii,NYANZA,19725
MASABA,Rural,46,398,443,841,Kisii,NYANZA,19726
MASABA,Rural,47,458,477,935,Kisii,NYANZA,19727
MASABA,Rural,48,377,508,885,Kisii,NYANZA,19728
MASABA,Rural,49,432,436,868,Kisii,NYANZA,19729
MASABA,Rural,50,618,1026,1644,Kisii,NYANZA,19730
MASABA,Rural,51,337,315,652,Kisii,NYANZA,19731
MASABA,Rural,52,295,327,622,Kisii,NYANZA,19732
MASABA,Rural,53,282,271,553,Kisii,NYANZA,19733
MASABA,Rural,54,228,240,468,Kisii,NYANZA,19734
MASABA,Rural,55,381,509,890,Kisii,NYANZA,19735
MASABA,Rural,56,237,268,505,Kisii,NYANZA,19736
MASABA,Rural,57,317,244,561,Kisii,NYANZA,19737
MASABA,Rural,58,220,215,435,Kisii,NYANZA,19738
MASABA,Rural,59,206,221,427,Kisii,NYANZA,19739
MASABA,Rural,60,461,710,1171,Kisii,NYANZA,19740
MASABA,Rural,61,239,206,445,Kisii,NYANZA,19741
MASABA,Rural,62,181,150,331,Kisii,NYANZA,19742
MASABA,Rural,63,163,127,290,Kisii,NYANZA,19743
MASABA,Rural,64,150,185,335,Kisii,NYANZA,19744
MASABA,Rural,65,242,319,561,Kisii,NYANZA,19745
MASABA,Rural,66,99,84,183,Kisii,NYANZA,19746
MASABA,Rural,67,177,130,307,Kisii,NYANZA,19747
MASABA,Rural,68,110,145,255,Kisii,NYANZA,19748
MASABA,Rural,69,117,191,308,Kisii,NYANZA,19749
MASABA,Rural,70,261,427,688,Kisii,NYANZA,19750
MASABA,Rural,71,109,84,193,Kisii,NYANZA,19751
MASABA,Rural,72,100,116,216,Kisii,NYANZA,19752
MASABA,Rural,73,124,67,191,Kisii,NYANZA,19753
MASABA,Rural,74,100,96,196,Kisii,NYANZA,19754
MASABA,Rural,75,120,172,292,Kisii,NYANZA,19755
MASABA,Rural,76,75,89,164,Kisii,NYANZA,19756
MASABA,Rural,77,78,59,137,Kisii,NYANZA,19757
MASABA,Rural,78,71,95,166,Kisii,NYANZA,19758
MASABA,Rural,79,57,105,162,Kisii,NYANZA,19759
MASABA,Rural,80+,575,855,1430,Kisii,NYANZA,19760
MASABA,Rural,Age NS,44,43,87,Kisii,NYANZA,19761
GUCHA,Rural,0,6626,6454,13080,Kisii,NYANZA,19762
GUCHA,Rural,1,5528,5443,10971,Kisii,NYANZA,19763
GUCHA,Rural,2,6976,6875,13851,Kisii,NYANZA,19764
GUCHA,Rural,3,6518,6625,13143,Kisii,NYANZA,19765
GUCHA,Rural,4,6248,6107,12355,Kisii,NYANZA,19766
GUCHA,Rural,5,6078,5794,11872,Kisii,NYANZA,19767
GUCHA,Rural,6,5862,5790,11652,Kisii,NYANZA,19768
GUCHA,Rural,7,5442,5325,10767,Kisii,NYANZA,19769
GUCHA,Rural,8,5732,5581,11313,Kisii,NYANZA,19770
GUCHA,Rural,9,4937,4785,9722,Kisii,NYANZA,19771
GUCHA,Rural,10,6011,5882,11893,Kisii,NYANZA,19772
GUCHA,Rural,11,3755,3832,7587,Kisii,NYANZA,19773
GUCHA,Rural,12,5688,5500,11188,Kisii,NYANZA,19774
GUCHA,Rural,13,4510,4731,9241,Kisii,NYANZA,19775
GUCHA,Rural,14,4860,4747,9607,Kisii,NYANZA,19776
GUCHA,Rural,15,4495,4586,9081,Kisii,NYANZA,19777
GUCHA,Rural,16,4481,4517,8998,Kisii,NYANZA,19778
GUCHA,Rural,17,4278,4110,8388,Kisii,NYANZA,19779
GUCHA,Rural,18,4849,5085,9934,Kisii,NYANZA,19780
GUCHA,Rural,19,2941,3228,6169,Kisii,NYANZA,19781
GUCHA,Rural,20,3996,5778,9774,Kisii,NYANZA,19782
GUCHA,Rural,21,2454,3174,5628,Kisii,NYANZA,19783
GUCHA,Rural,22,2883,4158,7041,Kisii,NYANZA,19784
GUCHA,Rural,23,2451,3368,5819,Kisii,NYANZA,19785
GUCHA,Rural,24,2244,3349,5593,Kisii,NYANZA,19786
GUCHA,Rural,25,2887,4483,7370,Kisii,NYANZA,19787
GUCHA,Rural,26,1973,2482,4455,Kisii,NYANZA,19788
GUCHA,Rural,27,1978,2730,4708,Kisii,NYANZA,19789
GUCHA,Rural,28,1877,2868,4745,Kisii,NYANZA,19790
GUCHA,Rural,29,1552,1808,3360,Kisii,NYANZA,19791
GUCHA,Rural,30,2743,3898,6641,Kisii,NYANZA,19792
GUCHA,Rural,31,1576,1524,3100,Kisii,NYANZA,19793
GUCHA,Rural,32,1651,2039,3690,Kisii,NYANZA,19794
GUCHA,Rural,33,1349,1433,2782,Kisii,NYANZA,19795
GUCHA,Rural,34,1342,1518,2860,Kisii,NYANZA,19796
GUCHA,Rural,35,2410,3108,5518,Kisii,NYANZA,19797
GUCHA,Rural,36,1273,1449,2722,Kisii,NYANZA,19798
GUCHA,Rural,37,1310,1628,2938,Kisii,NYANZA,19799
GUCHA,Rural,38,1155,1635,2790,Kisii,NYANZA,19800
GUCHA,Rural,39,992,1276,2268,Kisii,NYANZA,19801
GUCHA,Rural,40,1948,2953,4901,Kisii,NYANZA,19802
GUCHA,Rural,41,1005,968,1973,Kisii,NYANZA,19803
GUCHA,Rural,42,998,1011,2009,Kisii,NYANZA,19804
GUCHA,Rural,43,751,781,1532,Kisii,NYANZA,19805
GUCHA,Rural,44,735,811,1546,Kisii,NYANZA,19806
GUCHA,Rural,45,1611,2055,3666,Kisii,NYANZA,19807
GUCHA,Rural,46,1187,1145,2332,Kisii,NYANZA,19808
GUCHA,Rural,47,1094,1273,2367,Kisii,NYANZA,19809
GUCHA,Rural,48,949,1268,2217,Kisii,NYANZA,19810
GUCHA,Rural,49,1055,1081,2136,Kisii,NYANZA,19811
GUCHA,Rural,50,1505,2080,3585,Kisii,NYANZA,19812
GUCHA,Rural,51,851,823,1674,Kisii,NYANZA,19813
GUCHA,Rural,52,845,821,1666,Kisii,NYANZA,19814
GUCHA,Rural,53,701,678,1379,Kisii,NYANZA,19815
GUCHA,Rural,54,635,633,1268,Kisii,NYANZA,19816
GUCHA,Rural,55,958,1158,2116,Kisii,NYANZA,19817
GUCHA,Rural,56,625,620,1245,Kisii,NYANZA,19818
GUCHA,Rural,57,741,638,1379,Kisii,NYANZA,19819
GUCHA,Rural,58,430,511,941,Kisii,NYANZA,19820
GUCHA,Rural,59,530,608,1138,Kisii,NYANZA,19821
GUCHA,Rural,60,963,1388,2351,Kisii,NYANZA,19822
GUCHA,Rural,61,528,401,929,Kisii,NYANZA,19823
GUCHA,Rural,62,419,341,760,Kisii,NYANZA,19824
GUCHA,Rural,63,378,289,667,Kisii,NYANZA,19825
GUCHA,Rural,64,386,447,833,Kisii,NYANZA,19826
GUCHA,Rural,65,530,702,1232,Kisii,NYANZA,19827
GUCHA,Rural,66,232,209,441,Kisii,NYANZA,19828
GUCHA,Rural,67,411,367,778,Kisii,NYANZA,19829
GUCHA,Rural,68,280,371,651,Kisii,NYANZA,19830
GUCHA,Rural,69,267,419,686,Kisii,NYANZA,19831
GUCHA,Rural,70,562,971,1533,Kisii,NYANZA,19832
GUCHA,Rural,71,239,237,476,Kisii,NYANZA,19833
GUCHA,Rural,72,244,240,484,Kisii,NYANZA,19834
GUCHA,Rural,73,265,211,476,Kisii,NYANZA,19835
GUCHA,Rural,74,184,243,427,Kisii,NYANZA,19836
GUCHA,Rural,75,294,458,752,Kisii,NYANZA,19837
GUCHA,Rural,76,187,184,371,Kisii,NYANZA,19838
GUCHA,Rural,77,222,173,395,Kisii,NYANZA,19839
GUCHA,Rural,78,177,229,406,Kisii,NYANZA,19840
GUCHA,Rural,79,163,256,419,Kisii,NYANZA,19841
GUCHA,Rural,80+,1434,2197,3631,Kisii,NYANZA,19842
GUCHA,Rural,Age NS,42,36,78,Kisii,NYANZA,19843
GUCHA SOUTH,Rural,0,2784,2750,5534,Kisii,NYANZA,19844
GUCHA SOUTH,Rural,1,2281,2372,4653,Kisii,NYANZA,19845
GUCHA SOUTH,Rural,2,2986,2944,5930,Kisii,NYANZA,19846
GUCHA SOUTH,Rural,3,2733,2835,5568,Kisii,NYANZA,19847
GUCHA SOUTH,Rural,4,2776,2695,5471,Kisii,NYANZA,19848
GUCHA SOUTH,Rural,5,2479,2352,4831,Kisii,NYANZA,19849
GUCHA SOUTH,Rural,6,2403,2351,4754,Kisii,NYANZA,19850
GUCHA SOUTH,Rural,7,2036,2092,4128,Kisii,NYANZA,19851
GUCHA SOUTH,Rural,8,2221,2367,4588,Kisii,NYANZA,19852
GUCHA SOUTH,Rural,9,1951,1867,3818,Kisii,NYANZA,19853
GUCHA SOUTH,Rural,10,2464,2416,4880,Kisii,NYANZA,19854
GUCHA SOUTH,Rural,11,1495,1454,2949,Kisii,NYANZA,19855
GUCHA SOUTH,Rural,12,2326,2195,4521,Kisii,NYANZA,19856
GUCHA SOUTH,Rural,13,1758,1754,3512,Kisii,NYANZA,19857
GUCHA SOUTH,Rural,14,1856,1789,3645,Kisii,NYANZA,19858
GUCHA SOUTH,Rural,15,1797,1746,3543,Kisii,NYANZA,19859
GUCHA SOUTH,Rural,16,1750,1748,3498,Kisii,NYANZA,19860
GUCHA SOUTH,Rural,17,1706,1596,3302,Kisii,NYANZA,19861
GUCHA SOUTH,Rural,18,2013,2102,4115,Kisii,NYANZA,19862
GUCHA SOUTH,Rural,19,1199,1291,2490,Kisii,NYANZA,19863
GUCHA SOUTH,Rural,20,1696,2407,4103,Kisii,NYANZA,19864
GUCHA SOUTH,Rural,21,1014,1288,2302,Kisii,NYANZA,19865
GUCHA SOUTH,Rural,22,1258,1708,2966,Kisii,NYANZA,19866
GUCHA SOUTH,Rural,23,1035,1334,2369,Kisii,NYANZA,19867
GUCHA SOUTH,Rural,24,1079,1373,2452,Kisii,NYANZA,19868
GUCHA SOUTH,Rural,25,1424,1853,3277,Kisii,NYANZA,19869
GUCHA SOUTH,Rural,26,854,1025,1879,Kisii,NYANZA,19870
GUCHA SOUTH,Rural,27,940,1056,1996,Kisii,NYANZA,19871
GUCHA SOUTH,Rural,28,863,1189,2052,Kisii,NYANZA,19872
GUCHA SOUTH,Rural,29,701,720,1421,Kisii,NYANZA,19873
GUCHA SOUTH,Rural,30,1214,1550,2764,Kisii,NYANZA,19874
GUCHA SOUTH,Rural,31,691,570,1261,Kisii,NYANZA,19875
GUCHA SOUTH,Rural,32,732,752,1484,Kisii,NYANZA,19876
GUCHA SOUTH,Rural,33,536,496,1032,Kisii,NYANZA,19877
GUCHA SOUTH,Rural,34,521,510,1031,Kisii,NYANZA,19878
GUCHA SOUTH,Rural,35,1054,1247,2301,Kisii,NYANZA,19879
GUCHA SOUTH,Rural,36,535,570,1105,Kisii,NYANZA,19880
GUCHA SOUTH,Rural,37,571,651,1222,Kisii,NYANZA,19881
GUCHA SOUTH,Rural,38,425,564,989,Kisii,NYANZA,19882
GUCHA SOUTH,Rural,39,420,390,810,Kisii,NYANZA,19883
GUCHA SOUTH,Rural,40,731,1133,1864,Kisii,NYANZA,19884
GUCHA SOUTH,Rural,41,391,382,773,Kisii,NYANZA,19885
GUCHA SOUTH,Rural,42,351,379,730,Kisii,NYANZA,19886
GUCHA SOUTH,Rural,43,235,256,491,Kisii,NYANZA,19887
GUCHA SOUTH,Rural,44,282,255,537,Kisii,NYANZA,19888
GUCHA SOUTH,Rural,45,680,780,1460,Kisii,NYANZA,19889
GUCHA SOUTH,Rural,46,440,390,830,Kisii,NYANZA,19890
GUCHA SOUTH,Rural,47,359,450,809,Kisii,NYANZA,19891
GUCHA SOUTH,Rural,48,325,456,781,Kisii,NYANZA,19892
GUCHA SOUTH,Rural,49,363,425,788,Kisii,NYANZA,19893
GUCHA SOUTH,Rural,50,520,848,1368,Kisii,NYANZA,19894
GUCHA SOUTH,Rural,51,255,287,542,Kisii,NYANZA,19895
GUCHA SOUTH,Rural,52,333,282,615,Kisii,NYANZA,19896
GUCHA SOUTH,Rural,53,246,255,501,Kisii,NYANZA,19897
GUCHA SOUTH,Rural,54,218,258,476,Kisii,NYANZA,19898
GUCHA SOUTH,Rural,55,377,409,786,Kisii,NYANZA,19899
GUCHA SOUTH,Rural,56,219,212,431,Kisii,NYANZA,19900
GUCHA SOUTH,Rural,57,237,255,492,Kisii,NYANZA,19901
GUCHA SOUTH,Rural,58,173,198,371,Kisii,NYANZA,19902
GUCHA SOUTH,Rural,59,207,237,444,Kisii,NYANZA,19903
GUCHA SOUTH,Rural,60,345,586,931,Kisii,NYANZA,19904
GUCHA SOUTH,Rural,61,177,172,349,Kisii,NYANZA,19905
GUCHA SOUTH,Rural,62,143,131,274,Kisii,NYANZA,19906
GUCHA SOUTH,Rural,63,96,85,181,Kisii,NYANZA,19907
GUCHA SOUTH,Rural,64,121,111,232,Kisii,NYANZA,19908
GUCHA SOUTH,Rural,65,167,265,432,Kisii,NYANZA,19909
GUCHA SOUTH,Rural,66,67,81,148,Kisii,NYANZA,19910
GUCHA SOUTH,Rural,67,132,123,255,Kisii,NYANZA,19911
GUCHA SOUTH,Rural,68,110,136,246,Kisii,NYANZA,19912
GUCHA SOUTH,Rural,69,111,142,253,Kisii,NYANZA,19913
GUCHA SOUTH,Rural,70,199,362,561,Kisii,NYANZA,19914
GUCHA SOUTH,Rural,71,74,78,152,Kisii,NYANZA,19915
GUCHA SOUTH,Rural,72,81,85,166,Kisii,NYANZA,19916
GUCHA SOUTH,Rural,73,76,65,141,Kisii,NYANZA,19917
GUCHA SOUTH,Rural,74,75,74,149,Kisii,NYANZA,19918
GUCHA SOUTH,Rural,75,101,156,257,Kisii,NYANZA,19919
GUCHA SOUTH,Rural,76,68,65,133,Kisii,NYANZA,19920
GUCHA SOUTH,Rural,77,90,54,144,Kisii,NYANZA,19921
GUCHA SOUTH,Rural,78,77,106,183,Kisii,NYANZA,19922
GUCHA SOUTH,Rural,79,84,95,179,Kisii,NYANZA,19923
GUCHA SOUTH,Rural,80+,531,752,1283,Kisii,NYANZA,19924
GUCHA SOUTH,Rural,Age NS,14,9,23,Kisii,NYANZA,19925
NYAMIRA,Rural,0,4355,4388,8743,Nyamira,NYANZA,19926
NYAMIRA,Rural,1,3764,3812,7576,Nyamira,NYANZA,19927
NYAMIRA,Rural,2,4731,4619,9350,Nyamira,NYANZA,19928
NYAMIRA,Rural,3,4449,4421,8870,Nyamira,NYANZA,19929
NYAMIRA,Rural,4,4550,4273,8823,Nyamira,NYANZA,19930
NYAMIRA,Rural,5,4300,4251,8551,Nyamira,NYANZA,19931
NYAMIRA,Rural,6,4044,4191,8235,Nyamira,NYANZA,19932
NYAMIRA,Rural,7,3589,3743,7332,Nyamira,NYANZA,19933
NYAMIRA,Rural,8,3910,3990,7900,Nyamira,NYANZA,19934
NYAMIRA,Rural,9,3649,3528,7177,Nyamira,NYANZA,19935
NYAMIRA,Rural,10,4182,4225,8407,Nyamira,NYANZA,19936
NYAMIRA,Rural,11,2541,2553,5094,Nyamira,NYANZA,19937
NYAMIRA,Rural,12,4097,3974,8071,Nyamira,NYANZA,19938
NYAMIRA,Rural,13,3336,3345,6681,Nyamira,NYANZA,19939
NYAMIRA,Rural,14,3514,3372,6886,Nyamira,NYANZA,19940
NYAMIRA,Rural,15,3171,3175,6346,Nyamira,NYANZA,19941
NYAMIRA,Rural,16,3207,3540,6747,Nyamira,NYANZA,19942
NYAMIRA,Rural,17,2842,3070,5912,Nyamira,NYANZA,19943
NYAMIRA,Rural,18,3632,3658,7290,Nyamira,NYANZA,19944
NYAMIRA,Rural,19,2098,2337,4435,Nyamira,NYANZA,19945
NYAMIRA,Rural,20,3031,4251,7282,Nyamira,NYANZA,19946
NYAMIRA,Rural,21,1649,2159,3808,Nyamira,NYANZA,19947
NYAMIRA,Rural,22,2113,2991,5104,Nyamira,NYANZA,19948
NYAMIRA,Rural,23,1700,2432,4132,Nyamira,NYANZA,19949
NYAMIRA,Rural,24,1667,2574,4241,Nyamira,NYANZA,19950
NYAMIRA,Rural,25,2352,3593,5945,Nyamira,NYANZA,19951
NYAMIRA,Rural,26,1497,1966,3463,Nyamira,NYANZA,19952
NYAMIRA,Rural,27,1562,1878,3440,Nyamira,NYANZA,19953
NYAMIRA,Rural,28,1555,2426,3981,Nyamira,NYANZA,19954
NYAMIRA,Rural,29,1214,1326,2540,Nyamira,NYANZA,19955
NYAMIRA,Rural,30,2444,3408,5852,Nyamira,NYANZA,19956
NYAMIRA,Rural,31,1169,1067,2236,Nyamira,NYANZA,19957
NYAMIRA,Rural,32,1307,1500,2807,Nyamira,NYANZA,19958
NYAMIRA,Rural,33,896,924,1820,Nyamira,NYANZA,19959
NYAMIRA,Rural,34,997,1001,1998,Nyamira,NYANZA,19960
NYAMIRA,Rural,35,2079,2677,4756,Nyamira,NYANZA,19961
NYAMIRA,Rural,36,893,1019,1912,Nyamira,NYANZA,19962
NYAMIRA,Rural,37,923,1049,1972,Nyamira,NYANZA,19963
NYAMIRA,Rural,38,975,1367,2342,Nyamira,NYANZA,19964
NYAMIRA,Rural,39,717,839,1556,Nyamira,NYANZA,19965
NYAMIRA,Rural,40,1816,2425,4241,Nyamira,NYANZA,19966
NYAMIRA,Rural,41,646,615,1261,Nyamira,NYANZA,19967
NYAMIRA,Rural,42,671,662,1333,Nyamira,NYANZA,19968
NYAMIRA,Rural,43,494,467,961,Nyamira,NYANZA,19969
NYAMIRA,Rural,44,539,458,997,Nyamira,NYANZA,19970
NYAMIRA,Rural,45,1401,1645,3046,Nyamira,NYANZA,19971
NYAMIRA,Rural,46,846,749,1595,Nyamira,NYANZA,19972
NYAMIRA,Rural,47,779,801,1580,Nyamira,NYANZA,19973
NYAMIRA,Rural,48,726,937,1663,Nyamira,NYANZA,19974
NYAMIRA,Rural,49,782,682,1464,Nyamira,NYANZA,19975
NYAMIRA,Rural,50,1355,1796,3151,Nyamira,NYANZA,19976
NYAMIRA,Rural,51,609,486,1095,Nyamira,NYANZA,19977
NYAMIRA,Rural,52,564,532,1096,Nyamira,NYANZA,19978
NYAMIRA,Rural,53,444,381,825,Nyamira,NYANZA,19979
NYAMIRA,Rural,54,441,403,844,Nyamira,NYANZA,19980
NYAMIRA,Rural,55,818,803,1621,Nyamira,NYANZA,19981
NYAMIRA,Rural,56,457,388,845,Nyamira,NYANZA,19982
NYAMIRA,Rural,57,503,459,962,Nyamira,NYANZA,19983
NYAMIRA,Rural,58,328,358,686,Nyamira,NYANZA,19984
NYAMIRA,Rural,59,383,391,774,Nyamira,NYANZA,19985
NYAMIRA,Rural,60,881,1163,2044,Nyamira,NYANZA,19986
NYAMIRA,Rural,61,446,346,792,Nyamira,NYANZA,19987
NYAMIRA,Rural,62,271,206,477,Nyamira,NYANZA,19988
NYAMIRA,Rural,63,262,178,440,Nyamira,NYANZA,19989
NYAMIRA,Rural,64,281,224,505,Nyamira,NYANZA,19990
NYAMIRA,Rural,65,427,513,940,Nyamira,NYANZA,19991
NYAMIRA,Rural,66,161,109,270,Nyamira,NYANZA,19992
NYAMIRA,Rural,67,275,215,490,Nyamira,NYANZA,19993
NYAMIRA,Rural,68,228,200,428,Nyamira,NYANZA,19994
NYAMIRA,Rural,69,212,254,466,Nyamira,NYANZA,19995
NYAMIRA,Rural,70,502,815,1317,Nyamira,NYANZA,19996
NYAMIRA,Rural,71,153,144,297,Nyamira,NYANZA,19997
NYAMIRA,Rural,72,183,141,324,Nyamira,NYANZA,19998
NYAMIRA,Rural,73,161,105,266,Nyamira,NYANZA,19999
NYAMIRA,Rural,74,169,137,306,Nyamira,NYANZA,20000
NYAMIRA,Rural,75,206,285,491,Nyamira,NYANZA,20001
NYAMIRA,Rural,76,140,111,251,Nyamira,NYANZA,20002
NYAMIRA,Rural,77,132,82,214,Nyamira,NYANZA,20003
NYAMIRA,Rural,78,147,142,289,Nyamira,NYANZA,20004
NYAMIRA,Rural,79,119,137,256,Nyamira,NYANZA,20005
NYAMIRA,Rural,80+,1047,1561,2608,Nyamira,NYANZA,20006
NYAMIRA,Rural,Age NS,38,39,77,Nyamira,NYANZA,20007
MANGA,Rural,0,1396,1403,2799,Nyamira,NYANZA,20008
MANGA,Rural,1,1333,1302,2635,Nyamira,NYANZA,20009
MANGA,Rural,2,1559,1553,3112,Nyamira,NYANZA,20010
MANGA,Rural,3,1451,1526,2977,Nyamira,NYANZA,20011
MANGA,Rural,4,1542,1382,2924,Nyamira,NYANZA,20012
MANGA,Rural,5,1493,1337,2830,Nyamira,NYANZA,20013
MANGA,Rural,6,1184,1225,2409,Nyamira,NYANZA,20014
MANGA,Rural,7,1220,1187,2407,Nyamira,NYANZA,20015
MANGA,Rural,8,1265,1230,2495,Nyamira,NYANZA,20016
MANGA,Rural,9,1146,1159,2305,Nyamira,NYANZA,20017
MANGA,Rural,10,1308,1314,2622,Nyamira,NYANZA,20018
MANGA,Rural,11,861,829,1690,Nyamira,NYANZA,20019
MANGA,Rural,12,1368,1312,2680,Nyamira,NYANZA,20020
MANGA,Rural,13,1097,1055,2152,Nyamira,NYANZA,20021
MANGA,Rural,14,1167,1066,2233,Nyamira,NYANZA,20022
MANGA,Rural,15,1083,1038,2121,Nyamira,NYANZA,20023
MANGA,Rural,16,1040,1088,2128,Nyamira,NYANZA,20024
MANGA,Rural,17,990,1088,2078,Nyamira,NYANZA,20025
MANGA,Rural,18,1152,1151,2303,Nyamira,NYANZA,20026
MANGA,Rural,19,710,818,1528,Nyamira,NYANZA,20027
MANGA,Rural,20,960,1415,2375,Nyamira,NYANZA,20028
MANGA,Rural,21,550,715,1265,Nyamira,NYANZA,20029
MANGA,Rural,22,709,994,1703,Nyamira,NYANZA,20030
MANGA,Rural,23,555,852,1407,Nyamira,NYANZA,20031
MANGA,Rural,24,583,901,1484,Nyamira,NYANZA,20032
MANGA,Rural,25,796,1199,1995,Nyamira,NYANZA,20033
MANGA,Rural,26,490,662,1152,Nyamira,NYANZA,20034
MANGA,Rural,27,513,713,1226,Nyamira,NYANZA,20035
MANGA,Rural,28,493,798,1291,Nyamira,NYANZA,20036
MANGA,Rural,29,395,497,892,Nyamira,NYANZA,20037
MANGA,Rural,30,712,1087,1799,Nyamira,NYANZA,20038
MANGA,Rural,31,370,339,709,Nyamira,NYANZA,20039
MANGA,Rural,32,449,532,981,Nyamira,NYANZA,20040
MANGA,Rural,33,326,315,641,Nyamira,NYANZA,20041
MANGA,Rural,34,354,369,723,Nyamira,NYANZA,20042
MANGA,Rural,35,666,872,1538,Nyamira,NYANZA,20043
MANGA,Rural,36,303,387,690,Nyamira,NYANZA,20044
MANGA,Rural,37,309,413,722,Nyamira,NYANZA,20045
MANGA,Rural,38,320,426,746,Nyamira,NYANZA,20046
MANGA,Rural,39,249,288,537,Nyamira,NYANZA,20047
MANGA,Rural,40,512,785,1297,Nyamira,NYANZA,20048
MANGA,Rural,41,249,224,473,Nyamira,NYANZA,20049
MANGA,Rural,42,244,253,497,Nyamira,NYANZA,20050
MANGA,Rural,43,171,179,350,Nyamira,NYANZA,20051
MANGA,Rural,44,172,198,370,Nyamira,NYANZA,20052
MANGA,Rural,45,420,538,958,Nyamira,NYANZA,20053
MANGA,Rural,46,271,265,536,Nyamira,NYANZA,20054
MANGA,Rural,47,294,345,639,Nyamira,NYANZA,20055
MANGA,Rural,48,267,368,635,Nyamira,NYANZA,20056
MANGA,Rural,49,299,281,580,Nyamira,NYANZA,20057
MANGA,Rural,50,434,612,1046,Nyamira,NYANZA,20058
MANGA,Rural,51,232,198,430,Nyamira,NYANZA,20059
MANGA,Rural,52,240,199,439,Nyamira,NYANZA,20060
MANGA,Rural,53,154,171,325,Nyamira,NYANZA,20061
MANGA,Rural,54,158,154,312,Nyamira,NYANZA,20062
MANGA,Rural,55,322,315,637,Nyamira,NYANZA,20063
MANGA,Rural,56,138,159,297,Nyamira,NYANZA,20064
MANGA,Rural,57,205,149,354,Nyamira,NYANZA,20065
MANGA,Rural,58,115,131,246,Nyamira,NYANZA,20066
MANGA,Rural,59,148,139,287,Nyamira,NYANZA,20067
MANGA,Rural,60,280,348,628,Nyamira,NYANZA,20068
MANGA,Rural,61,150,104,254,Nyamira,NYANZA,20069
MANGA,Rural,62,100,99,199,Nyamira,NYANZA,20070
MANGA,Rural,63,87,90,177,Nyamira,NYANZA,20071
MANGA,Rural,64,98,106,204,Nyamira,NYANZA,20072
MANGA,Rural,65,133,214,347,Nyamira,NYANZA,20073
MANGA,Rural,66,58,54,112,Nyamira,NYANZA,20074
MANGA,Rural,67,106,84,190,Nyamira,NYANZA,20075
MANGA,Rural,68,68,86,154,Nyamira,NYANZA,20076
MANGA,Rural,69,78,113,191,Nyamira,NYANZA,20077
MANGA,Rural,70,158,269,427,Nyamira,NYANZA,20078
MANGA,Rural,71,67,57,124,Nyamira,NYANZA,20079
MANGA,Rural,72,80,77,157,Nyamira,NYANZA,20080
MANGA,Rural,73,59,56,115,Nyamira,NYANZA,20081
MANGA,Rural,74,63,66,129,Nyamira,NYANZA,20082
MANGA,Rural,75,65,104,169,Nyamira,NYANZA,20083
MANGA,Rural,76,51,43,94,Nyamira,NYANZA,20084
MANGA,Rural,77,45,26,71,Nyamira,NYANZA,20085
MANGA,Rural,78,57,62,119,Nyamira,NYANZA,20086
MANGA,Rural,79,46,67,113,Nyamira,NYANZA,20087
MANGA,Rural,80+,310,549,859,Nyamira,NYANZA,20088
MANGA,Rural,Age NS,7,7,14,Nyamira,NYANZA,20089
BORABU,Rural,0,1027,967,1994,Nyamira,NYANZA,20090
BORABU,Rural,1,976,891,1867,Nyamira,NYANZA,20091
BORABU,Rural,2,1055,1046,2101,Nyamira,NYANZA,20092
BORABU,Rural,3,1061,1023,2084,Nyamira,NYANZA,20093
BORABU,Rural,4,1074,1049,2123,Nyamira,NYANZA,20094
BORABU,Rural,5,1108,1039,2147,Nyamira,NYANZA,20095
BORABU,Rural,6,990,988,1978,Nyamira,NYANZA,20096
BORABU,Rural,7,909,916,1825,Nyamira,NYANZA,20097
BORABU,Rural,8,969,992,1961,Nyamira,NYANZA,20098
BORABU,Rural,9,950,934,1884,Nyamira,NYANZA,20099
BORABU,Rural,10,1061,1005,2066,Nyamira,NYANZA,20100
BORABU,Rural,11,669,669,1338,Nyamira,NYANZA,20101
BORABU,Rural,12,979,980,1959,Nyamira,NYANZA,20102
BORABU,Rural,13,853,819,1672,Nyamira,NYANZA,20103
BORABU,Rural,14,854,789,1643,Nyamira,NYANZA,20104
BORABU,Rural,15,764,764,1528,Nyamira,NYANZA,20105
BORABU,Rural,16,756,792,1548,Nyamira,NYANZA,20106
BORABU,Rural,17,764,694,1458,Nyamira,NYANZA,20107
BORABU,Rural,18,892,775,1667,Nyamira,NYANZA,20108
BORABU,Rural,19,601,482,1083,Nyamira,NYANZA,20109
BORABU,Rural,20,734,876,1610,Nyamira,NYANZA,20110
BORABU,Rural,21,443,536,979,Nyamira,NYANZA,20111
BORABU,Rural,22,540,725,1265,Nyamira,NYANZA,20112
BORABU,Rural,23,481,568,1049,Nyamira,NYANZA,20113
BORABU,Rural,24,508,634,1142,Nyamira,NYANZA,20114
BORABU,Rural,25,626,824,1450,Nyamira,NYANZA,20115
BORABU,Rural,26,451,555,1006,Nyamira,NYANZA,20116
BORABU,Rural,27,465,485,950,Nyamira,NYANZA,20117
BORABU,Rural,28,481,661,1142,Nyamira,NYANZA,20118
BORABU,Rural,29,350,328,678,Nyamira,NYANZA,20119
BORABU,Rural,30,719,896,1615,Nyamira,NYANZA,20120
BORABU,Rural,31,335,293,628,Nyamira,NYANZA,20121
BORABU,Rural,32,462,470,932,Nyamira,NYANZA,20122
BORABU,Rural,33,314,302,616,Nyamira,NYANZA,20123
BORABU,Rural,34,314,301,615,Nyamira,NYANZA,20124
BORABU,Rural,35,718,728,1446,Nyamira,NYANZA,20125
BORABU,Rural,36,371,330,701,Nyamira,NYANZA,20126
BORABU,Rural,37,322,335,657,Nyamira,NYANZA,20127
BORABU,Rural,38,327,410,737,Nyamira,NYANZA,20128
BORABU,Rural,39,294,247,541,Nyamira,NYANZA,20129
BORABU,Rural,40,610,620,1230,Nyamira,NYANZA,20130
BORABU,Rural,41,228,168,396,Nyamira,NYANZA,20131
BORABU,Rural,42,339,196,535,Nyamira,NYANZA,20132
BORABU,Rural,43,197,173,370,Nyamira,NYANZA,20133
BORABU,Rural,44,195,128,323,Nyamira,NYANZA,20134
BORABU,Rural,45,480,383,863,Nyamira,NYANZA,20135
BORABU,Rural,46,299,215,514,Nyamira,NYANZA,20136
BORABU,Rural,47,308,234,542,Nyamira,NYANZA,20137
BORABU,Rural,48,300,241,541,Nyamira,NYANZA,20138
BORABU,Rural,49,289,207,496,Nyamira,NYANZA,20139
BORABU,Rural,50,417,372,789,Nyamira,NYANZA,20140
BORABU,Rural,51,186,102,288,Nyamira,NYANZA,20141
BORABU,Rural,52,217,134,351,Nyamira,NYANZA,20142
BORABU,Rural,53,149,96,245,Nyamira,NYANZA,20143
BORABU,Rural,54,162,94,256,Nyamira,NYANZA,20144
BORABU,Rural,55,232,172,404,Nyamira,NYANZA,20145
BORABU,Rural,56,143,96,239,Nyamira,NYANZA,20146
BORABU,Rural,57,135,101,236,Nyamira,NYANZA,20147
BORABU,Rural,58,81,67,148,Nyamira,NYANZA,20148
BORABU,Rural,59,88,70,158,Nyamira,NYANZA,20149
BORABU,Rural,60,196,230,426,Nyamira,NYANZA,20150
BORABU,Rural,61,89,55,144,Nyamira,NYANZA,20151
BORABU,Rural,62,75,63,138,Nyamira,NYANZA,20152
BORABU,Rural,63,58,38,96,Nyamira,NYANZA,20153
BORABU,Rural,64,59,53,112,Nyamira,NYANZA,20154
BORABU,Rural,65,94,130,224,Nyamira,NYANZA,20155
BORABU,Rural,66,34,29,63,Nyamira,NYANZA,20156
BORABU,Rural,67,65,57,122,Nyamira,NYANZA,20157
BORABU,Rural,68,47,62,109,Nyamira,NYANZA,20158
BORABU,Rural,69,45,64,109,Nyamira,NYANZA,20159
BORABU,Rural,70,102,127,229,Nyamira,NYANZA,20160
BORABU,Rural,71,38,34,72,Nyamira,NYANZA,20161
BORABU,Rural,72,45,44,89,Nyamira,NYANZA,20162
BORABU,Rural,73,40,29,69,Nyamira,NYANZA,20163
BORABU,Rural,74,37,33,70,Nyamira,NYANZA,20164
BORABU,Rural,75,60,56,116,Nyamira,NYANZA,20165
BORABU,Rural,76,45,38,83,Nyamira,NYANZA,20166
BORABU,Rural,77,48,23,71,Nyamira,NYANZA,20167
BORABU,Rural,78,37,34,71,Nyamira,NYANZA,20168
BORABU,Rural,79,36,33,69,Nyamira,NYANZA,20169
BORABU,Rural,80+,270,237,507,Nyamira,NYANZA,20170
BORABU,Rural,Age NS,9,5,14,Nyamira,NYANZA,20171
TURKANA CENTRAL,Rural,0,2672,2704,5376,Turkana,RIFT VALLEY,20172
TURKANA CENTRAL,Rural,1,2216,2103,4319,Turkana,RIFT VALLEY,20173
TURKANA CENTRAL,Rural,2,3503,3257,6760,Turkana,RIFT VALLEY,20174
TURKANA CENTRAL,Rural,3,3480,3293,6773,Turkana,RIFT VALLEY,20175
TURKANA CENTRAL,Rural,4,3672,3471,7143,Turkana,RIFT VALLEY,20176
TURKANA CENTRAL,Rural,5,3439,3307,6746,Turkana,RIFT VALLEY,20177
TURKANA CENTRAL,Rural,6,3885,3653,7538,Turkana,RIFT VALLEY,20178
TURKANA CENTRAL,Rural,7,3165,2991,6156,Turkana,RIFT VALLEY,20179
TURKANA CENTRAL,Rural,8,3958,3883,7841,Turkana,RIFT VALLEY,20180
TURKANA CENTRAL,Rural,9,3312,3043,6355,Turkana,RIFT VALLEY,20181
TURKANA CENTRAL,Rural,10,4799,4669,9468,Turkana,RIFT VALLEY,20182
TURKANA CENTRAL,Rural,11,2267,2353,4620,Turkana,RIFT VALLEY,20183
TURKANA CENTRAL,Rural,12,4123,3785,7908,Turkana,RIFT VALLEY,20184
TURKANA CENTRAL,Rural,13,2710,2335,5045,Turkana,RIFT VALLEY,20185
TURKANA CENTRAL,Rural,14,3410,2839,6249,Turkana,RIFT VALLEY,20186
TURKANA CENTRAL,Rural,15,3539,2934,6473,Turkana,RIFT VALLEY,20187
TURKANA CENTRAL,Rural,16,3317,2826,6143,Turkana,RIFT VALLEY,20188
TURKANA CENTRAL,Rural,17,2457,1955,4412,Turkana,RIFT VALLEY,20189
TURKANA CENTRAL,Rural,18,3198,2751,5949,Turkana,RIFT VALLEY,20190
TURKANA CENTRAL,Rural,19,1778,1530,3308,Turkana,RIFT VALLEY,20191
TURKANA CENTRAL,Rural,20,2946,2636,5582,Turkana,RIFT VALLEY,20192
TURKANA CENTRAL,Rural,21,1343,1342,2685,Turkana,RIFT VALLEY,20193
TURKANA CENTRAL,Rural,22,1590,1598,3188,Turkana,RIFT VALLEY,20194
TURKANA CENTRAL,Rural,23,1317,1414,2731,Turkana,RIFT VALLEY,20195
TURKANA CENTRAL,Rural,24,1652,1800,3452,Turkana,RIFT VALLEY,20196
TURKANA CENTRAL,Rural,25,1838,2030,3868,Turkana,RIFT VALLEY,20197
TURKANA CENTRAL,Rural,26,1148,1328,2476,Turkana,RIFT VALLEY,20198
TURKANA CENTRAL,Rural,27,1143,1095,2238,Turkana,RIFT VALLEY,20199
TURKANA CENTRAL,Rural,28,1389,1710,3099,Turkana,RIFT VALLEY,20200
TURKANA CENTRAL,Rural,29,1047,1296,2343,Turkana,RIFT VALLEY,20201
TURKANA CENTRAL,Rural,30,1778,2153,3931,Turkana,RIFT VALLEY,20202
TURKANA CENTRAL,Rural,31,617,949,1566,Turkana,RIFT VALLEY,20203
TURKANA CENTRAL,Rural,32,929,1310,2239,Turkana,RIFT VALLEY,20204
TURKANA CENTRAL,Rural,33,583,798,1381,Turkana,RIFT VALLEY,20205
TURKANA CENTRAL,Rural,34,627,892,1519,Turkana,RIFT VALLEY,20206
TURKANA CENTRAL,Rural,35,1125,1422,2547,Turkana,RIFT VALLEY,20207
TURKANA CENTRAL,Rural,36,838,1270,2108,Turkana,RIFT VALLEY,20208
TURKANA CENTRAL,Rural,37,404,562,966,Turkana,RIFT VALLEY,20209
TURKANA CENTRAL,Rural,38,649,902,1551,Turkana,RIFT VALLEY,20210
TURKANA CENTRAL,Rural,39,628,779,1407,Turkana,RIFT VALLEY,20211
TURKANA CENTRAL,Rural,40,1213,1404,2617,Turkana,RIFT VALLEY,20212
TURKANA CENTRAL,Rural,41,402,476,878,Turkana,RIFT VALLEY,20213
TURKANA CENTRAL,Rural,42,508,652,1160,Turkana,RIFT VALLEY,20214
TURKANA CENTRAL,Rural,43,392,562,954,Turkana,RIFT VALLEY,20215
TURKANA CENTRAL,Rural,44,332,467,799,Turkana,RIFT VALLEY,20216
TURKANA CENTRAL,Rural,45,756,908,1664,Turkana,RIFT VALLEY,20217
TURKANA CENTRAL,Rural,46,326,402,728,Turkana,RIFT VALLEY,20218
TURKANA CENTRAL,Rural,47,284,369,653,Turkana,RIFT VALLEY,20219
TURKANA CENTRAL,Rural,48,463,573,1036,Turkana,RIFT VALLEY,20220
TURKANA CENTRAL,Rural,49,473,665,1138,Turkana,RIFT VALLEY,20221
TURKANA CENTRAL,Rural,50,772,901,1673,Turkana,RIFT VALLEY,20222
TURKANA CENTRAL,Rural,51,360,467,827,Turkana,RIFT VALLEY,20223
TURKANA CENTRAL,Rural,52,339,457,796,Turkana,RIFT VALLEY,20224
TURKANA CENTRAL,Rural,53,275,359,634,Turkana,RIFT VALLEY,20225
TURKANA CENTRAL,Rural,54,302,373,675,Turkana,RIFT VALLEY,20226
TURKANA CENTRAL,Rural,55,378,467,845,Turkana,RIFT VALLEY,20227
TURKANA CENTRAL,Rural,56,334,399,733,Turkana,RIFT VALLEY,20228
TURKANA CENTRAL,Rural,57,408,479,887,Turkana,RIFT VALLEY,20229
TURKANA CENTRAL,Rural,58,335,388,723,Turkana,RIFT VALLEY,20230
TURKANA CENTRAL,Rural,59,371,436,807,Turkana,RIFT VALLEY,20231
TURKANA CENTRAL,Rural,60,618,653,1271,Turkana,RIFT VALLEY,20232
TURKANA CENTRAL,Rural,61,231,259,490,Turkana,RIFT VALLEY,20233
TURKANA CENTRAL,Rural,62,246,215,461,Turkana,RIFT VALLEY,20234
TURKANA CENTRAL,Rural,63,199,224,423,Turkana,RIFT VALLEY,20235
TURKANA CENTRAL,Rural,64,244,281,525,Turkana,RIFT VALLEY,20236
TURKANA CENTRAL,Rural,65,217,219,436,Turkana,RIFT VALLEY,20237
TURKANA CENTRAL,Rural,66,104,108,212,Turkana,RIFT VALLEY,20238
TURKANA CENTRAL,Rural,67,132,115,247,Turkana,RIFT VALLEY,20239
TURKANA CENTRAL,Rural,68,201,208,409,Turkana,RIFT VALLEY,20240
TURKANA CENTRAL,Rural,69,275,283,558,Turkana,RIFT VALLEY,20241
TURKANA CENTRAL,Rural,70,319,265,584,Turkana,RIFT VALLEY,20242
TURKANA CENTRAL,Rural,71,99,111,210,Turkana,RIFT VALLEY,20243
TURKANA CENTRAL,Rural,72,115,104,219,Turkana,RIFT VALLEY,20244
TURKANA CENTRAL,Rural,73,119,103,222,Turkana,RIFT VALLEY,20245
TURKANA CENTRAL,Rural,74,89,97,186,Turkana,RIFT VALLEY,20246
TURKANA CENTRAL,Rural,75,90,108,198,Turkana,RIFT VALLEY,20247
TURKANA CENTRAL,Rural,76,62,50,112,Turkana,RIFT VALLEY,20248
TURKANA CENTRAL,Rural,77,48,43,91,Turkana,RIFT VALLEY,20249
TURKANA CENTRAL,Rural,78,91,92,183,Turkana,RIFT VALLEY,20250
TURKANA CENTRAL,Rural,79,136,130,266,Turkana,RIFT VALLEY,20251
TURKANA CENTRAL,Rural,80+,658,660,1318,Turkana,RIFT VALLEY,20252
TURKANA CENTRAL,Rural,Age NS,39,36,75,Turkana,RIFT VALLEY,20253
TURKANA NORTH,Rural,0,2841,2612,5453,Turkana,RIFT VALLEY,20254
TURKANA NORTH,Rural,1,2191,2000,4191,Turkana,RIFT VALLEY,20255
TURKANA NORTH,Rural,2,4127,3867,7994,Turkana,RIFT VALLEY,20256
TURKANA NORTH,Rural,3,3973,3752,7725,Turkana,RIFT VALLEY,20257
TURKANA NORTH,Rural,4,4605,4125,8730,Turkana,RIFT VALLEY,20258
TURKANA NORTH,Rural,5,4505,4255,8760,Turkana,RIFT VALLEY,20259
TURKANA NORTH,Rural,6,5152,4685,9837,Turkana,RIFT VALLEY,20260
TURKANA NORTH,Rural,7,4387,3886,8273,Turkana,RIFT VALLEY,20261
TURKANA NORTH,Rural,8,5926,5390,11316,Turkana,RIFT VALLEY,20262
TURKANA NORTH,Rural,9,4952,4399,9351,Turkana,RIFT VALLEY,20263
TURKANA NORTH,Rural,10,8131,6950,15081,Turkana,RIFT VALLEY,20264
TURKANA NORTH,Rural,11,3332,3239,6571,Turkana,RIFT VALLEY,20265
TURKANA NORTH,Rural,12,7262,5937,13199,Turkana,RIFT VALLEY,20266
TURKANA NORTH,Rural,13,4397,3508,7905,Turkana,RIFT VALLEY,20267
TURKANA NORTH,Rural,14,5614,4473,10087,Turkana,RIFT VALLEY,20268
TURKANA NORTH,Rural,15,5895,4502,10397,Turkana,RIFT VALLEY,20269
TURKANA NORTH,Rural,16,5457,4402,9859,Turkana,RIFT VALLEY,20270
TURKANA NORTH,Rural,17,4371,3262,7633,Turkana,RIFT VALLEY,20271
TURKANA NORTH,Rural,18,6068,4564,10632,Turkana,RIFT VALLEY,20272
TURKANA NORTH,Rural,19,3477,2576,6053,Turkana,RIFT VALLEY,20273
TURKANA NORTH,Rural,20,6043,4474,10517,Turkana,RIFT VALLEY,20274
TURKANA NORTH,Rural,21,2729,2179,4908,Turkana,RIFT VALLEY,20275
TURKANA NORTH,Rural,22,2857,2320,5177,Turkana,RIFT VALLEY,20276
TURKANA NORTH,Rural,23,2193,1746,3939,Turkana,RIFT VALLEY,20277
TURKANA NORTH,Rural,24,2693,2312,5005,Turkana,RIFT VALLEY,20278
TURKANA NORTH,Rural,25,2975,2652,5627,Turkana,RIFT VALLEY,20279
TURKANA NORTH,Rural,26,2074,1788,3862,Turkana,RIFT VALLEY,20280
TURKANA NORTH,Rural,27,1773,1642,3415,Turkana,RIFT VALLEY,20281
TURKANA NORTH,Rural,28,2323,2338,4661,Turkana,RIFT VALLEY,20282
TURKANA NORTH,Rural,29,2004,2347,4351,Turkana,RIFT VALLEY,20283
TURKANA NORTH,Rural,30,3173,3248,6421,Turkana,RIFT VALLEY,20284
TURKANA NORTH,Rural,31,983,1078,2061,Turkana,RIFT VALLEY,20285
TURKANA NORTH,Rural,32,1475,1867,3342,Turkana,RIFT VALLEY,20286
TURKANA NORTH,Rural,33,912,987,1899,Turkana,RIFT VALLEY,20287
TURKANA NORTH,Rural,34,1012,1199,2211,Turkana,RIFT VALLEY,20288
TURKANA NORTH,Rural,35,1698,1946,3644,Turkana,RIFT VALLEY,20289
TURKANA NORTH,Rural,36,1165,1583,2748,Turkana,RIFT VALLEY,20290
TURKANA NORTH,Rural,37,803,992,1795,Turkana,RIFT VALLEY,20291
TURKANA NORTH,Rural,38,1272,1779,3051,Turkana,RIFT VALLEY,20292
TURKANA NORTH,Rural,39,1102,1540,2642,Turkana,RIFT VALLEY,20293
TURKANA NORTH,Rural,40,2372,2452,4824,Turkana,RIFT VALLEY,20294
TURKANA NORTH,Rural,41,645,739,1384,Turkana,RIFT VALLEY,20295
TURKANA NORTH,Rural,42,986,1150,2136,Turkana,RIFT VALLEY,20296
TURKANA NORTH,Rural,43,702,814,1516,Turkana,RIFT VALLEY,20297
TURKANA NORTH,Rural,44,507,544,1051,Turkana,RIFT VALLEY,20298
TURKANA NORTH,Rural,45,1289,1228,2517,Turkana,RIFT VALLEY,20299
TURKANA NORTH,Rural,46,631,642,1273,Turkana,RIFT VALLEY,20300
TURKANA NORTH,Rural,47,547,583,1130,Turkana,RIFT VALLEY,20301
TURKANA NORTH,Rural,48,928,868,1796,Turkana,RIFT VALLEY,20302
TURKANA NORTH,Rural,49,778,854,1632,Turkana,RIFT VALLEY,20303
TURKANA NORTH,Rural,50,1461,1335,2796,Turkana,RIFT VALLEY,20304
TURKANA NORTH,Rural,51,505,527,1032,Turkana,RIFT VALLEY,20305
TURKANA NORTH,Rural,52,669,581,1250,Turkana,RIFT VALLEY,20306
TURKANA NORTH,Rural,53,408,387,795,Turkana,RIFT VALLEY,20307
TURKANA NORTH,Rural,54,452,408,860,Turkana,RIFT VALLEY,20308
TURKANA NORTH,Rural,55,537,502,1039,Turkana,RIFT VALLEY,20309
TURKANA NORTH,Rural,56,483,427,910,Turkana,RIFT VALLEY,20310
TURKANA NORTH,Rural,57,516,575,1091,Turkana,RIFT VALLEY,20311
TURKANA NORTH,Rural,58,448,390,838,Turkana,RIFT VALLEY,20312
TURKANA NORTH,Rural,59,493,424,917,Turkana,RIFT VALLEY,20313
TURKANA NORTH,Rural,60,1170,895,2065,Turkana,RIFT VALLEY,20314
TURKANA NORTH,Rural,61,246,244,490,Turkana,RIFT VALLEY,20315
TURKANA NORTH,Rural,62,373,286,659,Turkana,RIFT VALLEY,20316
TURKANA NORTH,Rural,63,280,230,510,Turkana,RIFT VALLEY,20317
TURKANA NORTH,Rural,64,358,260,618,Turkana,RIFT VALLEY,20318
TURKANA NORTH,Rural,65,427,268,695,Turkana,RIFT VALLEY,20319
TURKANA NORTH,Rural,66,128,111,239,Turkana,RIFT VALLEY,20320
TURKANA NORTH,Rural,67,201,156,357,Turkana,RIFT VALLEY,20321
TURKANA NORTH,Rural,68,343,262,605,Turkana,RIFT VALLEY,20322
TURKANA NORTH,Rural,69,283,267,550,Turkana,RIFT VALLEY,20323
TURKANA NORTH,Rural,70,609,355,964,Turkana,RIFT VALLEY,20324
TURKANA NORTH,Rural,71,115,102,217,Turkana,RIFT VALLEY,20325
TURKANA NORTH,Rural,72,183,127,310,Turkana,RIFT VALLEY,20326
TURKANA NORTH,Rural,73,115,111,226,Turkana,RIFT VALLEY,20327
TURKANA NORTH,Rural,74,83,89,172,Turkana,RIFT VALLEY,20328
TURKANA NORTH,Rural,75,207,140,347,Turkana,RIFT VALLEY,20329
TURKANA NORTH,Rural,76,70,64,134,Turkana,RIFT VALLEY,20330
TURKANA NORTH,Rural,77,52,44,96,Turkana,RIFT VALLEY,20331
TURKANA NORTH,Rural,78,96,86,182,Turkana,RIFT VALLEY,20332
TURKANA NORTH,Rural,79,118,113,231,Turkana,RIFT VALLEY,20333
TURKANA NORTH,Rural,80+,1119,885,2004,Turkana,RIFT VALLEY,20334
TURKANA NORTH,Rural,Age NS,86,52,138,Turkana,RIFT VALLEY,20335
TURKANA SOUTH,Rural,0,2368,2333,4701,Turkana,RIFT VALLEY,20336
TURKANA SOUTH,Rural,1,1719,1618,3337,Turkana,RIFT VALLEY,20337
TURKANA SOUTH,Rural,2,3280,3133,6413,Turkana,RIFT VALLEY,20338
TURKANA SOUTH,Rural,3,3291,3078,6369,Turkana,RIFT VALLEY,20339
TURKANA SOUTH,Rural,4,3719,3367,7086,Turkana,RIFT VALLEY,20340
TURKANA SOUTH,Rural,5,3861,3435,7296,Turkana,RIFT VALLEY,20341
TURKANA SOUTH,Rural,6,4226,3758,7984,Turkana,RIFT VALLEY,20342
TURKANA SOUTH,Rural,7,3648,3254,6902,Turkana,RIFT VALLEY,20343
TURKANA SOUTH,Rural,8,4876,4331,9207,Turkana,RIFT VALLEY,20344
TURKANA SOUTH,Rural,9,3635,3210,6845,Turkana,RIFT VALLEY,20345
TURKANA SOUTH,Rural,10,6398,5632,12030,Turkana,RIFT VALLEY,20346
TURKANA SOUTH,Rural,11,2771,2870,5641,Turkana,RIFT VALLEY,20347
TURKANA SOUTH,Rural,12,5300,3960,9260,Turkana,RIFT VALLEY,20348
TURKANA SOUTH,Rural,13,3647,2703,6350,Turkana,RIFT VALLEY,20349
TURKANA SOUTH,Rural,14,4255,3182,7437,Turkana,RIFT VALLEY,20350
TURKANA SOUTH,Rural,15,4557,3362,7919,Turkana,RIFT VALLEY,20351
TURKANA SOUTH,Rural,16,4180,3107,7287,Turkana,RIFT VALLEY,20352
TURKANA SOUTH,Rural,17,3227,2259,5486,Turkana,RIFT VALLEY,20353
TURKANA SOUTH,Rural,18,4144,3138,7282,Turkana,RIFT VALLEY,20354
TURKANA SOUTH,Rural,19,2362,1622,3984,Turkana,RIFT VALLEY,20355
TURKANA SOUTH,Rural,20,4010,3023,7033,Turkana,RIFT VALLEY,20356
TURKANA SOUTH,Rural,21,1831,1377,3208,Turkana,RIFT VALLEY,20357
TURKANA SOUTH,Rural,22,1944,1516,3460,Turkana,RIFT VALLEY,20358
TURKANA SOUTH,Rural,23,1604,1255,2859,Turkana,RIFT VALLEY,20359
TURKANA SOUTH,Rural,24,1868,1627,3495,Turkana,RIFT VALLEY,20360
TURKANA SOUTH,Rural,25,2148,1916,4064,Turkana,RIFT VALLEY,20361
TURKANA SOUTH,Rural,26,1433,1389,2822,Turkana,RIFT VALLEY,20362
TURKANA SOUTH,Rural,27,1188,1072,2260,Turkana,RIFT VALLEY,20363
TURKANA SOUTH,Rural,28,1613,1788,3401,Turkana,RIFT VALLEY,20364
TURKANA SOUTH,Rural,29,1172,1167,2339,Turkana,RIFT VALLEY,20365
TURKANA SOUTH,Rural,30,2391,2421,4812,Turkana,RIFT VALLEY,20366
TURKANA SOUTH,Rural,31,819,765,1584,Turkana,RIFT VALLEY,20367
TURKANA SOUTH,Rural,32,1158,1338,2496,Turkana,RIFT VALLEY,20368
TURKANA SOUTH,Rural,33,614,757,1371,Turkana,RIFT VALLEY,20369
TURKANA SOUTH,Rural,34,826,896,1722,Turkana,RIFT VALLEY,20370
TURKANA SOUTH,Rural,35,1363,1538,2901,Turkana,RIFT VALLEY,20371
TURKANA SOUTH,Rural,36,999,1206,2205,Turkana,RIFT VALLEY,20372
TURKANA SOUTH,Rural,37,633,790,1423,Turkana,RIFT VALLEY,20373
TURKANA SOUTH,Rural,38,1078,1310,2388,Turkana,RIFT VALLEY,20374
TURKANA SOUTH,Rural,39,839,951,1790,Turkana,RIFT VALLEY,20375
TURKANA SOUTH,Rural,40,1917,1798,3715,Turkana,RIFT VALLEY,20376
TURKANA SOUTH,Rural,41,513,528,1041,Turkana,RIFT VALLEY,20377
TURKANA SOUTH,Rural,42,789,800,1589,Turkana,RIFT VALLEY,20378
TURKANA SOUTH,Rural,43,587,599,1186,Turkana,RIFT VALLEY,20379
TURKANA SOUTH,Rural,44,371,363,734,Turkana,RIFT VALLEY,20380
TURKANA SOUTH,Rural,45,1019,963,1982,Turkana,RIFT VALLEY,20381
TURKANA SOUTH,Rural,46,571,524,1095,Turkana,RIFT VALLEY,20382
TURKANA SOUTH,Rural,47,448,388,836,Turkana,RIFT VALLEY,20383
TURKANA SOUTH,Rural,48,716,647,1363,Turkana,RIFT VALLEY,20384
TURKANA SOUTH,Rural,49,784,604,1388,Turkana,RIFT VALLEY,20385
TURKANA SOUTH,Rural,50,1097,878,1975,Turkana,RIFT VALLEY,20386
TURKANA SOUTH,Rural,51,330,312,642,Turkana,RIFT VALLEY,20387
TURKANA SOUTH,Rural,52,438,351,789,Turkana,RIFT VALLEY,20388
TURKANA SOUTH,Rural,53,308,231,539,Turkana,RIFT VALLEY,20389
TURKANA SOUTH,Rural,54,327,278,605,Turkana,RIFT VALLEY,20390
TURKANA SOUTH,Rural,55,481,380,861,Turkana,RIFT VALLEY,20391
TURKANA SOUTH,Rural,56,364,285,649,Turkana,RIFT VALLEY,20392
TURKANA SOUTH,Rural,57,353,238,591,Turkana,RIFT VALLEY,20393
TURKANA SOUTH,Rural,58,319,244,563,Turkana,RIFT VALLEY,20394
TURKANA SOUTH,Rural,59,332,273,605,Turkana,RIFT VALLEY,20395
TURKANA SOUTH,Rural,60,756,534,1290,Turkana,RIFT VALLEY,20396
TURKANA SOUTH,Rural,61,213,168,381,Turkana,RIFT VALLEY,20397
TURKANA SOUTH,Rural,62,210,150,360,Turkana,RIFT VALLEY,20398
TURKANA SOUTH,Rural,63,145,127,272,Turkana,RIFT VALLEY,20399
TURKANA SOUTH,Rural,64,182,158,340,Turkana,RIFT VALLEY,20400
TURKANA SOUTH,Rural,65,245,176,421,Turkana,RIFT VALLEY,20401
TURKANA SOUTH,Rural,66,108,79,187,Turkana,RIFT VALLEY,20402
TURKANA SOUTH,Rural,67,120,96,216,Turkana,RIFT VALLEY,20403
TURKANA SOUTH,Rural,68,149,110,259,Turkana,RIFT VALLEY,20404
TURKANA SOUTH,Rural,69,178,206,384,Turkana,RIFT VALLEY,20405
TURKANA SOUTH,Rural,70,321,258,579,Turkana,RIFT VALLEY,20406
TURKANA SOUTH,Rural,71,64,47,111,Turkana,RIFT VALLEY,20407
TURKANA SOUTH,Rural,72,102,92,194,Turkana,RIFT VALLEY,20408
TURKANA SOUTH,Rural,73,83,74,157,Turkana,RIFT VALLEY,20409
TURKANA SOUTH,Rural,74,85,74,159,Turkana,RIFT VALLEY,20410
TURKANA SOUTH,Rural,75,121,80,201,Turkana,RIFT VALLEY,20411
TURKANA SOUTH,Rural,76,41,46,87,Turkana,RIFT VALLEY,20412
TURKANA SOUTH,Rural,77,31,33,64,Turkana,RIFT VALLEY,20413
TURKANA SOUTH,Rural,78,66,75,141,Turkana,RIFT VALLEY,20414
TURKANA SOUTH,Rural,79,100,90,190,Turkana,RIFT VALLEY,20415
TURKANA SOUTH,Rural,80+,609,531,1140,Turkana,RIFT VALLEY,20416
TURKANA SOUTH,Rural,Age NS,34,15,49,Turkana,RIFT VALLEY,20417
WEST POKOT,Rural,0,3084,2967,6051,West Pokot,RIFT VALLEY,20418
WEST POKOT,Rural,1,2320,2280,4600,West Pokot,RIFT VALLEY,20419
WEST POKOT,Rural,2,3059,2923,5982,West Pokot,RIFT VALLEY,20420
WEST POKOT,Rural,3,2581,2536,5117,West Pokot,RIFT VALLEY,20421
WEST POKOT,Rural,4,2761,2794,5555,West Pokot,RIFT VALLEY,20422
WEST POKOT,Rural,5,2643,2318,4961,West Pokot,RIFT VALLEY,20423
WEST POKOT,Rural,6,2593,2718,5311,West Pokot,RIFT VALLEY,20424
WEST POKOT,Rural,7,2288,2239,4527,West Pokot,RIFT VALLEY,20425
WEST POKOT,Rural,8,2550,2507,5057,West Pokot,RIFT VALLEY,20426
WEST POKOT,Rural,9,1972,1967,3939,West Pokot,RIFT VALLEY,20427
WEST POKOT,Rural,10,2662,2773,5435,West Pokot,RIFT VALLEY,20428
WEST POKOT,Rural,11,1499,1726,3225,West Pokot,RIFT VALLEY,20429
WEST POKOT,Rural,12,2435,2102,4537,West Pokot,RIFT VALLEY,20430
WEST POKOT,Rural,13,1881,1711,3592,West Pokot,RIFT VALLEY,20431
WEST POKOT,Rural,14,1844,1710,3554,West Pokot,RIFT VALLEY,20432
WEST POKOT,Rural,15,2048,1737,3785,West Pokot,RIFT VALLEY,20433
WEST POKOT,Rural,16,1669,1540,3209,West Pokot,RIFT VALLEY,20434
WEST POKOT,Rural,17,1366,1263,2629,West Pokot,RIFT VALLEY,20435
WEST POKOT,Rural,18,1633,1656,3289,West Pokot,RIFT VALLEY,20436
WEST POKOT,Rural,19,1042,1154,2196,West Pokot,RIFT VALLEY,20437
WEST POKOT,Rural,20,1523,1953,3476,West Pokot,RIFT VALLEY,20438
WEST POKOT,Rural,21,922,993,1915,West Pokot,RIFT VALLEY,20439
WEST POKOT,Rural,22,1113,1185,2298,West Pokot,RIFT VALLEY,20440
WEST POKOT,Rural,23,921,1012,1933,West Pokot,RIFT VALLEY,20441
WEST POKOT,Rural,24,857,967,1824,West Pokot,RIFT VALLEY,20442
WEST POKOT,Rural,25,1531,1582,3113,West Pokot,RIFT VALLEY,20443
WEST POKOT,Rural,26,750,835,1585,West Pokot,RIFT VALLEY,20444
WEST POKOT,Rural,27,763,735,1498,West Pokot,RIFT VALLEY,20445
WEST POKOT,Rural,28,689,905,1594,West Pokot,RIFT VALLEY,20446
WEST POKOT,Rural,29,530,633,1163,West Pokot,RIFT VALLEY,20447
WEST POKOT,Rural,30,1189,1224,2413,West Pokot,RIFT VALLEY,20448
WEST POKOT,Rural,31,540,480,1020,West Pokot,RIFT VALLEY,20449
WEST POKOT,Rural,32,713,811,1524,West Pokot,RIFT VALLEY,20450
WEST POKOT,Rural,33,480,519,999,West Pokot,RIFT VALLEY,20451
WEST POKOT,Rural,34,413,511,924,West Pokot,RIFT VALLEY,20452
WEST POKOT,Rural,35,1029,1012,2041,West Pokot,RIFT VALLEY,20453
WEST POKOT,Rural,36,570,552,1122,West Pokot,RIFT VALLEY,20454
WEST POKOT,Rural,37,460,404,864,West Pokot,RIFT VALLEY,20455
WEST POKOT,Rural,38,416,520,936,West Pokot,RIFT VALLEY,20456
WEST POKOT,Rural,39,377,366,743,West Pokot,RIFT VALLEY,20457
WEST POKOT,Rural,40,847,867,1714,West Pokot,RIFT VALLEY,20458
WEST POKOT,Rural,41,311,316,627,West Pokot,RIFT VALLEY,20459
WEST POKOT,Rural,42,348,377,725,West Pokot,RIFT VALLEY,20460
WEST POKOT,Rural,43,226,275,501,West Pokot,RIFT VALLEY,20461
WEST POKOT,Rural,44,259,307,566,West Pokot,RIFT VALLEY,20462
WEST POKOT,Rural,45,543,596,1139,West Pokot,RIFT VALLEY,20463
WEST POKOT,Rural,46,272,302,574,West Pokot,RIFT VALLEY,20464
WEST POKOT,Rural,47,262,253,515,West Pokot,RIFT VALLEY,20465
WEST POKOT,Rural,48,388,373,761,West Pokot,RIFT VALLEY,20466
WEST POKOT,Rural,49,284,292,576,West Pokot,RIFT VALLEY,20467
WEST POKOT,Rural,50,554,711,1265,West Pokot,RIFT VALLEY,20468
WEST POKOT,Rural,51,198,205,403,West Pokot,RIFT VALLEY,20469
WEST POKOT,Rural,52,212,220,432,West Pokot,RIFT VALLEY,20470
WEST POKOT,Rural,53,155,192,347,West Pokot,RIFT VALLEY,20471
WEST POKOT,Rural,54,165,243,408,West Pokot,RIFT VALLEY,20472
WEST POKOT,Rural,55,349,363,712,West Pokot,RIFT VALLEY,20473
WEST POKOT,Rural,56,182,222,404,West Pokot,RIFT VALLEY,20474
WEST POKOT,Rural,57,204,173,377,West Pokot,RIFT VALLEY,20475
WEST POKOT,Rural,58,146,138,284,West Pokot,RIFT VALLEY,20476
WEST POKOT,Rural,59,211,211,422,West Pokot,RIFT VALLEY,20477
WEST POKOT,Rural,60,444,525,969,West Pokot,RIFT VALLEY,20478
WEST POKOT,Rural,61,112,110,222,West Pokot,RIFT VALLEY,20479
WEST POKOT,Rural,62,96,121,217,West Pokot,RIFT VALLEY,20480
WEST POKOT,Rural,63,78,108,186,West Pokot,RIFT VALLEY,20481
WEST POKOT,Rural,64,106,134,240,West Pokot,RIFT VALLEY,20482
WEST POKOT,Rural,65,246,273,519,West Pokot,RIFT VALLEY,20483
WEST POKOT,Rural,66,69,84,153,West Pokot,RIFT VALLEY,20484
WEST POKOT,Rural,67,83,66,149,West Pokot,RIFT VALLEY,20485
WEST POKOT,Rural,68,76,112,188,West Pokot,RIFT VALLEY,20486
WEST POKOT,Rural,69,83,135,218,West Pokot,RIFT VALLEY,20487
WEST POKOT,Rural,70,223,331,554,West Pokot,RIFT VALLEY,20488
WEST POKOT,Rural,71,42,58,100,West Pokot,RIFT VALLEY,20489
WEST POKOT,Rural,72,57,57,114,West Pokot,RIFT VALLEY,20490
WEST POKOT,Rural,73,47,61,108,West Pokot,RIFT VALLEY,20491
WEST POKOT,Rural,74,49,64,113,West Pokot,RIFT VALLEY,20492
WEST POKOT,Rural,75,109,126,235,West Pokot,RIFT VALLEY,20493
WEST POKOT,Rural,76,34,33,67,West Pokot,RIFT VALLEY,20494
WEST POKOT,Rural,77,29,30,59,West Pokot,RIFT VALLEY,20495
WEST POKOT,Rural,78,36,70,106,West Pokot,RIFT VALLEY,20496
WEST POKOT,Rural,79,53,90,143,West Pokot,RIFT VALLEY,20497
WEST POKOT,Rural,80+,578,828,1406,West Pokot,RIFT VALLEY,20498
WEST POKOT,Rural,Age NS,6,7,13,West Pokot,RIFT VALLEY,20499
POKOT NORTH,Rural,0,2887,2933,5820,West Pokot,RIFT VALLEY,20500
POKOT NORTH,Rural,1,1743,1684,3427,West Pokot,RIFT VALLEY,20501
POKOT NORTH,Rural,2,3475,3464,6939,West Pokot,RIFT VALLEY,20502
POKOT NORTH,Rural,3,2994,2979,5973,West Pokot,RIFT VALLEY,20503
POKOT NORTH,Rural,4,3490,3384,6874,West Pokot,RIFT VALLEY,20504
POKOT NORTH,Rural,5,3119,2894,6013,West Pokot,RIFT VALLEY,20505
POKOT NORTH,Rural,6,3608,3545,7153,West Pokot,RIFT VALLEY,20506
POKOT NORTH,Rural,7,2630,2372,5002,West Pokot,RIFT VALLEY,20507
POKOT NORTH,Rural,8,3849,3629,7478,West Pokot,RIFT VALLEY,20508
POKOT NORTH,Rural,9,2579,2327,4906,West Pokot,RIFT VALLEY,20509
POKOT NORTH,Rural,10,4280,4022,8302,West Pokot,RIFT VALLEY,20510
POKOT NORTH,Rural,11,1803,1916,3719,West Pokot,RIFT VALLEY,20511
POKOT NORTH,Rural,12,3376,2950,6326,West Pokot,RIFT VALLEY,20512
POKOT NORTH,Rural,13,2090,1703,3793,West Pokot,RIFT VALLEY,20513
POKOT NORTH,Rural,14,2549,2035,4584,West Pokot,RIFT VALLEY,20514
POKOT NORTH,Rural,15,2470,1978,4448,West Pokot,RIFT VALLEY,20515
POKOT NORTH,Rural,16,2108,1782,3890,West Pokot,RIFT VALLEY,20516
POKOT NORTH,Rural,17,1411,1113,2524,West Pokot,RIFT VALLEY,20517
POKOT NORTH,Rural,18,2203,1987,4190,West Pokot,RIFT VALLEY,20518
POKOT NORTH,Rural,19,893,940,1833,West Pokot,RIFT VALLEY,20519
POKOT NORTH,Rural,20,2157,2517,4674,West Pokot,RIFT VALLEY,20520
POKOT NORTH,Rural,21,775,870,1645,West Pokot,RIFT VALLEY,20521
POKOT NORTH,Rural,22,897,1093,1990,West Pokot,RIFT VALLEY,20522
POKOT NORTH,Rural,23,800,1053,1853,West Pokot,RIFT VALLEY,20523
POKOT NORTH,Rural,24,890,1184,2074,West Pokot,RIFT VALLEY,20524
POKOT NORTH,Rural,25,1590,2166,3756,West Pokot,RIFT VALLEY,20525
POKOT NORTH,Rural,26,742,943,1685,West Pokot,RIFT VALLEY,20526
POKOT NORTH,Rural,27,654,835,1489,West Pokot,RIFT VALLEY,20527
POKOT NORTH,Rural,28,883,1328,2211,West Pokot,RIFT VALLEY,20528
POKOT NORTH,Rural,29,551,789,1340,West Pokot,RIFT VALLEY,20529
POKOT NORTH,Rural,30,1573,2042,3615,West Pokot,RIFT VALLEY,20530
POKOT NORTH,Rural,31,401,480,881,West Pokot,RIFT VALLEY,20531
POKOT NORTH,Rural,32,655,877,1532,West Pokot,RIFT VALLEY,20532
POKOT NORTH,Rural,33,338,408,746,West Pokot,RIFT VALLEY,20533
POKOT NORTH,Rural,34,403,475,878,West Pokot,RIFT VALLEY,20534
POKOT NORTH,Rural,35,975,1136,2111,West Pokot,RIFT VALLEY,20535
POKOT NORTH,Rural,36,599,788,1387,West Pokot,RIFT VALLEY,20536
POKOT NORTH,Rural,37,430,406,836,West Pokot,RIFT VALLEY,20537
POKOT NORTH,Rural,38,496,620,1116,West Pokot,RIFT VALLEY,20538
POKOT NORTH,Rural,39,348,444,792,West Pokot,RIFT VALLEY,20539
POKOT NORTH,Rural,40,1269,1197,2466,West Pokot,RIFT VALLEY,20540
POKOT NORTH,Rural,41,209,217,426,West Pokot,RIFT VALLEY,20541
POKOT NORTH,Rural,42,352,340,692,West Pokot,RIFT VALLEY,20542
POKOT NORTH,Rural,43,196,203,399,West Pokot,RIFT VALLEY,20543
POKOT NORTH,Rural,44,228,219,447,West Pokot,RIFT VALLEY,20544
POKOT NORTH,Rural,45,653,553,1206,West Pokot,RIFT VALLEY,20545
POKOT NORTH,Rural,46,232,254,486,West Pokot,RIFT VALLEY,20546
POKOT NORTH,Rural,47,186,195,381,West Pokot,RIFT VALLEY,20547
POKOT NORTH,Rural,48,356,379,735,West Pokot,RIFT VALLEY,20548
POKOT NORTH,Rural,49,245,212,457,West Pokot,RIFT VALLEY,20549
POKOT NORTH,Rural,50,684,552,1236,West Pokot,RIFT VALLEY,20550
POKOT NORTH,Rural,51,109,89,198,West Pokot,RIFT VALLEY,20551
POKOT NORTH,Rural,52,201,175,376,West Pokot,RIFT VALLEY,20552
POKOT NORTH,Rural,53,126,127,253,West Pokot,RIFT VALLEY,20553
POKOT NORTH,Rural,54,144,138,282,West Pokot,RIFT VALLEY,20554
POKOT NORTH,Rural,55,237,230,467,West Pokot,RIFT VALLEY,20555
POKOT NORTH,Rural,56,203,183,386,West Pokot,RIFT VALLEY,20556
POKOT NORTH,Rural,57,150,105,255,West Pokot,RIFT VALLEY,20557
POKOT NORTH,Rural,58,119,118,237,West Pokot,RIFT VALLEY,20558
POKOT NORTH,Rural,59,113,118,231,West Pokot,RIFT VALLEY,20559
POKOT NORTH,Rural,60,429,402,831,West Pokot,RIFT VALLEY,20560
POKOT NORTH,Rural,61,79,79,158,West Pokot,RIFT VALLEY,20561
POKOT NORTH,Rural,62,105,99,204,West Pokot,RIFT VALLEY,20562
POKOT NORTH,Rural,63,68,83,151,West Pokot,RIFT VALLEY,20563
POKOT NORTH,Rural,64,87,81,168,West Pokot,RIFT VALLEY,20564
POKOT NORTH,Rural,65,195,178,373,West Pokot,RIFT VALLEY,20565
POKOT NORTH,Rural,66,36,50,86,West Pokot,RIFT VALLEY,20566
POKOT NORTH,Rural,67,40,47,87,West Pokot,RIFT VALLEY,20567
POKOT NORTH,Rural,68,70,76,146,West Pokot,RIFT VALLEY,20568
POKOT NORTH,Rural,69,73,67,140,West Pokot,RIFT VALLEY,20569
POKOT NORTH,Rural,70,205,233,438,West Pokot,RIFT VALLEY,20570
POKOT NORTH,Rural,71,32,24,56,West Pokot,RIFT VALLEY,20571
POKOT NORTH,Rural,72,47,49,96,West Pokot,RIFT VALLEY,20572
POKOT NORTH,Rural,73,22,24,46,West Pokot,RIFT VALLEY,20573
POKOT NORTH,Rural,74,18,30,48,West Pokot,RIFT VALLEY,20574
POKOT NORTH,Rural,75,82,100,182,West Pokot,RIFT VALLEY,20575
POKOT NORTH,Rural,76,27,41,68,West Pokot,RIFT VALLEY,20576
POKOT NORTH,Rural,77,19,14,33,West Pokot,RIFT VALLEY,20577
POKOT NORTH,Rural,78,51,48,99,West Pokot,RIFT VALLEY,20578
POKOT NORTH,Rural,79,37,45,82,West Pokot,RIFT VALLEY,20579
POKOT NORTH,Rural,80+,491,578,1069,West Pokot,RIFT VALLEY,20580
POKOT NORTH,Rural,Age NS,20,9,29,West Pokot,RIFT VALLEY,20581
POKOT CENTRAL,Rural,0,3878,3808,7686,West Pokot,RIFT VALLEY,20582
POKOT CENTRAL,Rural,1,2771,2614,5385,West Pokot,RIFT VALLEY,20583
POKOT CENTRAL,Rural,2,3697,3565,7262,West Pokot,RIFT VALLEY,20584
POKOT CENTRAL,Rural,3,3382,3131,6513,West Pokot,RIFT VALLEY,20585
POKOT CENTRAL,Rural,4,3484,3401,6885,West Pokot,RIFT VALLEY,20586
POKOT CENTRAL,Rural,5,3262,3126,6388,West Pokot,RIFT VALLEY,20587
POKOT CENTRAL,Rural,6,3384,3325,6709,West Pokot,RIFT VALLEY,20588
POKOT CENTRAL,Rural,7,2798,2731,5529,West Pokot,RIFT VALLEY,20589
POKOT CENTRAL,Rural,8,3370,3406,6776,West Pokot,RIFT VALLEY,20590
POKOT CENTRAL,Rural,9,2615,2485,5100,West Pokot,RIFT VALLEY,20591
POKOT CENTRAL,Rural,10,3610,3604,7214,West Pokot,RIFT VALLEY,20592
POKOT CENTRAL,Rural,11,1964,2181,4145,West Pokot,RIFT VALLEY,20593
POKOT CENTRAL,Rural,12,3141,2829,5970,West Pokot,RIFT VALLEY,20594
POKOT CENTRAL,Rural,13,2144,1965,4109,West Pokot,RIFT VALLEY,20595
POKOT CENTRAL,Rural,14,2370,2288,4658,West Pokot,RIFT VALLEY,20596
POKOT CENTRAL,Rural,15,2321,2146,4467,West Pokot,RIFT VALLEY,20597
POKOT CENTRAL,Rural,16,2068,2226,4294,West Pokot,RIFT VALLEY,20598
POKOT CENTRAL,Rural,17,1737,1554,3291,West Pokot,RIFT VALLEY,20599
POKOT CENTRAL,Rural,18,2166,2314,4480,West Pokot,RIFT VALLEY,20600
POKOT CENTRAL,Rural,19,1221,1392,2613,West Pokot,RIFT VALLEY,20601
POKOT CENTRAL,Rural,20,2173,2760,4933,West Pokot,RIFT VALLEY,20602
POKOT CENTRAL,Rural,21,1124,1217,2341,West Pokot,RIFT VALLEY,20603
POKOT CENTRAL,Rural,22,1416,1621,3037,West Pokot,RIFT VALLEY,20604
POKOT CENTRAL,Rural,23,1165,1192,2357,West Pokot,RIFT VALLEY,20605
POKOT CENTRAL,Rural,24,1135,1409,2544,West Pokot,RIFT VALLEY,20606
POKOT CENTRAL,Rural,25,1780,2033,3813,West Pokot,RIFT VALLEY,20607
POKOT CENTRAL,Rural,26,917,1010,1927,West Pokot,RIFT VALLEY,20608
POKOT CENTRAL,Rural,27,896,916,1812,West Pokot,RIFT VALLEY,20609
POKOT CENTRAL,Rural,28,1122,1287,2409,West Pokot,RIFT VALLEY,20610
POKOT CENTRAL,Rural,29,720,669,1389,West Pokot,RIFT VALLEY,20611
POKOT CENTRAL,Rural,30,1749,1804,3553,West Pokot,RIFT VALLEY,20612
POKOT CENTRAL,Rural,31,641,588,1229,West Pokot,RIFT VALLEY,20613
POKOT CENTRAL,Rural,32,970,975,1945,West Pokot,RIFT VALLEY,20614
POKOT CENTRAL,Rural,33,561,495,1056,West Pokot,RIFT VALLEY,20615
POKOT CENTRAL,Rural,34,567,574,1141,West Pokot,RIFT VALLEY,20616
POKOT CENTRAL,Rural,35,1327,1382,2709,West Pokot,RIFT VALLEY,20617
POKOT CENTRAL,Rural,36,599,649,1248,West Pokot,RIFT VALLEY,20618
POKOT CENTRAL,Rural,37,526,517,1043,West Pokot,RIFT VALLEY,20619
POKOT CENTRAL,Rural,38,555,685,1240,West Pokot,RIFT VALLEY,20620
POKOT CENTRAL,Rural,39,441,453,894,West Pokot,RIFT VALLEY,20621
POKOT CENTRAL,Rural,40,1147,1249,2396,West Pokot,RIFT VALLEY,20622
POKOT CENTRAL,Rural,41,405,291,696,West Pokot,RIFT VALLEY,20623
POKOT CENTRAL,Rural,42,418,372,790,West Pokot,RIFT VALLEY,20624
POKOT CENTRAL,Rural,43,291,277,568,West Pokot,RIFT VALLEY,20625
POKOT CENTRAL,Rural,44,301,357,658,West Pokot,RIFT VALLEY,20626
POKOT CENTRAL,Rural,45,688,855,1543,West Pokot,RIFT VALLEY,20627
POKOT CENTRAL,Rural,46,340,342,682,West Pokot,RIFT VALLEY,20628
POKOT CENTRAL,Rural,47,282,251,533,West Pokot,RIFT VALLEY,20629
POKOT CENTRAL,Rural,48,412,482,894,West Pokot,RIFT VALLEY,20630
POKOT CENTRAL,Rural,49,295,316,611,West Pokot,RIFT VALLEY,20631
POKOT CENTRAL,Rural,50,739,938,1677,West Pokot,RIFT VALLEY,20632
POKOT CENTRAL,Rural,51,235,206,441,West Pokot,RIFT VALLEY,20633
POKOT CENTRAL,Rural,52,273,292,565,West Pokot,RIFT VALLEY,20634
POKOT CENTRAL,Rural,53,197,197,394,West Pokot,RIFT VALLEY,20635
POKOT CENTRAL,Rural,54,245,243,488,West Pokot,RIFT VALLEY,20636
POKOT CENTRAL,Rural,55,419,452,871,West Pokot,RIFT VALLEY,20637
POKOT CENTRAL,Rural,56,221,236,457,West Pokot,RIFT VALLEY,20638
POKOT CENTRAL,Rural,57,242,187,429,West Pokot,RIFT VALLEY,20639
POKOT CENTRAL,Rural,58,193,201,394,West Pokot,RIFT VALLEY,20640
POKOT CENTRAL,Rural,59,275,262,537,West Pokot,RIFT VALLEY,20641
POKOT CENTRAL,Rural,60,532,683,1215,West Pokot,RIFT VALLEY,20642
POKOT CENTRAL,Rural,61,163,119,282,West Pokot,RIFT VALLEY,20643
POKOT CENTRAL,Rural,62,130,110,240,West Pokot,RIFT VALLEY,20644
POKOT CENTRAL,Rural,63,118,128,246,West Pokot,RIFT VALLEY,20645
POKOT CENTRAL,Rural,64,151,155,306,West Pokot,RIFT VALLEY,20646
POKOT CENTRAL,Rural,65,322,360,682,West Pokot,RIFT VALLEY,20647
POKOT CENTRAL,Rural,66,123,101,224,West Pokot,RIFT VALLEY,20648
POKOT CENTRAL,Rural,67,106,70,176,West Pokot,RIFT VALLEY,20649
POKOT CENTRAL,Rural,68,98,128,226,West Pokot,RIFT VALLEY,20650
POKOT CENTRAL,Rural,69,161,179,340,West Pokot,RIFT VALLEY,20651
POKOT CENTRAL,Rural,70,343,368,711,West Pokot,RIFT VALLEY,20652
POKOT CENTRAL,Rural,71,60,60,120,West Pokot,RIFT VALLEY,20653
POKOT CENTRAL,Rural,72,71,65,136,West Pokot,RIFT VALLEY,20654
POKOT CENTRAL,Rural,73,72,56,128,West Pokot,RIFT VALLEY,20655
POKOT CENTRAL,Rural,74,51,52,103,West Pokot,RIFT VALLEY,20656
POKOT CENTRAL,Rural,75,156,139,295,West Pokot,RIFT VALLEY,20657
POKOT CENTRAL,Rural,76,52,59,111,West Pokot,RIFT VALLEY,20658
POKOT CENTRAL,Rural,77,33,31,64,West Pokot,RIFT VALLEY,20659
POKOT CENTRAL,Rural,78,73,64,137,West Pokot,RIFT VALLEY,20660
POKOT CENTRAL,Rural,79,89,92,181,West Pokot,RIFT VALLEY,20661
POKOT CENTRAL,Rural,80+,875,1041,1916,West Pokot,RIFT VALLEY,20662
POKOT CENTRAL,Rural,Age NS,35,24,59,West Pokot,RIFT VALLEY,20663
SAMBURU CENTRAL,Rural,0,1949,1891,3840,Samburu,RIFT VALLEY,20664
SAMBURU CENTRAL,Rural,1,1546,1514,3060,Samburu,RIFT VALLEY,20665
SAMBURU CENTRAL,Rural,2,1825,1895,3720,Samburu,RIFT VALLEY,20666
SAMBURU CENTRAL,Rural,3,1846,1775,3621,Samburu,RIFT VALLEY,20667
SAMBURU CENTRAL,Rural,4,1780,1822,3602,Samburu,RIFT VALLEY,20668
SAMBURU CENTRAL,Rural,5,1892,1872,3764,Samburu,RIFT VALLEY,20669
SAMBURU CENTRAL,Rural,6,1654,1512,3166,Samburu,RIFT VALLEY,20670
SAMBURU CENTRAL,Rural,7,1554,1520,3074,Samburu,RIFT VALLEY,20671
SAMBURU CENTRAL,Rural,8,1487,1454,2941,Samburu,RIFT VALLEY,20672
SAMBURU CENTRAL,Rural,9,1241,1214,2455,Samburu,RIFT VALLEY,20673
SAMBURU CENTRAL,Rural,10,1694,1677,3371,Samburu,RIFT VALLEY,20674
SAMBURU CENTRAL,Rural,11,835,966,1801,Samburu,RIFT VALLEY,20675
SAMBURU CENTRAL,Rural,12,1523,1300,2823,Samburu,RIFT VALLEY,20676
SAMBURU CENTRAL,Rural,13,1143,1098,2241,Samburu,RIFT VALLEY,20677
SAMBURU CENTRAL,Rural,14,1054,901,1955,Samburu,RIFT VALLEY,20678
SAMBURU CENTRAL,Rural,15,1210,1020,2230,Samburu,RIFT VALLEY,20679
SAMBURU CENTRAL,Rural,16,967,849,1816,Samburu,RIFT VALLEY,20680
SAMBURU CENTRAL,Rural,17,909,702,1611,Samburu,RIFT VALLEY,20681
SAMBURU CENTRAL,Rural,18,1129,989,2118,Samburu,RIFT VALLEY,20682
SAMBURU CENTRAL,Rural,19,955,862,1817,Samburu,RIFT VALLEY,20683
SAMBURU CENTRAL,Rural,20,1049,1370,2419,Samburu,RIFT VALLEY,20684
SAMBURU CENTRAL,Rural,21,552,737,1289,Samburu,RIFT VALLEY,20685
SAMBURU CENTRAL,Rural,22,598,802,1400,Samburu,RIFT VALLEY,20686
SAMBURU CENTRAL,Rural,23,508,631,1139,Samburu,RIFT VALLEY,20687
SAMBURU CENTRAL,Rural,24,532,649,1181,Samburu,RIFT VALLEY,20688
SAMBURU CENTRAL,Rural,25,779,1150,1929,Samburu,RIFT VALLEY,20689
SAMBURU CENTRAL,Rural,26,435,540,975,Samburu,RIFT VALLEY,20690
SAMBURU CENTRAL,Rural,27,405,453,858,Samburu,RIFT VALLEY,20691
SAMBURU CENTRAL,Rural,28,346,468,814,Samburu,RIFT VALLEY,20692
SAMBURU CENTRAL,Rural,29,282,308,590,Samburu,RIFT VALLEY,20693
SAMBURU CENTRAL,Rural,30,709,807,1516,Samburu,RIFT VALLEY,20694
SAMBURU CENTRAL,Rural,31,279,338,617,Samburu,RIFT VALLEY,20695
SAMBURU CENTRAL,Rural,32,335,400,735,Samburu,RIFT VALLEY,20696
SAMBURU CENTRAL,Rural,33,238,319,557,Samburu,RIFT VALLEY,20697
SAMBURU CENTRAL,Rural,34,234,227,461,Samburu,RIFT VALLEY,20698
SAMBURU CENTRAL,Rural,35,593,705,1298,Samburu,RIFT VALLEY,20699
SAMBURU CENTRAL,Rural,36,293,454,747,Samburu,RIFT VALLEY,20700
SAMBURU CENTRAL,Rural,37,301,332,633,Samburu,RIFT VALLEY,20701
SAMBURU CENTRAL,Rural,38,227,318,545,Samburu,RIFT VALLEY,20702
SAMBURU CENTRAL,Rural,39,186,287,473,Samburu,RIFT VALLEY,20703
SAMBURU CENTRAL,Rural,40,471,655,1126,Samburu,RIFT VALLEY,20704
SAMBURU CENTRAL,Rural,41,118,159,277,Samburu,RIFT VALLEY,20705
SAMBURU CENTRAL,Rural,42,179,192,371,Samburu,RIFT VALLEY,20706
SAMBURU CENTRAL,Rural,43,124,129,253,Samburu,RIFT VALLEY,20707
SAMBURU CENTRAL,Rural,44,156,199,355,Samburu,RIFT VALLEY,20708
SAMBURU CENTRAL,Rural,45,308,384,692,Samburu,RIFT VALLEY,20709
SAMBURU CENTRAL,Rural,46,154,139,293,Samburu,RIFT VALLEY,20710
SAMBURU CENTRAL,Rural,47,146,149,295,Samburu,RIFT VALLEY,20711
SAMBURU CENTRAL,Rural,48,177,164,341,Samburu,RIFT VALLEY,20712
SAMBURU CENTRAL,Rural,49,228,304,532,Samburu,RIFT VALLEY,20713
SAMBURU CENTRAL,Rural,50,398,474,872,Samburu,RIFT VALLEY,20714
SAMBURU CENTRAL,Rural,51,124,137,261,Samburu,RIFT VALLEY,20715
SAMBURU CENTRAL,Rural,52,111,121,232,Samburu,RIFT VALLEY,20716
SAMBURU CENTRAL,Rural,53,98,121,219,Samburu,RIFT VALLEY,20717
SAMBURU CENTRAL,Rural,54,99,129,228,Samburu,RIFT VALLEY,20718
SAMBURU CENTRAL,Rural,55,145,180,325,Samburu,RIFT VALLEY,20719
SAMBURU CENTRAL,Rural,56,101,81,182,Samburu,RIFT VALLEY,20720
SAMBURU CENTRAL,Rural,57,125,135,260,Samburu,RIFT VALLEY,20721
SAMBURU CENTRAL,Rural,58,90,104,194,Samburu,RIFT VALLEY,20722
SAMBURU CENTRAL,Rural,59,95,109,204,Samburu,RIFT VALLEY,20723
SAMBURU CENTRAL,Rural,60,277,327,604,Samburu,RIFT VALLEY,20724
SAMBURU CENTRAL,Rural,61,133,160,293,Samburu,RIFT VALLEY,20725
SAMBURU CENTRAL,Rural,62,74,60,134,Samburu,RIFT VALLEY,20726
SAMBURU CENTRAL,Rural,63,49,66,115,Samburu,RIFT VALLEY,20727
SAMBURU CENTRAL,Rural,64,80,106,186,Samburu,RIFT VALLEY,20728
SAMBURU CENTRAL,Rural,65,167,184,351,Samburu,RIFT VALLEY,20729
SAMBURU CENTRAL,Rural,66,27,25,52,Samburu,RIFT VALLEY,20730
SAMBURU CENTRAL,Rural,67,51,51,102,Samburu,RIFT VALLEY,20731
SAMBURU CENTRAL,Rural,68,47,65,112,Samburu,RIFT VALLEY,20732
SAMBURU CENTRAL,Rural,69,89,76,165,Samburu,RIFT VALLEY,20733
SAMBURU CENTRAL,Rural,70,187,228,415,Samburu,RIFT VALLEY,20734
SAMBURU CENTRAL,Rural,71,41,40,81,Samburu,RIFT VALLEY,20735
SAMBURU CENTRAL,Rural,72,42,40,82,Samburu,RIFT VALLEY,20736
SAMBURU CENTRAL,Rural,73,60,59,119,Samburu,RIFT VALLEY,20737
SAMBURU CENTRAL,Rural,74,42,23,65,Samburu,RIFT VALLEY,20738
SAMBURU CENTRAL,Rural,75,57,78,135,Samburu,RIFT VALLEY,20739
SAMBURU CENTRAL,Rural,76,33,29,62,Samburu,RIFT VALLEY,20740
SAMBURU CENTRAL,Rural,77,39,20,59,Samburu,RIFT VALLEY,20741
SAMBURU CENTRAL,Rural,78,30,27,57,Samburu,RIFT VALLEY,20742
SAMBURU CENTRAL,Rural,79,75,59,134,Samburu,RIFT VALLEY,20743
SAMBURU CENTRAL,Rural,80+,388,452,840,Samburu,RIFT VALLEY,20744
SAMBURU CENTRAL,Rural,Age NS,15,10,25,Samburu,RIFT VALLEY,20745
SAMBURU EAST,Rural,0,943,1018,1961,Samburu,RIFT VALLEY,20746
SAMBURU EAST,Rural,1,696,734,1430,Samburu,RIFT VALLEY,20747
SAMBURU EAST,Rural,2,975,920,1895,Samburu,RIFT VALLEY,20748
SAMBURU EAST,Rural,3,967,989,1956,Samburu,RIFT VALLEY,20749
SAMBURU EAST,Rural,4,911,972,1883,Samburu,RIFT VALLEY,20750
SAMBURU EAST,Rural,5,924,905,1829,Samburu,RIFT VALLEY,20751
SAMBURU EAST,Rural,6,871,837,1708,Samburu,RIFT VALLEY,20752
SAMBURU EAST,Rural,7,816,811,1627,Samburu,RIFT VALLEY,20753
SAMBURU EAST,Rural,8,788,780,1568,Samburu,RIFT VALLEY,20754
SAMBURU EAST,Rural,9,716,708,1424,Samburu,RIFT VALLEY,20755
SAMBURU EAST,Rural,10,983,970,1953,Samburu,RIFT VALLEY,20756
SAMBURU EAST,Rural,11,470,497,967,Samburu,RIFT VALLEY,20757
SAMBURU EAST,Rural,12,882,759,1641,Samburu,RIFT VALLEY,20758
SAMBURU EAST,Rural,13,566,525,1091,Samburu,RIFT VALLEY,20759
SAMBURU EAST,Rural,14,580,513,1093,Samburu,RIFT VALLEY,20760
SAMBURU EAST,Rural,15,653,538,1191,Samburu,RIFT VALLEY,20761
SAMBURU EAST,Rural,16,492,442,934,Samburu,RIFT VALLEY,20762
SAMBURU EAST,Rural,17,433,397,830,Samburu,RIFT VALLEY,20763
SAMBURU EAST,Rural,18,544,481,1025,Samburu,RIFT VALLEY,20764
SAMBURU EAST,Rural,19,413,499,912,Samburu,RIFT VALLEY,20765
SAMBURU EAST,Rural,20,606,620,1226,Samburu,RIFT VALLEY,20766
SAMBURU EAST,Rural,21,271,359,630,Samburu,RIFT VALLEY,20767
SAMBURU EAST,Rural,22,333,412,745,Samburu,RIFT VALLEY,20768
SAMBURU EAST,Rural,23,236,324,560,Samburu,RIFT VALLEY,20769
SAMBURU EAST,Rural,24,315,307,622,Samburu,RIFT VALLEY,20770
SAMBURU EAST,Rural,25,463,587,1050,Samburu,RIFT VALLEY,20771
SAMBURU EAST,Rural,26,232,380,612,Samburu,RIFT VALLEY,20772
SAMBURU EAST,Rural,27,219,301,520,Samburu,RIFT VALLEY,20773
SAMBURU EAST,Rural,28,202,331,533,Samburu,RIFT VALLEY,20774
SAMBURU EAST,Rural,29,138,195,333,Samburu,RIFT VALLEY,20775
SAMBURU EAST,Rural,30,373,450,823,Samburu,RIFT VALLEY,20776
SAMBURU EAST,Rural,31,185,193,378,Samburu,RIFT VALLEY,20777
SAMBURU EAST,Rural,32,218,287,505,Samburu,RIFT VALLEY,20778
SAMBURU EAST,Rural,33,198,201,399,Samburu,RIFT VALLEY,20779
SAMBURU EAST,Rural,34,152,142,294,Samburu,RIFT VALLEY,20780
SAMBURU EAST,Rural,35,377,343,720,Samburu,RIFT VALLEY,20781
SAMBURU EAST,Rural,36,191,216,407,Samburu,RIFT VALLEY,20782
SAMBURU EAST,Rural,37,143,188,331,Samburu,RIFT VALLEY,20783
SAMBURU EAST,Rural,38,164,195,359,Samburu,RIFT VALLEY,20784
SAMBURU EAST,Rural,39,134,169,303,Samburu,RIFT VALLEY,20785
SAMBURU EAST,Rural,40,282,307,589,Samburu,RIFT VALLEY,20786
SAMBURU EAST,Rural,41,96,71,167,Samburu,RIFT VALLEY,20787
SAMBURU EAST,Rural,42,89,138,227,Samburu,RIFT VALLEY,20788
SAMBURU EAST,Rural,43,52,62,114,Samburu,RIFT VALLEY,20789
SAMBURU EAST,Rural,44,54,120,174,Samburu,RIFT VALLEY,20790
SAMBURU EAST,Rural,45,189,165,354,Samburu,RIFT VALLEY,20791
SAMBURU EAST,Rural,46,72,88,160,Samburu,RIFT VALLEY,20792
SAMBURU EAST,Rural,47,68,60,128,Samburu,RIFT VALLEY,20793
SAMBURU EAST,Rural,48,115,128,243,Samburu,RIFT VALLEY,20794
SAMBURU EAST,Rural,49,116,205,321,Samburu,RIFT VALLEY,20795
SAMBURU EAST,Rural,50,180,207,387,Samburu,RIFT VALLEY,20796
SAMBURU EAST,Rural,51,72,89,161,Samburu,RIFT VALLEY,20797
SAMBURU EAST,Rural,52,80,79,159,Samburu,RIFT VALLEY,20798
SAMBURU EAST,Rural,53,47,82,129,Samburu,RIFT VALLEY,20799
SAMBURU EAST,Rural,54,51,62,113,Samburu,RIFT VALLEY,20800
SAMBURU EAST,Rural,55,85,73,158,Samburu,RIFT VALLEY,20801
SAMBURU EAST,Rural,56,53,57,110,Samburu,RIFT VALLEY,20802
SAMBURU EAST,Rural,57,59,86,145,Samburu,RIFT VALLEY,20803
SAMBURU EAST,Rural,58,68,107,175,Samburu,RIFT VALLEY,20804
SAMBURU EAST,Rural,59,53,62,115,Samburu,RIFT VALLEY,20805
SAMBURU EAST,Rural,60,114,146,260,Samburu,RIFT VALLEY,20806
SAMBURU EAST,Rural,61,78,94,172,Samburu,RIFT VALLEY,20807
SAMBURU EAST,Rural,62,49,40,89,Samburu,RIFT VALLEY,20808
SAMBURU EAST,Rural,63,33,35,68,Samburu,RIFT VALLEY,20809
SAMBURU EAST,Rural,64,47,58,105,Samburu,RIFT VALLEY,20810
SAMBURU EAST,Rural,65,89,87,176,Samburu,RIFT VALLEY,20811
SAMBURU EAST,Rural,66,17,25,42,Samburu,RIFT VALLEY,20812
SAMBURU EAST,Rural,67,31,38,69,Samburu,RIFT VALLEY,20813
SAMBURU EAST,Rural,68,32,39,71,Samburu,RIFT VALLEY,20814
SAMBURU EAST,Rural,69,45,46,91,Samburu,RIFT VALLEY,20815
SAMBURU EAST,Rural,70,77,86,163,Samburu,RIFT VALLEY,20816
SAMBURU EAST,Rural,71,14,29,43,Samburu,RIFT VALLEY,20817
SAMBURU EAST,Rural,72,30,36,66,Samburu,RIFT VALLEY,20818
SAMBURU EAST,Rural,73,33,34,67,Samburu,RIFT VALLEY,20819
SAMBURU EAST,Rural,74,19,20,39,Samburu,RIFT VALLEY,20820
SAMBURU EAST,Rural,75,36,35,71,Samburu,RIFT VALLEY,20821
SAMBURU EAST,Rural,76,25,26,51,Samburu,RIFT VALLEY,20822
SAMBURU EAST,Rural,77,15,16,31,Samburu,RIFT VALLEY,20823
SAMBURU EAST,Rural,78,18,13,31,Samburu,RIFT VALLEY,20824
SAMBURU EAST,Rural,79,26,32,58,Samburu,RIFT VALLEY,20825
SAMBURU EAST,Rural,80+,157,250,407,Samburu,RIFT VALLEY,20826
SAMBURU EAST,Rural,Age NS,2,3,5,Samburu,RIFT VALLEY,20827
SAMBURU NORTH,Rural,0,751,776,1527,Samburu,RIFT VALLEY,20828
SAMBURU NORTH,Rural,1,770,725,1495,Samburu,RIFT VALLEY,20829
SAMBURU NORTH,Rural,2,1005,967,1972,Samburu,RIFT VALLEY,20830
SAMBURU NORTH,Rural,3,940,903,1843,Samburu,RIFT VALLEY,20831
SAMBURU NORTH,Rural,4,1000,952,1952,Samburu,RIFT VALLEY,20832
SAMBURU NORTH,Rural,5,900,885,1785,Samburu,RIFT VALLEY,20833
SAMBURU NORTH,Rural,6,1048,896,1944,Samburu,RIFT VALLEY,20834
SAMBURU NORTH,Rural,7,817,809,1626,Samburu,RIFT VALLEY,20835
SAMBURU NORTH,Rural,8,1040,967,2007,Samburu,RIFT VALLEY,20836
SAMBURU NORTH,Rural,9,752,734,1486,Samburu,RIFT VALLEY,20837
SAMBURU NORTH,Rural,10,1366,1175,2541,Samburu,RIFT VALLEY,20838
SAMBURU NORTH,Rural,11,571,554,1125,Samburu,RIFT VALLEY,20839
SAMBURU NORTH,Rural,12,1127,920,2047,Samburu,RIFT VALLEY,20840
SAMBURU NORTH,Rural,13,787,614,1401,Samburu,RIFT VALLEY,20841
SAMBURU NORTH,Rural,14,910,614,1524,Samburu,RIFT VALLEY,20842
SAMBURU NORTH,Rural,15,920,685,1605,Samburu,RIFT VALLEY,20843
SAMBURU NORTH,Rural,16,736,567,1303,Samburu,RIFT VALLEY,20844
SAMBURU NORTH,Rural,17,552,413,965,Samburu,RIFT VALLEY,20845
SAMBURU NORTH,Rural,18,913,625,1538,Samburu,RIFT VALLEY,20846
SAMBURU NORTH,Rural,19,468,371,839,Samburu,RIFT VALLEY,20847
SAMBURU NORTH,Rural,20,944,723,1667,Samburu,RIFT VALLEY,20848
SAMBURU NORTH,Rural,21,386,269,655,Samburu,RIFT VALLEY,20849
SAMBURU NORTH,Rural,22,456,399,855,Samburu,RIFT VALLEY,20850
SAMBURU NORTH,Rural,23,417,369,786,Samburu,RIFT VALLEY,20851
SAMBURU NORTH,Rural,24,505,348,853,Samburu,RIFT VALLEY,20852
SAMBURU NORTH,Rural,25,621,566,1187,Samburu,RIFT VALLEY,20853
SAMBURU NORTH,Rural,26,369,287,656,Samburu,RIFT VALLEY,20854
SAMBURU NORTH,Rural,27,285,204,489,Samburu,RIFT VALLEY,20855
SAMBURU NORTH,Rural,28,503,352,855,Samburu,RIFT VALLEY,20856
SAMBURU NORTH,Rural,29,208,170,378,Samburu,RIFT VALLEY,20857
SAMBURU NORTH,Rural,30,500,476,976,Samburu,RIFT VALLEY,20858
SAMBURU NORTH,Rural,31,151,162,313,Samburu,RIFT VALLEY,20859
SAMBURU NORTH,Rural,32,274,296,570,Samburu,RIFT VALLEY,20860
SAMBURU NORTH,Rural,33,146,162,308,Samburu,RIFT VALLEY,20861
SAMBURU NORTH,Rural,34,154,150,304,Samburu,RIFT VALLEY,20862
SAMBURU NORTH,Rural,35,376,314,690,Samburu,RIFT VALLEY,20863
SAMBURU NORTH,Rural,36,190,226,416,Samburu,RIFT VALLEY,20864
SAMBURU NORTH,Rural,37,131,151,282,Samburu,RIFT VALLEY,20865
SAMBURU NORTH,Rural,38,224,239,463,Samburu,RIFT VALLEY,20866
SAMBURU NORTH,Rural,39,108,118,226,Samburu,RIFT VALLEY,20867
SAMBURU NORTH,Rural,40,327,351,678,Samburu,RIFT VALLEY,20868
SAMBURU NORTH,Rural,41,84,110,194,Samburu,RIFT VALLEY,20869
SAMBURU NORTH,Rural,42,148,151,299,Samburu,RIFT VALLEY,20870
SAMBURU NORTH,Rural,43,93,84,177,Samburu,RIFT VALLEY,20871
SAMBURU NORTH,Rural,44,81,99,180,Samburu,RIFT VALLEY,20872
SAMBURU NORTH,Rural,45,226,172,398,Samburu,RIFT VALLEY,20873
SAMBURU NORTH,Rural,46,106,73,179,Samburu,RIFT VALLEY,20874
SAMBURU NORTH,Rural,47,84,70,154,Samburu,RIFT VALLEY,20875
SAMBURU NORTH,Rural,48,152,109,261,Samburu,RIFT VALLEY,20876
SAMBURU NORTH,Rural,49,132,128,260,Samburu,RIFT VALLEY,20877
SAMBURU NORTH,Rural,50,200,223,423,Samburu,RIFT VALLEY,20878
SAMBURU NORTH,Rural,51,52,54,106,Samburu,RIFT VALLEY,20879
SAMBURU NORTH,Rural,52,101,67,168,Samburu,RIFT VALLEY,20880
SAMBURU NORTH,Rural,53,45,43,88,Samburu,RIFT VALLEY,20881
SAMBURU NORTH,Rural,54,57,66,123,Samburu,RIFT VALLEY,20882
SAMBURU NORTH,Rural,55,100,70,170,Samburu,RIFT VALLEY,20883
SAMBURU NORTH,Rural,56,69,67,136,Samburu,RIFT VALLEY,20884
SAMBURU NORTH,Rural,57,55,33,88,Samburu,RIFT VALLEY,20885
SAMBURU NORTH,Rural,58,70,54,124,Samburu,RIFT VALLEY,20886
SAMBURU NORTH,Rural,59,52,68,120,Samburu,RIFT VALLEY,20887
SAMBURU NORTH,Rural,60,180,168,348,Samburu,RIFT VALLEY,20888
SAMBURU NORTH,Rural,61,63,70,133,Samburu,RIFT VALLEY,20889
SAMBURU NORTH,Rural,62,46,36,82,Samburu,RIFT VALLEY,20890
SAMBURU NORTH,Rural,63,36,27,63,Samburu,RIFT VALLEY,20891
SAMBURU NORTH,Rural,64,40,36,76,Samburu,RIFT VALLEY,20892
SAMBURU NORTH,Rural,65,86,73,159,Samburu,RIFT VALLEY,20893
SAMBURU NORTH,Rural,66,17,9,26,Samburu,RIFT VALLEY,20894
SAMBURU NORTH,Rural,67,34,21,55,Samburu,RIFT VALLEY,20895
SAMBURU NORTH,Rural,68,34,28,62,Samburu,RIFT VALLEY,20896
SAMBURU NORTH,Rural,69,56,33,89,Samburu,RIFT VALLEY,20897
SAMBURU NORTH,Rural,70,123,104,227,Samburu,RIFT VALLEY,20898
SAMBURU NORTH,Rural,71,24,24,48,Samburu,RIFT VALLEY,20899
SAMBURU NORTH,Rural,72,29,17,46,Samburu,RIFT VALLEY,20900
SAMBURU NORTH,Rural,73,25,19,44,Samburu,RIFT VALLEY,20901
SAMBURU NORTH,Rural,74,22,11,33,Samburu,RIFT VALLEY,20902
SAMBURU NORTH,Rural,75,30,40,70,Samburu,RIFT VALLEY,20903
SAMBURU NORTH,Rural,76,18,14,32,Samburu,RIFT VALLEY,20904
SAMBURU NORTH,Rural,77,12,11,23,Samburu,RIFT VALLEY,20905
SAMBURU NORTH,Rural,78,13,12,25,Samburu,RIFT VALLEY,20906
SAMBURU NORTH,Rural,79,37,30,67,Samburu,RIFT VALLEY,20907
SAMBURU NORTH,Rural,80+,157,148,305,Samburu,RIFT VALLEY,20908
SAMBURU NORTH,Rural,Age NS,9,7,16,Samburu,RIFT VALLEY,20909
TRANS NZOIA WEST,Rural,0,4382,4367,8749,Trans Nzoia,RIFT VALLEY,20910
TRANS NZOIA WEST,Rural,1,3780,3726,7506,Trans Nzoia,RIFT VALLEY,20911
TRANS NZOIA WEST,Rural,2,4393,4268,8661,Trans Nzoia,RIFT VALLEY,20912
TRANS NZOIA WEST,Rural,3,4165,4319,8484,Trans Nzoia,RIFT VALLEY,20913
TRANS NZOIA WEST,Rural,4,4246,4140,8386,Trans Nzoia,RIFT VALLEY,20914
TRANS NZOIA WEST,Rural,5,4472,4178,8650,Trans Nzoia,RIFT VALLEY,20915
TRANS NZOIA WEST,Rural,6,4064,3970,8034,Trans Nzoia,RIFT VALLEY,20916
TRANS NZOIA WEST,Rural,7,3979,3906,7885,Trans Nzoia,RIFT VALLEY,20917
TRANS NZOIA WEST,Rural,8,3640,3731,7371,Trans Nzoia,RIFT VALLEY,20918
TRANS NZOIA WEST,Rural,9,3946,3877,7823,Trans Nzoia,RIFT VALLEY,20919
TRANS NZOIA WEST,Rural,10,3953,3781,7734,Trans Nzoia,RIFT VALLEY,20920
TRANS NZOIA WEST,Rural,11,2971,2926,5897,Trans Nzoia,RIFT VALLEY,20921
TRANS NZOIA WEST,Rural,12,3735,3562,7297,Trans Nzoia,RIFT VALLEY,20922
TRANS NZOIA WEST,Rural,13,3536,3412,6948,Trans Nzoia,RIFT VALLEY,20923
TRANS NZOIA WEST,Rural,14,3089,3185,6274,Trans Nzoia,RIFT VALLEY,20924
TRANS NZOIA WEST,Rural,15,3048,2952,6000,Trans Nzoia,RIFT VALLEY,20925
TRANS NZOIA WEST,Rural,16,2861,2816,5677,Trans Nzoia,RIFT VALLEY,20926
TRANS NZOIA WEST,Rural,17,2952,2601,5553,Trans Nzoia,RIFT VALLEY,20927
TRANS NZOIA WEST,Rural,18,2727,2459,5186,Trans Nzoia,RIFT VALLEY,20928
TRANS NZOIA WEST,Rural,19,2330,2174,4504,Trans Nzoia,RIFT VALLEY,20929
TRANS NZOIA WEST,Rural,20,2369,2685,5054,Trans Nzoia,RIFT VALLEY,20930
TRANS NZOIA WEST,Rural,21,1886,1972,3858,Trans Nzoia,RIFT VALLEY,20931
TRANS NZOIA WEST,Rural,22,1951,2384,4335,Trans Nzoia,RIFT VALLEY,20932
TRANS NZOIA WEST,Rural,23,1859,2101,3960,Trans Nzoia,RIFT VALLEY,20933
TRANS NZOIA WEST,Rural,24,1642,1918,3560,Trans Nzoia,RIFT VALLEY,20934
TRANS NZOIA WEST,Rural,25,1984,2193,4177,Trans Nzoia,RIFT VALLEY,20935
TRANS NZOIA WEST,Rural,26,1431,1554,2985,Trans Nzoia,RIFT VALLEY,20936
TRANS NZOIA WEST,Rural,27,1475,1605,3080,Trans Nzoia,RIFT VALLEY,20937
TRANS NZOIA WEST,Rural,28,1311,1533,2844,Trans Nzoia,RIFT VALLEY,20938
TRANS NZOIA WEST,Rural,29,1265,1410,2675,Trans Nzoia,RIFT VALLEY,20939
TRANS NZOIA WEST,Rural,30,1618,1920,3538,Trans Nzoia,RIFT VALLEY,20940
TRANS NZOIA WEST,Rural,31,1141,1121,2262,Trans Nzoia,RIFT VALLEY,20941
TRANS NZOIA WEST,Rural,32,1340,1496,2836,Trans Nzoia,RIFT VALLEY,20942
TRANS NZOIA WEST,Rural,33,1058,1112,2170,Trans Nzoia,RIFT VALLEY,20943
TRANS NZOIA WEST,Rural,34,1083,1066,2149,Trans Nzoia,RIFT VALLEY,20944
TRANS NZOIA WEST,Rural,35,1539,1603,3142,Trans Nzoia,RIFT VALLEY,20945
TRANS NZOIA WEST,Rural,36,924,989,1913,Trans Nzoia,RIFT VALLEY,20946
TRANS NZOIA WEST,Rural,37,956,993,1949,Trans Nzoia,RIFT VALLEY,20947
TRANS NZOIA WEST,Rural,38,858,973,1831,Trans Nzoia,RIFT VALLEY,20948
TRANS NZOIA WEST,Rural,39,873,921,1794,Trans Nzoia,RIFT VALLEY,20949
TRANS NZOIA WEST,Rural,40,1072,1270,2342,Trans Nzoia,RIFT VALLEY,20950
TRANS NZOIA WEST,Rural,41,654,708,1362,Trans Nzoia,RIFT VALLEY,20951
TRANS NZOIA WEST,Rural,42,728,838,1566,Trans Nzoia,RIFT VALLEY,20952
TRANS NZOIA WEST,Rural,43,640,723,1363,Trans Nzoia,RIFT VALLEY,20953
TRANS NZOIA WEST,Rural,44,582,687,1269,Trans Nzoia,RIFT VALLEY,20954
TRANS NZOIA WEST,Rural,45,862,1066,1928,Trans Nzoia,RIFT VALLEY,20955
TRANS NZOIA WEST,Rural,46,622,665,1287,Trans Nzoia,RIFT VALLEY,20956
TRANS NZOIA WEST,Rural,47,632,759,1391,Trans Nzoia,RIFT VALLEY,20957
TRANS NZOIA WEST,Rural,48,557,692,1249,Trans Nzoia,RIFT VALLEY,20958
TRANS NZOIA WEST,Rural,49,721,781,1502,Trans Nzoia,RIFT VALLEY,20959
TRANS NZOIA WEST,Rural,50,753,809,1562,Trans Nzoia,RIFT VALLEY,20960
TRANS NZOIA WEST,Rural,51,473,577,1050,Trans Nzoia,RIFT VALLEY,20961
TRANS NZOIA WEST,Rural,52,481,585,1066,Trans Nzoia,RIFT VALLEY,20962
TRANS NZOIA WEST,Rural,53,477,575,1052,Trans Nzoia,RIFT VALLEY,20963
TRANS NZOIA WEST,Rural,54,448,517,965,Trans Nzoia,RIFT VALLEY,20964
TRANS NZOIA WEST,Rural,55,541,625,1166,Trans Nzoia,RIFT VALLEY,20965
TRANS NZOIA WEST,Rural,56,382,467,849,Trans Nzoia,RIFT VALLEY,20966
TRANS NZOIA WEST,Rural,57,491,535,1026,Trans Nzoia,RIFT VALLEY,20967
TRANS NZOIA WEST,Rural,58,279,309,588,Trans Nzoia,RIFT VALLEY,20968
TRANS NZOIA WEST,Rural,59,455,405,860,Trans Nzoia,RIFT VALLEY,20969
TRANS NZOIA WEST,Rural,60,476,447,923,Trans Nzoia,RIFT VALLEY,20970
TRANS NZOIA WEST,Rural,61,370,374,744,Trans Nzoia,RIFT VALLEY,20971
TRANS NZOIA WEST,Rural,62,293,285,578,Trans Nzoia,RIFT VALLEY,20972
TRANS NZOIA WEST,Rural,63,284,270,554,Trans Nzoia,RIFT VALLEY,20973
TRANS NZOIA WEST,Rural,64,264,249,513,Trans Nzoia,RIFT VALLEY,20974
TRANS NZOIA WEST,Rural,65,292,317,609,Trans Nzoia,RIFT VALLEY,20975
TRANS NZOIA WEST,Rural,66,185,260,445,Trans Nzoia,RIFT VALLEY,20976
TRANS NZOIA WEST,Rural,67,239,311,550,Trans Nzoia,RIFT VALLEY,20977
TRANS NZOIA WEST,Rural,68,166,168,334,Trans Nzoia,RIFT VALLEY,20978
TRANS NZOIA WEST,Rural,69,173,200,373,Trans Nzoia,RIFT VALLEY,20979
TRANS NZOIA WEST,Rural,70,260,316,576,Trans Nzoia,RIFT VALLEY,20980
TRANS NZOIA WEST,Rural,71,142,166,308,Trans Nzoia,RIFT VALLEY,20981
TRANS NZOIA WEST,Rural,72,177,167,344,Trans Nzoia,RIFT VALLEY,20982
TRANS NZOIA WEST,Rural,73,201,202,403,Trans Nzoia,RIFT VALLEY,20983
TRANS NZOIA WEST,Rural,74,104,118,222,Trans Nzoia,RIFT VALLEY,20984
TRANS NZOIA WEST,Rural,75,173,182,355,Trans Nzoia,RIFT VALLEY,20985
TRANS NZOIA WEST,Rural,76,116,125,241,Trans Nzoia,RIFT VALLEY,20986
TRANS NZOIA WEST,Rural,77,170,195,365,Trans Nzoia,RIFT VALLEY,20987
TRANS NZOIA WEST,Rural,78,81,84,165,Trans Nzoia,RIFT VALLEY,20988
TRANS NZOIA WEST,Rural,79,101,158,259,Trans Nzoia,RIFT VALLEY,20989
TRANS NZOIA WEST,Rural,80+,781,991,1772,Trans Nzoia,RIFT VALLEY,20990
TRANS NZOIA WEST,Rural,Age NS,24,23,47,Trans Nzoia,RIFT VALLEY,20991
TRANS NZOIA EAST,Rural,0,3351,3248,6599,Trans Nzoia,RIFT VALLEY,20992
TRANS NZOIA EAST,Rural,1,3181,2983,6164,Trans Nzoia,RIFT VALLEY,20993
TRANS NZOIA EAST,Rural,2,3415,3405,6820,Trans Nzoia,RIFT VALLEY,20994
TRANS NZOIA EAST,Rural,3,3344,3285,6629,Trans Nzoia,RIFT VALLEY,20995
TRANS NZOIA EAST,Rural,4,3570,3303,6873,Trans Nzoia,RIFT VALLEY,20996
TRANS NZOIA EAST,Rural,5,3456,3306,6762,Trans Nzoia,RIFT VALLEY,20997
TRANS NZOIA EAST,Rural,6,3197,3352,6549,Trans Nzoia,RIFT VALLEY,20998
TRANS NZOIA EAST,Rural,7,3202,3179,6381,Trans Nzoia,RIFT VALLEY,20999
TRANS NZOIA EAST,Rural,8,3127,3110,6237,Trans Nzoia,RIFT VALLEY,21000
TRANS NZOIA EAST,Rural,9,3253,3061,6314,Trans Nzoia,RIFT VALLEY,21001
TRANS NZOIA EAST,Rural,10,3290,3252,6542,Trans Nzoia,RIFT VALLEY,21002
TRANS NZOIA EAST,Rural,11,2434,2514,4948,Trans Nzoia,RIFT VALLEY,21003
TRANS NZOIA EAST,Rural,12,3082,2987,6069,Trans Nzoia,RIFT VALLEY,21004
TRANS NZOIA EAST,Rural,13,2750,2724,5474,Trans Nzoia,RIFT VALLEY,21005
TRANS NZOIA EAST,Rural,14,2512,2550,5062,Trans Nzoia,RIFT VALLEY,21006
TRANS NZOIA EAST,Rural,15,2427,2480,4907,Trans Nzoia,RIFT VALLEY,21007
TRANS NZOIA EAST,Rural,16,2336,2235,4571,Trans Nzoia,RIFT VALLEY,21008
TRANS NZOIA EAST,Rural,17,2372,2110,4482,Trans Nzoia,RIFT VALLEY,21009
TRANS NZOIA EAST,Rural,18,2343,2109,4452,Trans Nzoia,RIFT VALLEY,21010
TRANS NZOIA EAST,Rural,19,1832,1777,3609,Trans Nzoia,RIFT VALLEY,21011
TRANS NZOIA EAST,Rural,20,2054,2302,4356,Trans Nzoia,RIFT VALLEY,21012
TRANS NZOIA EAST,Rural,21,1459,1546,3005,Trans Nzoia,RIFT VALLEY,21013
TRANS NZOIA EAST,Rural,22,1607,1861,3468,Trans Nzoia,RIFT VALLEY,21014
TRANS NZOIA EAST,Rural,23,1425,1622,3047,Trans Nzoia,RIFT VALLEY,21015
TRANS NZOIA EAST,Rural,24,1423,1623,3046,Trans Nzoia,RIFT VALLEY,21016
TRANS NZOIA EAST,Rural,25,1643,1922,3565,Trans Nzoia,RIFT VALLEY,21017
TRANS NZOIA EAST,Rural,26,1171,1359,2530,Trans Nzoia,RIFT VALLEY,21018
TRANS NZOIA EAST,Rural,27,1271,1313,2584,Trans Nzoia,RIFT VALLEY,21019
TRANS NZOIA EAST,Rural,28,1061,1389,2450,Trans Nzoia,RIFT VALLEY,21020
TRANS NZOIA EAST,Rural,29,957,1060,2017,Trans Nzoia,RIFT VALLEY,21021
TRANS NZOIA EAST,Rural,30,1512,1819,3331,Trans Nzoia,RIFT VALLEY,21022
TRANS NZOIA EAST,Rural,31,908,960,1868,Trans Nzoia,RIFT VALLEY,21023
TRANS NZOIA EAST,Rural,32,1185,1276,2461,Trans Nzoia,RIFT VALLEY,21024
TRANS NZOIA EAST,Rural,33,864,848,1712,Trans Nzoia,RIFT VALLEY,21025
TRANS NZOIA EAST,Rural,34,863,805,1668,Trans Nzoia,RIFT VALLEY,21026
TRANS NZOIA EAST,Rural,35,1362,1390,2752,Trans Nzoia,RIFT VALLEY,21027
TRANS NZOIA EAST,Rural,36,718,823,1541,Trans Nzoia,RIFT VALLEY,21028
TRANS NZOIA EAST,Rural,37,759,838,1597,Trans Nzoia,RIFT VALLEY,21029
TRANS NZOIA EAST,Rural,38,705,813,1518,Trans Nzoia,RIFT VALLEY,21030
TRANS NZOIA EAST,Rural,39,659,746,1405,Trans Nzoia,RIFT VALLEY,21031
TRANS NZOIA EAST,Rural,40,1083,1169,2252,Trans Nzoia,RIFT VALLEY,21032
TRANS NZOIA EAST,Rural,41,556,520,1076,Trans Nzoia,RIFT VALLEY,21033
TRANS NZOIA EAST,Rural,42,606,671,1277,Trans Nzoia,RIFT VALLEY,21034
TRANS NZOIA EAST,Rural,43,433,554,987,Trans Nzoia,RIFT VALLEY,21035
TRANS NZOIA EAST,Rural,44,453,529,982,Trans Nzoia,RIFT VALLEY,21036
TRANS NZOIA EAST,Rural,45,887,934,1821,Trans Nzoia,RIFT VALLEY,21037
TRANS NZOIA EAST,Rural,46,502,594,1096,Trans Nzoia,RIFT VALLEY,21038
TRANS NZOIA EAST,Rural,47,532,566,1098,Trans Nzoia,RIFT VALLEY,21039
TRANS NZOIA EAST,Rural,48,531,611,1142,Trans Nzoia,RIFT VALLEY,21040
TRANS NZOIA EAST,Rural,49,490,558,1048,Trans Nzoia,RIFT VALLEY,21041
TRANS NZOIA EAST,Rural,50,733,786,1519,Trans Nzoia,RIFT VALLEY,21042
TRANS NZOIA EAST,Rural,51,392,372,764,Trans Nzoia,RIFT VALLEY,21043
TRANS NZOIA EAST,Rural,52,442,400,842,Trans Nzoia,RIFT VALLEY,21044
TRANS NZOIA EAST,Rural,53,386,338,724,Trans Nzoia,RIFT VALLEY,21045
TRANS NZOIA EAST,Rural,54,365,317,682,Trans Nzoia,RIFT VALLEY,21046
TRANS NZOIA EAST,Rural,55,471,522,993,Trans Nzoia,RIFT VALLEY,21047
TRANS NZOIA EAST,Rural,56,328,335,663,Trans Nzoia,RIFT VALLEY,21048
TRANS NZOIA EAST,Rural,57,415,372,787,Trans Nzoia,RIFT VALLEY,21049
TRANS NZOIA EAST,Rural,58,236,232,468,Trans Nzoia,RIFT VALLEY,21050
TRANS NZOIA EAST,Rural,59,310,275,585,Trans Nzoia,RIFT VALLEY,21051
TRANS NZOIA EAST,Rural,60,474,503,977,Trans Nzoia,RIFT VALLEY,21052
TRANS NZOIA EAST,Rural,61,294,260,554,Trans Nzoia,RIFT VALLEY,21053
TRANS NZOIA EAST,Rural,62,217,174,391,Trans Nzoia,RIFT VALLEY,21054
TRANS NZOIA EAST,Rural,63,226,200,426,Trans Nzoia,RIFT VALLEY,21055
TRANS NZOIA EAST,Rural,64,187,202,389,Trans Nzoia,RIFT VALLEY,21056
TRANS NZOIA EAST,Rural,65,299,319,618,Trans Nzoia,RIFT VALLEY,21057
TRANS NZOIA EAST,Rural,66,161,198,359,Trans Nzoia,RIFT VALLEY,21058
TRANS NZOIA EAST,Rural,67,203,196,399,Trans Nzoia,RIFT VALLEY,21059
TRANS NZOIA EAST,Rural,68,132,134,266,Trans Nzoia,RIFT VALLEY,21060
TRANS NZOIA EAST,Rural,69,143,194,337,Trans Nzoia,RIFT VALLEY,21061
TRANS NZOIA EAST,Rural,70,284,343,627,Trans Nzoia,RIFT VALLEY,21062
TRANS NZOIA EAST,Rural,71,100,97,197,Trans Nzoia,RIFT VALLEY,21063
TRANS NZOIA EAST,Rural,72,127,107,234,Trans Nzoia,RIFT VALLEY,21064
TRANS NZOIA EAST,Rural,73,146,115,261,Trans Nzoia,RIFT VALLEY,21065
TRANS NZOIA EAST,Rural,74,103,83,186,Trans Nzoia,RIFT VALLEY,21066
TRANS NZOIA EAST,Rural,75,123,162,285,Trans Nzoia,RIFT VALLEY,21067
TRANS NZOIA EAST,Rural,76,91,87,178,Trans Nzoia,RIFT VALLEY,21068
TRANS NZOIA EAST,Rural,77,92,106,198,Trans Nzoia,RIFT VALLEY,21069
TRANS NZOIA EAST,Rural,78,95,90,185,Trans Nzoia,RIFT VALLEY,21070
TRANS NZOIA EAST,Rural,79,101,111,212,Trans Nzoia,RIFT VALLEY,21071
TRANS NZOIA EAST,Rural,80+,734,916,1650,Trans Nzoia,RIFT VALLEY,21072
TRANS NZOIA EAST,Rural,Age NS,33,40,73,Trans Nzoia,RIFT VALLEY,21073
KWANZA,Rural,0,4334,4178,8512,Trans Nzoia,RIFT VALLEY,21074
KWANZA,Rural,1,3669,3542,7211,Trans Nzoia,RIFT VALLEY,21075
KWANZA,Rural,2,4115,4036,8151,Trans Nzoia,RIFT VALLEY,21076
KWANZA,Rural,3,4049,3935,7984,Trans Nzoia,RIFT VALLEY,21077
KWANZA,Rural,4,3997,3924,7921,Trans Nzoia,RIFT VALLEY,21078
KWANZA,Rural,5,4012,4031,8043,Trans Nzoia,RIFT VALLEY,21079
KWANZA,Rural,6,3772,3779,7551,Trans Nzoia,RIFT VALLEY,21080
KWANZA,Rural,7,3747,3625,7372,Trans Nzoia,RIFT VALLEY,21081
KWANZA,Rural,8,3371,3614,6985,Trans Nzoia,RIFT VALLEY,21082
KWANZA,Rural,9,3494,3412,6906,Trans Nzoia,RIFT VALLEY,21083
KWANZA,Rural,10,3575,3588,7163,Trans Nzoia,RIFT VALLEY,21084
KWANZA,Rural,11,2585,2602,5187,Trans Nzoia,RIFT VALLEY,21085
KWANZA,Rural,12,3332,3197,6529,Trans Nzoia,RIFT VALLEY,21086
KWANZA,Rural,13,2892,2932,5824,Trans Nzoia,RIFT VALLEY,21087
KWANZA,Rural,14,2689,2685,5374,Trans Nzoia,RIFT VALLEY,21088
KWANZA,Rural,15,2612,2574,5186,Trans Nzoia,RIFT VALLEY,21089
KWANZA,Rural,16,2489,2258,4747,Trans Nzoia,RIFT VALLEY,21090
KWANZA,Rural,17,2568,2307,4875,Trans Nzoia,RIFT VALLEY,21091
KWANZA,Rural,18,2520,2263,4783,Trans Nzoia,RIFT VALLEY,21092
KWANZA,Rural,19,2157,2090,4247,Trans Nzoia,RIFT VALLEY,21093
KWANZA,Rural,20,2193,2564,4757,Trans Nzoia,RIFT VALLEY,21094
KWANZA,Rural,21,1728,1779,3507,Trans Nzoia,RIFT VALLEY,21095
KWANZA,Rural,22,1847,2180,4027,Trans Nzoia,RIFT VALLEY,21096
KWANZA,Rural,23,1716,1869,3585,Trans Nzoia,RIFT VALLEY,21097
KWANZA,Rural,24,1695,1842,3537,Trans Nzoia,RIFT VALLEY,21098
KWANZA,Rural,25,2005,2133,4138,Trans Nzoia,RIFT VALLEY,21099
KWANZA,Rural,26,1459,1466,2925,Trans Nzoia,RIFT VALLEY,21100
KWANZA,Rural,27,1461,1496,2957,Trans Nzoia,RIFT VALLEY,21101
KWANZA,Rural,28,1276,1318,2594,Trans Nzoia,RIFT VALLEY,21102
KWANZA,Rural,29,1253,1217,2470,Trans Nzoia,RIFT VALLEY,21103
KWANZA,Rural,30,1691,1771,3462,Trans Nzoia,RIFT VALLEY,21104
KWANZA,Rural,31,1081,991,2072,Trans Nzoia,RIFT VALLEY,21105
KWANZA,Rural,32,1333,1257,2590,Trans Nzoia,RIFT VALLEY,21106
KWANZA,Rural,33,943,938,1881,Trans Nzoia,RIFT VALLEY,21107
KWANZA,Rural,34,1033,943,1976,Trans Nzoia,RIFT VALLEY,21108
KWANZA,Rural,35,1437,1333,2770,Trans Nzoia,RIFT VALLEY,21109
KWANZA,Rural,36,857,810,1667,Trans Nzoia,RIFT VALLEY,21110
KWANZA,Rural,37,783,874,1657,Trans Nzoia,RIFT VALLEY,21111
KWANZA,Rural,38,782,850,1632,Trans Nzoia,RIFT VALLEY,21112
KWANZA,Rural,39,765,748,1513,Trans Nzoia,RIFT VALLEY,21113
KWANZA,Rural,40,1089,1175,2264,Trans Nzoia,RIFT VALLEY,21114
KWANZA,Rural,41,578,596,1174,Trans Nzoia,RIFT VALLEY,21115
KWANZA,Rural,42,688,694,1382,Trans Nzoia,RIFT VALLEY,21116
KWANZA,Rural,43,562,642,1204,Trans Nzoia,RIFT VALLEY,21117
KWANZA,Rural,44,466,544,1010,Trans Nzoia,RIFT VALLEY,21118
KWANZA,Rural,45,792,873,1665,Trans Nzoia,RIFT VALLEY,21119
KWANZA,Rural,46,520,609,1129,Trans Nzoia,RIFT VALLEY,21120
KWANZA,Rural,47,536,634,1170,Trans Nzoia,RIFT VALLEY,21121
KWANZA,Rural,48,467,547,1014,Trans Nzoia,RIFT VALLEY,21122
KWANZA,Rural,49,616,586,1202,Trans Nzoia,RIFT VALLEY,21123
KWANZA,Rural,50,714,759,1473,Trans Nzoia,RIFT VALLEY,21124
KWANZA,Rural,51,456,455,911,Trans Nzoia,RIFT VALLEY,21125
KWANZA,Rural,52,443,474,917,Trans Nzoia,RIFT VALLEY,21126
KWANZA,Rural,53,440,453,893,Trans Nzoia,RIFT VALLEY,21127
KWANZA,Rural,54,409,454,863,Trans Nzoia,RIFT VALLEY,21128
KWANZA,Rural,55,499,501,1000,Trans Nzoia,RIFT VALLEY,21129
KWANZA,Rural,56,367,366,733,Trans Nzoia,RIFT VALLEY,21130
KWANZA,Rural,57,432,356,788,Trans Nzoia,RIFT VALLEY,21131
KWANZA,Rural,58,238,244,482,Trans Nzoia,RIFT VALLEY,21132
KWANZA,Rural,59,336,302,638,Trans Nzoia,RIFT VALLEY,21133
KWANZA,Rural,60,444,452,896,Trans Nzoia,RIFT VALLEY,21134
KWANZA,Rural,61,266,310,576,Trans Nzoia,RIFT VALLEY,21135
KWANZA,Rural,62,242,192,434,Trans Nzoia,RIFT VALLEY,21136
KWANZA,Rural,63,240,220,460,Trans Nzoia,RIFT VALLEY,21137
KWANZA,Rural,64,228,183,411,Trans Nzoia,RIFT VALLEY,21138
KWANZA,Rural,65,276,266,542,Trans Nzoia,RIFT VALLEY,21139
KWANZA,Rural,66,182,181,363,Trans Nzoia,RIFT VALLEY,21140
KWANZA,Rural,67,206,229,435,Trans Nzoia,RIFT VALLEY,21141
KWANZA,Rural,68,137,144,281,Trans Nzoia,RIFT VALLEY,21142
KWANZA,Rural,69,127,173,300,Trans Nzoia,RIFT VALLEY,21143
KWANZA,Rural,70,268,288,556,Trans Nzoia,RIFT VALLEY,21144
KWANZA,Rural,71,131,109,240,Trans Nzoia,RIFT VALLEY,21145
KWANZA,Rural,72,151,113,264,Trans Nzoia,RIFT VALLEY,21146
KWANZA,Rural,73,161,124,285,Trans Nzoia,RIFT VALLEY,21147
KWANZA,Rural,74,87,95,182,Trans Nzoia,RIFT VALLEY,21148
KWANZA,Rural,75,133,138,271,Trans Nzoia,RIFT VALLEY,21149
KWANZA,Rural,76,98,95,193,Trans Nzoia,RIFT VALLEY,21150
KWANZA,Rural,77,111,108,219,Trans Nzoia,RIFT VALLEY,21151
KWANZA,Rural,78,88,96,184,Trans Nzoia,RIFT VALLEY,21152
KWANZA,Rural,79,118,126,244,Trans Nzoia,RIFT VALLEY,21153
KWANZA,Rural,80+,811,935,1746,Trans Nzoia,RIFT VALLEY,21154
KWANZA,Rural,Age NS,31,17,48,Trans Nzoia,RIFT VALLEY,21155
BARINGO,Rural,0,2277,2245,4522,Baringo,RIFT VALLEY,21156
BARINGO,Rural,1,1857,1854,3711,Baringo,RIFT VALLEY,21157
BARINGO,Rural,2,2259,2193,4452,Baringo,RIFT VALLEY,21158
BARINGO,Rural,3,2383,2186,4569,Baringo,RIFT VALLEY,21159
BARINGO,Rural,4,2253,2242,4495,Baringo,RIFT VALLEY,21160
BARINGO,Rural,5,2370,2263,4633,Baringo,RIFT VALLEY,21161
BARINGO,Rural,6,2250,2158,4408,Baringo,RIFT VALLEY,21162
BARINGO,Rural,7,2085,2049,4134,Baringo,RIFT VALLEY,21163
BARINGO,Rural,8,2112,2055,4167,Baringo,RIFT VALLEY,21164
BARINGO,Rural,9,1976,1933,3909,Baringo,RIFT VALLEY,21165
BARINGO,Rural,10,2354,2290,4644,Baringo,RIFT VALLEY,21166
BARINGO,Rural,11,1594,1611,3205,Baringo,RIFT VALLEY,21167
BARINGO,Rural,12,2251,2158,4409,Baringo,RIFT VALLEY,21168
BARINGO,Rural,13,1992,1952,3944,Baringo,RIFT VALLEY,21169
BARINGO,Rural,14,1979,2045,4024,Baringo,RIFT VALLEY,21170
BARINGO,Rural,15,1946,1971,3917,Baringo,RIFT VALLEY,21171
BARINGO,Rural,16,1851,1743,3594,Baringo,RIFT VALLEY,21172
BARINGO,Rural,17,1607,1361,2968,Baringo,RIFT VALLEY,21173
BARINGO,Rural,18,1720,1474,3194,Baringo,RIFT VALLEY,21174
BARINGO,Rural,19,1057,951,2008,Baringo,RIFT VALLEY,21175
BARINGO,Rural,20,1446,1600,3046,Baringo,RIFT VALLEY,21176
BARINGO,Rural,21,888,922,1810,Baringo,RIFT VALLEY,21177
BARINGO,Rural,22,1082,1144,2226,Baringo,RIFT VALLEY,21178
BARINGO,Rural,23,839,1003,1842,Baringo,RIFT VALLEY,21179
BARINGO,Rural,24,900,1016,1916,Baringo,RIFT VALLEY,21180
BARINGO,Rural,25,1220,1465,2685,Baringo,RIFT VALLEY,21181
BARINGO,Rural,26,776,772,1548,Baringo,RIFT VALLEY,21182
BARINGO,Rural,27,729,770,1499,Baringo,RIFT VALLEY,21183
BARINGO,Rural,28,699,858,1557,Baringo,RIFT VALLEY,21184
BARINGO,Rural,29,554,581,1135,Baringo,RIFT VALLEY,21185
BARINGO,Rural,30,970,1203,2173,Baringo,RIFT VALLEY,21186
BARINGO,Rural,31,546,455,1001,Baringo,RIFT VALLEY,21187
BARINGO,Rural,32,609,706,1315,Baringo,RIFT VALLEY,21188
BARINGO,Rural,33,386,474,860,Baringo,RIFT VALLEY,21189
BARINGO,Rural,34,457,513,970,Baringo,RIFT VALLEY,21190
BARINGO,Rural,35,924,997,1921,Baringo,RIFT VALLEY,21191
BARINGO,Rural,36,398,516,914,Baringo,RIFT VALLEY,21192
BARINGO,Rural,37,427,464,891,Baringo,RIFT VALLEY,21193
BARINGO,Rural,38,392,547,939,Baringo,RIFT VALLEY,21194
BARINGO,Rural,39,363,376,739,Baringo,RIFT VALLEY,21195
BARINGO,Rural,40,726,951,1677,Baringo,RIFT VALLEY,21196
BARINGO,Rural,41,292,273,565,Baringo,RIFT VALLEY,21197
BARINGO,Rural,42,366,464,830,Baringo,RIFT VALLEY,21198
BARINGO,Rural,43,252,250,502,Baringo,RIFT VALLEY,21199
BARINGO,Rural,44,313,365,678,Baringo,RIFT VALLEY,21200
BARINGO,Rural,45,551,663,1214,Baringo,RIFT VALLEY,21201
BARINGO,Rural,46,298,296,594,Baringo,RIFT VALLEY,21202
BARINGO,Rural,47,349,361,710,Baringo,RIFT VALLEY,21203
BARINGO,Rural,48,446,524,970,Baringo,RIFT VALLEY,21204
BARINGO,Rural,49,331,340,671,Baringo,RIFT VALLEY,21205
BARINGO,Rural,50,613,724,1337,Baringo,RIFT VALLEY,21206
BARINGO,Rural,51,274,190,464,Baringo,RIFT VALLEY,21207
BARINGO,Rural,52,307,279,586,Baringo,RIFT VALLEY,21208
BARINGO,Rural,53,258,207,465,Baringo,RIFT VALLEY,21209
BARINGO,Rural,54,274,217,491,Baringo,RIFT VALLEY,21210
BARINGO,Rural,55,383,409,792,Baringo,RIFT VALLEY,21211
BARINGO,Rural,56,261,175,436,Baringo,RIFT VALLEY,21212
BARINGO,Rural,57,292,177,469,Baringo,RIFT VALLEY,21213
BARINGO,Rural,58,174,183,357,Baringo,RIFT VALLEY,21214
BARINGO,Rural,59,229,175,404,Baringo,RIFT VALLEY,21215
BARINGO,Rural,60,481,536,1017,Baringo,RIFT VALLEY,21216
BARINGO,Rural,61,188,169,357,Baringo,RIFT VALLEY,21217
BARINGO,Rural,62,144,114,258,Baringo,RIFT VALLEY,21218
BARINGO,Rural,63,149,106,255,Baringo,RIFT VALLEY,21219
BARINGO,Rural,64,149,156,305,Baringo,RIFT VALLEY,21220
BARINGO,Rural,65,279,267,546,Baringo,RIFT VALLEY,21221
BARINGO,Rural,66,77,71,148,Baringo,RIFT VALLEY,21222
BARINGO,Rural,67,122,97,219,Baringo,RIFT VALLEY,21223
BARINGO,Rural,68,98,142,240,Baringo,RIFT VALLEY,21224
BARINGO,Rural,69,125,142,267,Baringo,RIFT VALLEY,21225
BARINGO,Rural,70,268,347,615,Baringo,RIFT VALLEY,21226
BARINGO,Rural,71,66,95,161,Baringo,RIFT VALLEY,21227
BARINGO,Rural,72,84,105,189,Baringo,RIFT VALLEY,21228
BARINGO,Rural,73,69,77,146,Baringo,RIFT VALLEY,21229
BARINGO,Rural,74,41,105,146,Baringo,RIFT VALLEY,21230
BARINGO,Rural,75,117,166,283,Baringo,RIFT VALLEY,21231
BARINGO,Rural,76,59,54,113,Baringo,RIFT VALLEY,21232
BARINGO,Rural,77,52,34,86,Baringo,RIFT VALLEY,21233
BARINGO,Rural,78,71,86,157,Baringo,RIFT VALLEY,21234
BARINGO,Rural,79,87,109,196,Baringo,RIFT VALLEY,21235
BARINGO,Rural,80+,624,910,1534,Baringo,RIFT VALLEY,21236
BARINGO,Rural,Age NS,19,15,34,Baringo,RIFT VALLEY,21237
BARINGO NORTH,Rural,0,1529,1436,2965,Baringo,RIFT VALLEY,21238
BARINGO NORTH,Rural,1,1289,1274,2563,Baringo,RIFT VALLEY,21239
BARINGO NORTH,Rural,2,1533,1454,2987,Baringo,RIFT VALLEY,21240
BARINGO NORTH,Rural,3,1540,1454,2994,Baringo,RIFT VALLEY,21241
BARINGO NORTH,Rural,4,1573,1481,3054,Baringo,RIFT VALLEY,21242
BARINGO NORTH,Rural,5,1567,1468,3035,Baringo,RIFT VALLEY,21243
BARINGO NORTH,Rural,6,1533,1496,3029,Baringo,RIFT VALLEY,21244
BARINGO NORTH,Rural,7,1421,1371,2792,Baringo,RIFT VALLEY,21245
BARINGO NORTH,Rural,8,1494,1484,2978,Baringo,RIFT VALLEY,21246
BARINGO NORTH,Rural,9,1456,1323,2779,Baringo,RIFT VALLEY,21247
BARINGO NORTH,Rural,10,1847,1709,3556,Baringo,RIFT VALLEY,21248
BARINGO NORTH,Rural,11,1136,1133,2269,Baringo,RIFT VALLEY,21249
BARINGO NORTH,Rural,12,1733,1577,3310,Baringo,RIFT VALLEY,21250
BARINGO NORTH,Rural,13,1403,1392,2795,Baringo,RIFT VALLEY,21251
BARINGO NORTH,Rural,14,1477,1481,2958,Baringo,RIFT VALLEY,21252
BARINGO NORTH,Rural,15,1520,1482,3002,Baringo,RIFT VALLEY,21253
BARINGO NORTH,Rural,16,1325,1288,2613,Baringo,RIFT VALLEY,21254
BARINGO NORTH,Rural,17,1085,995,2080,Baringo,RIFT VALLEY,21255
BARINGO NORTH,Rural,18,1170,1070,2240,Baringo,RIFT VALLEY,21256
BARINGO NORTH,Rural,19,801,794,1595,Baringo,RIFT VALLEY,21257
BARINGO NORTH,Rural,20,1084,1083,2167,Baringo,RIFT VALLEY,21258
BARINGO NORTH,Rural,21,602,654,1256,Baringo,RIFT VALLEY,21259
BARINGO NORTH,Rural,22,707,856,1563,Baringo,RIFT VALLEY,21260
BARINGO NORTH,Rural,23,660,719,1379,Baringo,RIFT VALLEY,21261
BARINGO NORTH,Rural,24,642,694,1336,Baringo,RIFT VALLEY,21262
BARINGO NORTH,Rural,25,848,1001,1849,Baringo,RIFT VALLEY,21263
BARINGO NORTH,Rural,26,444,580,1024,Baringo,RIFT VALLEY,21264
BARINGO NORTH,Rural,27,481,522,1003,Baringo,RIFT VALLEY,21265
BARINGO NORTH,Rural,28,404,624,1028,Baringo,RIFT VALLEY,21266
BARINGO NORTH,Rural,29,348,377,725,Baringo,RIFT VALLEY,21267
BARINGO NORTH,Rural,30,642,835,1477,Baringo,RIFT VALLEY,21268
BARINGO NORTH,Rural,31,336,334,670,Baringo,RIFT VALLEY,21269
BARINGO NORTH,Rural,32,343,412,755,Baringo,RIFT VALLEY,21270
BARINGO NORTH,Rural,33,258,286,544,Baringo,RIFT VALLEY,21271
BARINGO NORTH,Rural,34,300,348,648,Baringo,RIFT VALLEY,21272
BARINGO NORTH,Rural,35,679,783,1462,Baringo,RIFT VALLEY,21273
BARINGO NORTH,Rural,36,303,318,621,Baringo,RIFT VALLEY,21274
BARINGO NORTH,Rural,37,304,313,617,Baringo,RIFT VALLEY,21275
BARINGO NORTH,Rural,38,242,322,564,Baringo,RIFT VALLEY,21276
BARINGO NORTH,Rural,39,253,289,542,Baringo,RIFT VALLEY,21277
BARINGO NORTH,Rural,40,446,679,1125,Baringo,RIFT VALLEY,21278
BARINGO NORTH,Rural,41,205,190,395,Baringo,RIFT VALLEY,21279
BARINGO NORTH,Rural,42,200,243,443,Baringo,RIFT VALLEY,21280
BARINGO NORTH,Rural,43,156,179,335,Baringo,RIFT VALLEY,21281
BARINGO NORTH,Rural,44,225,292,517,Baringo,RIFT VALLEY,21282
BARINGO NORTH,Rural,45,344,457,801,Baringo,RIFT VALLEY,21283
BARINGO NORTH,Rural,46,193,221,414,Baringo,RIFT VALLEY,21284
BARINGO NORTH,Rural,47,204,287,491,Baringo,RIFT VALLEY,21285
BARINGO NORTH,Rural,48,302,356,658,Baringo,RIFT VALLEY,21286
BARINGO NORTH,Rural,49,288,254,542,Baringo,RIFT VALLEY,21287
BARINGO NORTH,Rural,50,428,606,1034,Baringo,RIFT VALLEY,21288
BARINGO NORTH,Rural,51,205,192,397,Baringo,RIFT VALLEY,21289
BARINGO NORTH,Rural,52,219,237,456,Baringo,RIFT VALLEY,21290
BARINGO NORTH,Rural,53,201,183,384,Baringo,RIFT VALLEY,21291
BARINGO NORTH,Rural,54,168,199,367,Baringo,RIFT VALLEY,21292
BARINGO NORTH,Rural,55,301,354,655,Baringo,RIFT VALLEY,21293
BARINGO NORTH,Rural,56,198,213,411,Baringo,RIFT VALLEY,21294
BARINGO NORTH,Rural,57,226,219,445,Baringo,RIFT VALLEY,21295
BARINGO NORTH,Rural,58,167,154,321,Baringo,RIFT VALLEY,21296
BARINGO NORTH,Rural,59,218,206,424,Baringo,RIFT VALLEY,21297
BARINGO NORTH,Rural,60,389,444,833,Baringo,RIFT VALLEY,21298
BARINGO NORTH,Rural,61,228,174,402,Baringo,RIFT VALLEY,21299
BARINGO NORTH,Rural,62,159,125,284,Baringo,RIFT VALLEY,21300
BARINGO NORTH,Rural,63,102,98,200,Baringo,RIFT VALLEY,21301
BARINGO NORTH,Rural,64,170,139,309,Baringo,RIFT VALLEY,21302
BARINGO NORTH,Rural,65,188,200,388,Baringo,RIFT VALLEY,21303
BARINGO NORTH,Rural,66,49,60,109,Baringo,RIFT VALLEY,21304
BARINGO NORTH,Rural,67,121,87,208,Baringo,RIFT VALLEY,21305
BARINGO NORTH,Rural,68,76,105,181,Baringo,RIFT VALLEY,21306
BARINGO NORTH,Rural,69,109,120,229,Baringo,RIFT VALLEY,21307
BARINGO NORTH,Rural,70,257,277,534,Baringo,RIFT VALLEY,21308
BARINGO NORTH,Rural,71,74,102,176,Baringo,RIFT VALLEY,21309
BARINGO NORTH,Rural,72,85,77,162,Baringo,RIFT VALLEY,21310
BARINGO NORTH,Rural,73,53,70,123,Baringo,RIFT VALLEY,21311
BARINGO NORTH,Rural,74,75,85,160,Baringo,RIFT VALLEY,21312
BARINGO NORTH,Rural,75,103,140,243,Baringo,RIFT VALLEY,21313
BARINGO NORTH,Rural,76,59,48,107,Baringo,RIFT VALLEY,21314
BARINGO NORTH,Rural,77,35,34,69,Baringo,RIFT VALLEY,21315
BARINGO NORTH,Rural,78,48,58,106,Baringo,RIFT VALLEY,21316
BARINGO NORTH,Rural,79,83,95,178,Baringo,RIFT VALLEY,21317
BARINGO NORTH,Rural,80+,548,774,1322,Baringo,RIFT VALLEY,21318
BARINGO NORTH,Rural,Age NS,11,16,27,Baringo,RIFT VALLEY,21319
EAST POKOT,Rural,0,2735,2415,5150,Baringo,RIFT VALLEY,21320
EAST POKOT,Rural,1,1651,1471,3122,Baringo,RIFT VALLEY,21321
EAST POKOT,Rural,2,3057,2917,5974,Baringo,RIFT VALLEY,21322
EAST POKOT,Rural,3,2517,2390,4907,Baringo,RIFT VALLEY,21323
EAST POKOT,Rural,4,3134,2724,5858,Baringo,RIFT VALLEY,21324
EAST POKOT,Rural,5,2632,2407,5039,Baringo,RIFT VALLEY,21325
EAST POKOT,Rural,6,3091,2736,5827,Baringo,RIFT VALLEY,21326
EAST POKOT,Rural,7,2376,2240,4616,Baringo,RIFT VALLEY,21327
EAST POKOT,Rural,8,3144,2922,6066,Baringo,RIFT VALLEY,21328
EAST POKOT,Rural,9,2612,2220,4832,Baringo,RIFT VALLEY,21329
EAST POKOT,Rural,10,3646,3132,6778,Baringo,RIFT VALLEY,21330
EAST POKOT,Rural,11,1637,1749,3386,Baringo,RIFT VALLEY,21331
EAST POKOT,Rural,12,3131,2274,5405,Baringo,RIFT VALLEY,21332
EAST POKOT,Rural,13,1904,1420,3324,Baringo,RIFT VALLEY,21333
EAST POKOT,Rural,14,2285,1594,3879,Baringo,RIFT VALLEY,21334
EAST POKOT,Rural,15,2453,1625,4078,Baringo,RIFT VALLEY,21335
EAST POKOT,Rural,16,2091,1388,3479,Baringo,RIFT VALLEY,21336
EAST POKOT,Rural,17,1611,1032,2643,Baringo,RIFT VALLEY,21337
EAST POKOT,Rural,18,2068,1553,3621,Baringo,RIFT VALLEY,21338
EAST POKOT,Rural,19,1060,871,1931,Baringo,RIFT VALLEY,21339
EAST POKOT,Rural,20,1910,1784,3694,Baringo,RIFT VALLEY,21340
EAST POKOT,Rural,21,978,920,1898,Baringo,RIFT VALLEY,21341
EAST POKOT,Rural,22,933,866,1799,Baringo,RIFT VALLEY,21342
EAST POKOT,Rural,23,733,680,1413,Baringo,RIFT VALLEY,21343
EAST POKOT,Rural,24,773,911,1684,Baringo,RIFT VALLEY,21344
EAST POKOT,Rural,25,1292,1508,2800,Baringo,RIFT VALLEY,21345
EAST POKOT,Rural,26,608,800,1408,Baringo,RIFT VALLEY,21346
EAST POKOT,Rural,27,597,642,1239,Baringo,RIFT VALLEY,21347
EAST POKOT,Rural,28,790,1037,1827,Baringo,RIFT VALLEY,21348
EAST POKOT,Rural,29,505,665,1170,Baringo,RIFT VALLEY,21349
EAST POKOT,Rural,30,1153,1307,2460,Baringo,RIFT VALLEY,21350
EAST POKOT,Rural,31,403,432,835,Baringo,RIFT VALLEY,21351
EAST POKOT,Rural,32,589,679,1268,Baringo,RIFT VALLEY,21352
EAST POKOT,Rural,33,287,374,661,Baringo,RIFT VALLEY,21353
EAST POKOT,Rural,34,418,504,922,Baringo,RIFT VALLEY,21354
EAST POKOT,Rural,35,780,831,1611,Baringo,RIFT VALLEY,21355
EAST POKOT,Rural,36,515,607,1122,Baringo,RIFT VALLEY,21356
EAST POKOT,Rural,37,336,325,661,Baringo,RIFT VALLEY,21357
EAST POKOT,Rural,38,480,538,1018,Baringo,RIFT VALLEY,21358
EAST POKOT,Rural,39,378,400,778,Baringo,RIFT VALLEY,21359
EAST POKOT,Rural,40,845,811,1656,Baringo,RIFT VALLEY,21360
EAST POKOT,Rural,41,207,202,409,Baringo,RIFT VALLEY,21361
EAST POKOT,Rural,42,329,309,638,Baringo,RIFT VALLEY,21362
EAST POKOT,Rural,43,191,190,381,Baringo,RIFT VALLEY,21363
EAST POKOT,Rural,44,202,228,430,Baringo,RIFT VALLEY,21364
EAST POKOT,Rural,45,438,383,821,Baringo,RIFT VALLEY,21365
EAST POKOT,Rural,46,203,261,464,Baringo,RIFT VALLEY,21366
EAST POKOT,Rural,47,161,178,339,Baringo,RIFT VALLEY,21367
EAST POKOT,Rural,48,309,293,602,Baringo,RIFT VALLEY,21368
EAST POKOT,Rural,49,253,224,477,Baringo,RIFT VALLEY,21369
EAST POKOT,Rural,50,473,447,920,Baringo,RIFT VALLEY,21370
EAST POKOT,Rural,51,115,122,237,Baringo,RIFT VALLEY,21371
EAST POKOT,Rural,52,194,159,353,Baringo,RIFT VALLEY,21372
EAST POKOT,Rural,53,86,83,169,Baringo,RIFT VALLEY,21373
EAST POKOT,Rural,54,112,100,212,Baringo,RIFT VALLEY,21374
EAST POKOT,Rural,55,150,138,288,Baringo,RIFT VALLEY,21375
EAST POKOT,Rural,56,148,144,292,Baringo,RIFT VALLEY,21376
EAST POKOT,Rural,57,122,89,211,Baringo,RIFT VALLEY,21377
EAST POKOT,Rural,58,102,81,183,Baringo,RIFT VALLEY,21378
EAST POKOT,Rural,59,145,163,308,Baringo,RIFT VALLEY,21379
EAST POKOT,Rural,60,297,251,548,Baringo,RIFT VALLEY,21380
EAST POKOT,Rural,61,89,53,142,Baringo,RIFT VALLEY,21381
EAST POKOT,Rural,62,105,74,179,Baringo,RIFT VALLEY,21382
EAST POKOT,Rural,63,54,56,110,Baringo,RIFT VALLEY,21383
EAST POKOT,Rural,64,76,87,163,Baringo,RIFT VALLEY,21384
EAST POKOT,Rural,65,125,134,259,Baringo,RIFT VALLEY,21385
EAST POKOT,Rural,66,52,28,80,Baringo,RIFT VALLEY,21386
EAST POKOT,Rural,67,53,40,93,Baringo,RIFT VALLEY,21387
EAST POKOT,Rural,68,68,58,126,Baringo,RIFT VALLEY,21388
EAST POKOT,Rural,69,75,69,144,Baringo,RIFT VALLEY,21389
EAST POKOT,Rural,70,173,164,337,Baringo,RIFT VALLEY,21390
EAST POKOT,Rural,71,31,29,60,Baringo,RIFT VALLEY,21391
EAST POKOT,Rural,72,38,56,94,Baringo,RIFT VALLEY,21392
EAST POKOT,Rural,73,27,24,51,Baringo,RIFT VALLEY,21393
EAST POKOT,Rural,74,28,27,55,Baringo,RIFT VALLEY,21394
EAST POKOT,Rural,75,71,72,143,Baringo,RIFT VALLEY,21395
EAST POKOT,Rural,76,22,18,40,Baringo,RIFT VALLEY,21396
EAST POKOT,Rural,77,21,15,36,Baringo,RIFT VALLEY,21397
EAST POKOT,Rural,78,18,44,62,Baringo,RIFT VALLEY,21398
EAST POKOT,Rural,79,37,48,85,Baringo,RIFT VALLEY,21399
EAST POKOT,Rural,80+,342,449,791,Baringo,RIFT VALLEY,21400
EAST POKOT,Rural,Age NS,9,9,18,Baringo,RIFT VALLEY,21401
KOIBATEK,Rural,0,2217,2175,4392,Baringo,RIFT VALLEY,21402
KOIBATEK,Rural,1,1867,1806,3673,Baringo,RIFT VALLEY,21403
KOIBATEK,Rural,2,2271,2094,4365,Baringo,RIFT VALLEY,21404
KOIBATEK,Rural,3,2199,2106,4305,Baringo,RIFT VALLEY,21405
KOIBATEK,Rural,4,2260,2171,4431,Baringo,RIFT VALLEY,21406
KOIBATEK,Rural,5,2271,2101,4372,Baringo,RIFT VALLEY,21407
KOIBATEK,Rural,6,2268,2173,4441,Baringo,RIFT VALLEY,21408
KOIBATEK,Rural,7,2109,2144,4253,Baringo,RIFT VALLEY,21409
KOIBATEK,Rural,8,1910,2049,3959,Baringo,RIFT VALLEY,21410
KOIBATEK,Rural,9,2185,2094,4279,Baringo,RIFT VALLEY,21411
KOIBATEK,Rural,10,2286,2199,4485,Baringo,RIFT VALLEY,21412
KOIBATEK,Rural,11,1828,1873,3701,Baringo,RIFT VALLEY,21413
KOIBATEK,Rural,12,2183,2142,4325,Baringo,RIFT VALLEY,21414
KOIBATEK,Rural,13,1976,1878,3854,Baringo,RIFT VALLEY,21415
KOIBATEK,Rural,14,1936,1936,3872,Baringo,RIFT VALLEY,21416
KOIBATEK,Rural,15,1808,1839,3647,Baringo,RIFT VALLEY,21417
KOIBATEK,Rural,16,1692,1610,3302,Baringo,RIFT VALLEY,21418
KOIBATEK,Rural,17,1569,1486,3055,Baringo,RIFT VALLEY,21419
KOIBATEK,Rural,18,1586,1350,2936,Baringo,RIFT VALLEY,21420
KOIBATEK,Rural,19,1330,1233,2563,Baringo,RIFT VALLEY,21421
KOIBATEK,Rural,20,1560,1471,3031,Baringo,RIFT VALLEY,21422
KOIBATEK,Rural,21,1073,1028,2101,Baringo,RIFT VALLEY,21423
KOIBATEK,Rural,22,1231,1202,2433,Baringo,RIFT VALLEY,21424
KOIBATEK,Rural,23,1088,1159,2247,Baringo,RIFT VALLEY,21425
KOIBATEK,Rural,24,949,1030,1979,Baringo,RIFT VALLEY,21426
KOIBATEK,Rural,25,1284,1372,2656,Baringo,RIFT VALLEY,21427
KOIBATEK,Rural,26,932,936,1868,Baringo,RIFT VALLEY,21428
KOIBATEK,Rural,27,953,982,1935,Baringo,RIFT VALLEY,21429
KOIBATEK,Rural,28,722,903,1625,Baringo,RIFT VALLEY,21430
KOIBATEK,Rural,29,818,795,1613,Baringo,RIFT VALLEY,21431
KOIBATEK,Rural,30,1168,1193,2361,Baringo,RIFT VALLEY,21432
KOIBATEK,Rural,31,732,638,1370,Baringo,RIFT VALLEY,21433
KOIBATEK,Rural,32,757,803,1560,Baringo,RIFT VALLEY,21434
KOIBATEK,Rural,33,559,599,1158,Baringo,RIFT VALLEY,21435
KOIBATEK,Rural,34,561,557,1118,Baringo,RIFT VALLEY,21436
KOIBATEK,Rural,35,1013,970,1983,Baringo,RIFT VALLEY,21437
KOIBATEK,Rural,36,583,557,1140,Baringo,RIFT VALLEY,21438
KOIBATEK,Rural,37,572,531,1103,Baringo,RIFT VALLEY,21439
KOIBATEK,Rural,38,474,521,995,Baringo,RIFT VALLEY,21440
KOIBATEK,Rural,39,485,539,1024,Baringo,RIFT VALLEY,21441
KOIBATEK,Rural,40,747,799,1546,Baringo,RIFT VALLEY,21442
KOIBATEK,Rural,41,395,391,786,Baringo,RIFT VALLEY,21443
KOIBATEK,Rural,42,457,434,891,Baringo,RIFT VALLEY,21444
KOIBATEK,Rural,43,327,345,672,Baringo,RIFT VALLEY,21445
KOIBATEK,Rural,44,355,367,722,Baringo,RIFT VALLEY,21446
KOIBATEK,Rural,45,535,566,1101,Baringo,RIFT VALLEY,21447
KOIBATEK,Rural,46,362,415,777,Baringo,RIFT VALLEY,21448
KOIBATEK,Rural,47,344,385,729,Baringo,RIFT VALLEY,21449
KOIBATEK,Rural,48,467,499,966,Baringo,RIFT VALLEY,21450
KOIBATEK,Rural,49,347,340,687,Baringo,RIFT VALLEY,21451
KOIBATEK,Rural,50,552,594,1146,Baringo,RIFT VALLEY,21452
KOIBATEK,Rural,51,327,230,557,Baringo,RIFT VALLEY,21453
KOIBATEK,Rural,52,320,283,603,Baringo,RIFT VALLEY,21454
KOIBATEK,Rural,53,221,215,436,Baringo,RIFT VALLEY,21455
KOIBATEK,Rural,54,222,208,430,Baringo,RIFT VALLEY,21456
KOIBATEK,Rural,55,343,372,715,Baringo,RIFT VALLEY,21457
KOIBATEK,Rural,56,196,202,398,Baringo,RIFT VALLEY,21458
KOIBATEK,Rural,57,339,289,628,Baringo,RIFT VALLEY,21459
KOIBATEK,Rural,58,165,187,352,Baringo,RIFT VALLEY,21460
KOIBATEK,Rural,59,219,219,438,Baringo,RIFT VALLEY,21461
KOIBATEK,Rural,60,416,497,913,Baringo,RIFT VALLEY,21462
KOIBATEK,Rural,61,237,186,423,Baringo,RIFT VALLEY,21463
KOIBATEK,Rural,62,200,134,334,Baringo,RIFT VALLEY,21464
KOIBATEK,Rural,63,143,145,288,Baringo,RIFT VALLEY,21465
KOIBATEK,Rural,64,164,172,336,Baringo,RIFT VALLEY,21466
KOIBATEK,Rural,65,210,256,466,Baringo,RIFT VALLEY,21467
KOIBATEK,Rural,66,108,123,231,Baringo,RIFT VALLEY,21468
KOIBATEK,Rural,67,154,165,319,Baringo,RIFT VALLEY,21469
KOIBATEK,Rural,68,97,132,229,Baringo,RIFT VALLEY,21470
KOIBATEK,Rural,69,125,165,290,Baringo,RIFT VALLEY,21471
KOIBATEK,Rural,70,274,315,589,Baringo,RIFT VALLEY,21472
KOIBATEK,Rural,71,81,94,175,Baringo,RIFT VALLEY,21473
KOIBATEK,Rural,72,105,91,196,Baringo,RIFT VALLEY,21474
KOIBATEK,Rural,73,83,89,172,Baringo,RIFT VALLEY,21475
KOIBATEK,Rural,74,94,102,196,Baringo,RIFT VALLEY,21476
KOIBATEK,Rural,75,121,131,252,Baringo,RIFT VALLEY,21477
KOIBATEK,Rural,76,93,66,159,Baringo,RIFT VALLEY,21478
KOIBATEK,Rural,77,58,63,121,Baringo,RIFT VALLEY,21479
KOIBATEK,Rural,78,72,75,147,Baringo,RIFT VALLEY,21480
KOIBATEK,Rural,79,80,133,213,Baringo,RIFT VALLEY,21481
KOIBATEK,Rural,80+,633,854,1487,Baringo,RIFT VALLEY,21482
KOIBATEK,Rural,Age NS,11,17,28,Baringo,RIFT VALLEY,21483
ELDORET WEST,Rural,0,4132,4062,8194,Uasin Gishu,RIFT VALLEY,21484
ELDORET WEST,Rural,1,3762,3718,7480,Uasin Gishu,RIFT VALLEY,21485
ELDORET WEST,Rural,2,4322,4095,8417,Uasin Gishu,RIFT VALLEY,21486
ELDORET WEST,Rural,3,4189,4182,8371,Uasin Gishu,RIFT VALLEY,21487
ELDORET WEST,Rural,4,4206,3983,8189,Uasin Gishu,RIFT VALLEY,21488
ELDORET WEST,Rural,5,4107,3903,8010,Uasin Gishu,RIFT VALLEY,21489
ELDORET WEST,Rural,6,4071,3717,7788,Uasin Gishu,RIFT VALLEY,21490
ELDORET WEST,Rural,7,3940,3827,7767,Uasin Gishu,RIFT VALLEY,21491
ELDORET WEST,Rural,8,3596,3574,7170,Uasin Gishu,RIFT VALLEY,21492
ELDORET WEST,Rural,9,3996,3851,7847,Uasin Gishu,RIFT VALLEY,21493
ELDORET WEST,Rural,10,3908,3816,7724,Uasin Gishu,RIFT VALLEY,21494
ELDORET WEST,Rural,11,2894,2992,5886,Uasin Gishu,RIFT VALLEY,21495
ELDORET WEST,Rural,12,3627,3595,7222,Uasin Gishu,RIFT VALLEY,21496
ELDORET WEST,Rural,13,3492,3575,7067,Uasin Gishu,RIFT VALLEY,21497
ELDORET WEST,Rural,14,3123,3094,6217,Uasin Gishu,RIFT VALLEY,21498
ELDORET WEST,Rural,15,2947,2958,5905,Uasin Gishu,RIFT VALLEY,21499
ELDORET WEST,Rural,16,2833,2854,5687,Uasin Gishu,RIFT VALLEY,21500
ELDORET WEST,Rural,17,2954,2776,5730,Uasin Gishu,RIFT VALLEY,21501
ELDORET WEST,Rural,18,2755,2463,5218,Uasin Gishu,RIFT VALLEY,21502
ELDORET WEST,Rural,19,2542,2328,4870,Uasin Gishu,RIFT VALLEY,21503
ELDORET WEST,Rural,20,3000,2871,5871,Uasin Gishu,RIFT VALLEY,21504
ELDORET WEST,Rural,21,2376,2177,4553,Uasin Gishu,RIFT VALLEY,21505
ELDORET WEST,Rural,22,2474,2557,5031,Uasin Gishu,RIFT VALLEY,21506
ELDORET WEST,Rural,23,2360,2246,4606,Uasin Gishu,RIFT VALLEY,21507
ELDORET WEST,Rural,24,2142,2070,4212,Uasin Gishu,RIFT VALLEY,21508
ELDORET WEST,Rural,25,2457,2507,4964,Uasin Gishu,RIFT VALLEY,21509
ELDORET WEST,Rural,26,1710,1777,3487,Uasin Gishu,RIFT VALLEY,21510
ELDORET WEST,Rural,27,1855,1845,3700,Uasin Gishu,RIFT VALLEY,21511
ELDORET WEST,Rural,28,1328,1689,3017,Uasin Gishu,RIFT VALLEY,21512
ELDORET WEST,Rural,29,1463,1557,3020,Uasin Gishu,RIFT VALLEY,21513
ELDORET WEST,Rural,30,1907,2201,4108,Uasin Gishu,RIFT VALLEY,21514
ELDORET WEST,Rural,31,1256,1156,2412,Uasin Gishu,RIFT VALLEY,21515
ELDORET WEST,Rural,32,1496,1774,3270,Uasin Gishu,RIFT VALLEY,21516
ELDORET WEST,Rural,33,1131,1082,2213,Uasin Gishu,RIFT VALLEY,21517
ELDORET WEST,Rural,34,1134,1235,2369,Uasin Gishu,RIFT VALLEY,21518
ELDORET WEST,Rural,35,1765,1891,3656,Uasin Gishu,RIFT VALLEY,21519
ELDORET WEST,Rural,36,1055,1138,2193,Uasin Gishu,RIFT VALLEY,21520
ELDORET WEST,Rural,37,1101,1152,2253,Uasin Gishu,RIFT VALLEY,21521
ELDORET WEST,Rural,38,907,1080,1987,Uasin Gishu,RIFT VALLEY,21522
ELDORET WEST,Rural,39,991,959,1950,Uasin Gishu,RIFT VALLEY,21523
ELDORET WEST,Rural,40,1326,1383,2709,Uasin Gishu,RIFT VALLEY,21524
ELDORET WEST,Rural,41,751,739,1490,Uasin Gishu,RIFT VALLEY,21525
ELDORET WEST,Rural,42,795,875,1670,Uasin Gishu,RIFT VALLEY,21526
ELDORET WEST,Rural,43,655,701,1356,Uasin Gishu,RIFT VALLEY,21527
ELDORET WEST,Rural,44,569,585,1154,Uasin Gishu,RIFT VALLEY,21528
ELDORET WEST,Rural,45,938,981,1919,Uasin Gishu,RIFT VALLEY,21529
ELDORET WEST,Rural,46,645,696,1341,Uasin Gishu,RIFT VALLEY,21530
ELDORET WEST,Rural,47,606,687,1293,Uasin Gishu,RIFT VALLEY,21531
ELDORET WEST,Rural,48,651,824,1475,Uasin Gishu,RIFT VALLEY,21532
ELDORET WEST,Rural,49,694,624,1318,Uasin Gishu,RIFT VALLEY,21533
ELDORET WEST,Rural,50,821,872,1693,Uasin Gishu,RIFT VALLEY,21534
ELDORET WEST,Rural,51,471,468,939,Uasin Gishu,RIFT VALLEY,21535
ELDORET WEST,Rural,52,520,568,1088,Uasin Gishu,RIFT VALLEY,21536
ELDORET WEST,Rural,53,443,457,900,Uasin Gishu,RIFT VALLEY,21537
ELDORET WEST,Rural,54,392,440,832,Uasin Gishu,RIFT VALLEY,21538
ELDORET WEST,Rural,55,560,675,1235,Uasin Gishu,RIFT VALLEY,21539
ELDORET WEST,Rural,56,386,409,795,Uasin Gishu,RIFT VALLEY,21540
ELDORET WEST,Rural,57,501,609,1110,Uasin Gishu,RIFT VALLEY,21541
ELDORET WEST,Rural,58,269,298,567,Uasin Gishu,RIFT VALLEY,21542
ELDORET WEST,Rural,59,382,368,750,Uasin Gishu,RIFT VALLEY,21543
ELDORET WEST,Rural,60,513,606,1119,Uasin Gishu,RIFT VALLEY,21544
ELDORET WEST,Rural,61,375,341,716,Uasin Gishu,RIFT VALLEY,21545
ELDORET WEST,Rural,62,273,275,548,Uasin Gishu,RIFT VALLEY,21546
ELDORET WEST,Rural,63,251,252,503,Uasin Gishu,RIFT VALLEY,21547
ELDORET WEST,Rural,64,267,254,521,Uasin Gishu,RIFT VALLEY,21548
ELDORET WEST,Rural,65,355,375,730,Uasin Gishu,RIFT VALLEY,21549
ELDORET WEST,Rural,66,271,273,544,Uasin Gishu,RIFT VALLEY,21550
ELDORET WEST,Rural,67,264,259,523,Uasin Gishu,RIFT VALLEY,21551
ELDORET WEST,Rural,68,158,150,308,Uasin Gishu,RIFT VALLEY,21552
ELDORET WEST,Rural,69,207,217,424,Uasin Gishu,RIFT VALLEY,21553
ELDORET WEST,Rural,70,349,411,760,Uasin Gishu,RIFT VALLEY,21554
ELDORET WEST,Rural,71,141,143,284,Uasin Gishu,RIFT VALLEY,21555
ELDORET WEST,Rural,72,167,153,320,Uasin Gishu,RIFT VALLEY,21556
ELDORET WEST,Rural,73,161,132,293,Uasin Gishu,RIFT VALLEY,21557
ELDORET WEST,Rural,74,159,145,304,Uasin Gishu,RIFT VALLEY,21558
ELDORET WEST,Rural,75,179,237,416,Uasin Gishu,RIFT VALLEY,21559
ELDORET WEST,Rural,76,109,110,219,Uasin Gishu,RIFT VALLEY,21560
ELDORET WEST,Rural,77,116,98,214,Uasin Gishu,RIFT VALLEY,21561
ELDORET WEST,Rural,78,114,98,212,Uasin Gishu,RIFT VALLEY,21562
ELDORET WEST,Rural,79,105,178,283,Uasin Gishu,RIFT VALLEY,21563
ELDORET WEST,Rural,80+,1228,1595,2823,Uasin Gishu,RIFT VALLEY,21564
ELDORET WEST,Rural,Age NS,58,45,103,Uasin Gishu,RIFT VALLEY,21565
ELDORET EAST,Rural,0,2520,2418,4938,Uasin Gishu,RIFT VALLEY,21566
ELDORET EAST,Rural,1,2207,2106,4313,Uasin Gishu,RIFT VALLEY,21567
ELDORET EAST,Rural,2,2508,2565,5073,Uasin Gishu,RIFT VALLEY,21568
ELDORET EAST,Rural,3,2545,2621,5166,Uasin Gishu,RIFT VALLEY,21569
ELDORET EAST,Rural,4,2544,2496,5040,Uasin Gishu,RIFT VALLEY,21570
ELDORET EAST,Rural,5,2607,2508,5115,Uasin Gishu,RIFT VALLEY,21571
ELDORET EAST,Rural,6,2421,2421,4842,Uasin Gishu,RIFT VALLEY,21572
ELDORET EAST,Rural,7,2578,2487,5065,Uasin Gishu,RIFT VALLEY,21573
ELDORET EAST,Rural,8,2301,2300,4601,Uasin Gishu,RIFT VALLEY,21574
ELDORET EAST,Rural,9,2566,2513,5079,Uasin Gishu,RIFT VALLEY,21575
ELDORET EAST,Rural,10,2636,2401,5037,Uasin Gishu,RIFT VALLEY,21576
ELDORET EAST,Rural,11,2035,1960,3995,Uasin Gishu,RIFT VALLEY,21577
ELDORET EAST,Rural,12,2489,2371,4860,Uasin Gishu,RIFT VALLEY,21578
ELDORET EAST,Rural,13,2182,2228,4410,Uasin Gishu,RIFT VALLEY,21579
ELDORET EAST,Rural,14,2140,2082,4222,Uasin Gishu,RIFT VALLEY,21580
ELDORET EAST,Rural,15,1976,1968,3944,Uasin Gishu,RIFT VALLEY,21581
ELDORET EAST,Rural,16,1917,2028,3945,Uasin Gishu,RIFT VALLEY,21582
ELDORET EAST,Rural,17,1838,1808,3646,Uasin Gishu,RIFT VALLEY,21583
ELDORET EAST,Rural,18,1904,1673,3577,Uasin Gishu,RIFT VALLEY,21584
ELDORET EAST,Rural,19,1663,1390,3053,Uasin Gishu,RIFT VALLEY,21585
ELDORET EAST,Rural,20,1915,1817,3732,Uasin Gishu,RIFT VALLEY,21586
ELDORET EAST,Rural,21,1304,1245,2549,Uasin Gishu,RIFT VALLEY,21587
ELDORET EAST,Rural,22,1499,1630,3129,Uasin Gishu,RIFT VALLEY,21588
ELDORET EAST,Rural,23,1298,1458,2756,Uasin Gishu,RIFT VALLEY,21589
ELDORET EAST,Rural,24,1238,1431,2669,Uasin Gishu,RIFT VALLEY,21590
ELDORET EAST,Rural,25,1712,1840,3552,Uasin Gishu,RIFT VALLEY,21591
ELDORET EAST,Rural,26,1143,1280,2423,Uasin Gishu,RIFT VALLEY,21592
ELDORET EAST,Rural,27,1243,1205,2448,Uasin Gishu,RIFT VALLEY,21593
ELDORET EAST,Rural,28,994,1175,2169,Uasin Gishu,RIFT VALLEY,21594
ELDORET EAST,Rural,29,951,966,1917,Uasin Gishu,RIFT VALLEY,21595
ELDORET EAST,Rural,30,1471,1576,3047,Uasin Gishu,RIFT VALLEY,21596
ELDORET EAST,Rural,31,835,749,1584,Uasin Gishu,RIFT VALLEY,21597
ELDORET EAST,Rural,32,1155,1126,2281,Uasin Gishu,RIFT VALLEY,21598
ELDORET EAST,Rural,33,729,717,1446,Uasin Gishu,RIFT VALLEY,21599
ELDORET EAST,Rural,34,785,728,1513,Uasin Gishu,RIFT VALLEY,21600
ELDORET EAST,Rural,35,1327,1199,2526,Uasin Gishu,RIFT VALLEY,21601
ELDORET EAST,Rural,36,719,705,1424,Uasin Gishu,RIFT VALLEY,21602
ELDORET EAST,Rural,37,735,673,1408,Uasin Gishu,RIFT VALLEY,21603
ELDORET EAST,Rural,38,668,735,1403,Uasin Gishu,RIFT VALLEY,21604
ELDORET EAST,Rural,39,615,584,1199,Uasin Gishu,RIFT VALLEY,21605
ELDORET EAST,Rural,40,977,959,1936,Uasin Gishu,RIFT VALLEY,21606
ELDORET EAST,Rural,41,457,371,828,Uasin Gishu,RIFT VALLEY,21607
ELDORET EAST,Rural,42,533,533,1066,Uasin Gishu,RIFT VALLEY,21608
ELDORET EAST,Rural,43,360,439,799,Uasin Gishu,RIFT VALLEY,21609
ELDORET EAST,Rural,44,379,336,715,Uasin Gishu,RIFT VALLEY,21610
ELDORET EAST,Rural,45,676,700,1376,Uasin Gishu,RIFT VALLEY,21611
ELDORET EAST,Rural,46,427,416,843,Uasin Gishu,RIFT VALLEY,21612
ELDORET EAST,Rural,47,410,399,809,Uasin Gishu,RIFT VALLEY,21613
ELDORET EAST,Rural,48,473,577,1050,Uasin Gishu,RIFT VALLEY,21614
ELDORET EAST,Rural,49,381,345,726,Uasin Gishu,RIFT VALLEY,21615
ELDORET EAST,Rural,50,581,689,1270,Uasin Gishu,RIFT VALLEY,21616
ELDORET EAST,Rural,51,288,261,549,Uasin Gishu,RIFT VALLEY,21617
ELDORET EAST,Rural,52,333,362,695,Uasin Gishu,RIFT VALLEY,21618
ELDORET EAST,Rural,53,260,263,523,Uasin Gishu,RIFT VALLEY,21619
ELDORET EAST,Rural,54,261,280,541,Uasin Gishu,RIFT VALLEY,21620
ELDORET EAST,Rural,55,403,420,823,Uasin Gishu,RIFT VALLEY,21621
ELDORET EAST,Rural,56,256,276,532,Uasin Gishu,RIFT VALLEY,21622
ELDORET EAST,Rural,57,343,349,692,Uasin Gishu,RIFT VALLEY,21623
ELDORET EAST,Rural,58,182,233,415,Uasin Gishu,RIFT VALLEY,21624
ELDORET EAST,Rural,59,241,218,459,Uasin Gishu,RIFT VALLEY,21625
ELDORET EAST,Rural,60,438,540,978,Uasin Gishu,RIFT VALLEY,21626
ELDORET EAST,Rural,61,207,185,392,Uasin Gishu,RIFT VALLEY,21627
ELDORET EAST,Rural,62,209,157,366,Uasin Gishu,RIFT VALLEY,21628
ELDORET EAST,Rural,63,139,159,298,Uasin Gishu,RIFT VALLEY,21629
ELDORET EAST,Rural,64,152,179,331,Uasin Gishu,RIFT VALLEY,21630
ELDORET EAST,Rural,65,254,311,565,Uasin Gishu,RIFT VALLEY,21631
ELDORET EAST,Rural,66,184,163,347,Uasin Gishu,RIFT VALLEY,21632
ELDORET EAST,Rural,67,167,168,335,Uasin Gishu,RIFT VALLEY,21633
ELDORET EAST,Rural,68,109,132,241,Uasin Gishu,RIFT VALLEY,21634
ELDORET EAST,Rural,69,115,159,274,Uasin Gishu,RIFT VALLEY,21635
ELDORET EAST,Rural,70,326,406,732,Uasin Gishu,RIFT VALLEY,21636
ELDORET EAST,Rural,71,91,80,171,Uasin Gishu,RIFT VALLEY,21637
ELDORET EAST,Rural,72,112,102,214,Uasin Gishu,RIFT VALLEY,21638
ELDORET EAST,Rural,73,101,77,178,Uasin Gishu,RIFT VALLEY,21639
ELDORET EAST,Rural,74,97,110,207,Uasin Gishu,RIFT VALLEY,21640
ELDORET EAST,Rural,75,155,170,325,Uasin Gishu,RIFT VALLEY,21641
ELDORET EAST,Rural,76,92,82,174,Uasin Gishu,RIFT VALLEY,21642
ELDORET EAST,Rural,77,84,60,144,Uasin Gishu,RIFT VALLEY,21643
ELDORET EAST,Rural,78,69,85,154,Uasin Gishu,RIFT VALLEY,21644
ELDORET EAST,Rural,79,75,103,178,Uasin Gishu,RIFT VALLEY,21645
ELDORET EAST,Rural,80+,982,1249,2231,Uasin Gishu,RIFT VALLEY,21646
ELDORET EAST,Rural,Age NS,82,62,144,Uasin Gishu,RIFT VALLEY,21647
WARENG,Rural,0,2262,2299,4561,Uasin Gishu,RIFT VALLEY,21648
WARENG,Rural,1,1942,1860,3802,Uasin Gishu,RIFT VALLEY,21649
WARENG,Rural,2,2163,2208,4371,Uasin Gishu,RIFT VALLEY,21650
WARENG,Rural,3,2265,2261,4526,Uasin Gishu,RIFT VALLEY,21651
WARENG,Rural,4,2337,2149,4486,Uasin Gishu,RIFT VALLEY,21652
WARENG,Rural,5,2200,2098,4298,Uasin Gishu,RIFT VALLEY,21653
WARENG,Rural,6,2133,2134,4267,Uasin Gishu,RIFT VALLEY,21654
WARENG,Rural,7,2133,2117,4250,Uasin Gishu,RIFT VALLEY,21655
WARENG,Rural,8,1902,1908,3810,Uasin Gishu,RIFT VALLEY,21656
WARENG,Rural,9,2112,2005,4117,Uasin Gishu,RIFT VALLEY,21657
WARENG,Rural,10,2122,2029,4151,Uasin Gishu,RIFT VALLEY,21658
WARENG,Rural,11,1643,1535,3178,Uasin Gishu,RIFT VALLEY,21659
WARENG,Rural,12,2032,1879,3911,Uasin Gishu,RIFT VALLEY,21660
WARENG,Rural,13,1818,1770,3588,Uasin Gishu,RIFT VALLEY,21661
WARENG,Rural,14,1717,1740,3457,Uasin Gishu,RIFT VALLEY,21662
WARENG,Rural,15,1589,1632,3221,Uasin Gishu,RIFT VALLEY,21663
WARENG,Rural,16,1529,1585,3114,Uasin Gishu,RIFT VALLEY,21664
WARENG,Rural,17,1581,1533,3114,Uasin Gishu,RIFT VALLEY,21665
WARENG,Rural,18,1585,1491,3076,Uasin Gishu,RIFT VALLEY,21666
WARENG,Rural,19,1571,1484,3055,Uasin Gishu,RIFT VALLEY,21667
WARENG,Rural,20,2068,1974,4042,Uasin Gishu,RIFT VALLEY,21668
WARENG,Rural,21,1581,1497,3078,Uasin Gishu,RIFT VALLEY,21669
WARENG,Rural,22,1696,1679,3375,Uasin Gishu,RIFT VALLEY,21670
WARENG,Rural,23,1537,1439,2976,Uasin Gishu,RIFT VALLEY,21671
WARENG,Rural,24,1343,1348,2691,Uasin Gishu,RIFT VALLEY,21672
WARENG,Rural,25,1496,1499,2995,Uasin Gishu,RIFT VALLEY,21673
WARENG,Rural,26,1019,1040,2059,Uasin Gishu,RIFT VALLEY,21674
WARENG,Rural,27,1066,1021,2087,Uasin Gishu,RIFT VALLEY,21675
WARENG,Rural,28,849,947,1796,Uasin Gishu,RIFT VALLEY,21676
WARENG,Rural,29,780,882,1662,Uasin Gishu,RIFT VALLEY,21677
WARENG,Rural,30,1171,1290,2461,Uasin Gishu,RIFT VALLEY,21678
WARENG,Rural,31,753,687,1440,Uasin Gishu,RIFT VALLEY,21679
WARENG,Rural,32,939,954,1893,Uasin Gishu,RIFT VALLEY,21680
WARENG,Rural,33,654,673,1327,Uasin Gishu,RIFT VALLEY,21681
WARENG,Rural,34,720,664,1384,Uasin Gishu,RIFT VALLEY,21682
WARENG,Rural,35,1123,1119,2242,Uasin Gishu,RIFT VALLEY,21683
WARENG,Rural,36,641,653,1294,Uasin Gishu,RIFT VALLEY,21684
WARENG,Rural,37,655,586,1241,Uasin Gishu,RIFT VALLEY,21685
WARENG,Rural,38,550,585,1135,Uasin Gishu,RIFT VALLEY,21686
WARENG,Rural,39,605,576,1181,Uasin Gishu,RIFT VALLEY,21687
WARENG,Rural,40,804,848,1652,Uasin Gishu,RIFT VALLEY,21688
WARENG,Rural,41,433,406,839,Uasin Gishu,RIFT VALLEY,21689
WARENG,Rural,42,476,439,915,Uasin Gishu,RIFT VALLEY,21690
WARENG,Rural,43,380,401,781,Uasin Gishu,RIFT VALLEY,21691
WARENG,Rural,44,351,355,706,Uasin Gishu,RIFT VALLEY,21692
WARENG,Rural,45,607,613,1220,Uasin Gishu,RIFT VALLEY,21693
WARENG,Rural,46,411,369,780,Uasin Gishu,RIFT VALLEY,21694
WARENG,Rural,47,377,368,745,Uasin Gishu,RIFT VALLEY,21695
WARENG,Rural,48,387,493,880,Uasin Gishu,RIFT VALLEY,21696
WARENG,Rural,49,393,329,722,Uasin Gishu,RIFT VALLEY,21697
WARENG,Rural,50,482,543,1025,Uasin Gishu,RIFT VALLEY,21698
WARENG,Rural,51,271,252,523,Uasin Gishu,RIFT VALLEY,21699
WARENG,Rural,52,316,255,571,Uasin Gishu,RIFT VALLEY,21700
WARENG,Rural,53,250,205,455,Uasin Gishu,RIFT VALLEY,21701
WARENG,Rural,54,199,220,419,Uasin Gishu,RIFT VALLEY,21702
WARENG,Rural,55,305,337,642,Uasin Gishu,RIFT VALLEY,21703
WARENG,Rural,56,261,216,477,Uasin Gishu,RIFT VALLEY,21704
WARENG,Rural,57,304,293,597,Uasin Gishu,RIFT VALLEY,21705
WARENG,Rural,58,159,187,346,Uasin Gishu,RIFT VALLEY,21706
WARENG,Rural,59,224,171,395,Uasin Gishu,RIFT VALLEY,21707
WARENG,Rural,60,333,362,695,Uasin Gishu,RIFT VALLEY,21708
WARENG,Rural,61,194,154,348,Uasin Gishu,RIFT VALLEY,21709
WARENG,Rural,62,161,128,289,Uasin Gishu,RIFT VALLEY,21710
WARENG,Rural,63,129,123,252,Uasin Gishu,RIFT VALLEY,21711
WARENG,Rural,64,124,145,269,Uasin Gishu,RIFT VALLEY,21712
WARENG,Rural,65,193,240,433,Uasin Gishu,RIFT VALLEY,21713
WARENG,Rural,66,126,170,296,Uasin Gishu,RIFT VALLEY,21714
WARENG,Rural,67,138,130,268,Uasin Gishu,RIFT VALLEY,21715
WARENG,Rural,68,75,88,163,Uasin Gishu,RIFT VALLEY,21716
WARENG,Rural,69,128,130,258,Uasin Gishu,RIFT VALLEY,21717
WARENG,Rural,70,212,266,478,Uasin Gishu,RIFT VALLEY,21718
WARENG,Rural,71,78,72,150,Uasin Gishu,RIFT VALLEY,21719
WARENG,Rural,72,116,81,197,Uasin Gishu,RIFT VALLEY,21720
WARENG,Rural,73,86,85,171,Uasin Gishu,RIFT VALLEY,21721
WARENG,Rural,74,79,66,145,Uasin Gishu,RIFT VALLEY,21722
WARENG,Rural,75,109,125,234,Uasin Gishu,RIFT VALLEY,21723
WARENG,Rural,76,66,72,138,Uasin Gishu,RIFT VALLEY,21724
WARENG,Rural,77,66,55,121,Uasin Gishu,RIFT VALLEY,21725
WARENG,Rural,78,58,57,115,Uasin Gishu,RIFT VALLEY,21726
WARENG,Rural,79,69,101,170,Uasin Gishu,RIFT VALLEY,21727
WARENG,Rural,80+,752,1048,1800,Uasin Gishu,RIFT VALLEY,21728
WARENG,Rural,Age NS,50,24,74,Uasin Gishu,RIFT VALLEY,21729
MARAKWET,Rural,0,3716,3592,7308,Elgeyo Marakwet,RIFT VALLEY,21730
MARAKWET,Rural,1,2231,2222,4453,Elgeyo Marakwet,RIFT VALLEY,21731
MARAKWET,Rural,2,3451,3358,6809,Elgeyo Marakwet,RIFT VALLEY,21732
MARAKWET,Rural,3,2987,3081,6068,Elgeyo Marakwet,RIFT VALLEY,21733
MARAKWET,Rural,4,3240,3224,6464,Elgeyo Marakwet,RIFT VALLEY,21734
MARAKWET,Rural,5,3133,3072,6205,Elgeyo Marakwet,RIFT VALLEY,21735
MARAKWET,Rural,6,3121,3025,6146,Elgeyo Marakwet,RIFT VALLEY,21736
MARAKWET,Rural,7,2808,2686,5494,Elgeyo Marakwet,RIFT VALLEY,21737
MARAKWET,Rural,8,2925,3008,5933,Elgeyo Marakwet,RIFT VALLEY,21738
MARAKWET,Rural,9,2739,2662,5401,Elgeyo Marakwet,RIFT VALLEY,21739
MARAKWET,Rural,10,3298,3265,6563,Elgeyo Marakwet,RIFT VALLEY,21740
MARAKWET,Rural,11,2154,2211,4365,Elgeyo Marakwet,RIFT VALLEY,21741
MARAKWET,Rural,12,2986,2816,5802,Elgeyo Marakwet,RIFT VALLEY,21742
MARAKWET,Rural,13,2400,2335,4735,Elgeyo Marakwet,RIFT VALLEY,21743
MARAKWET,Rural,14,2570,2388,4958,Elgeyo Marakwet,RIFT VALLEY,21744
MARAKWET,Rural,15,2424,2271,4695,Elgeyo Marakwet,RIFT VALLEY,21745
MARAKWET,Rural,16,2281,2219,4500,Elgeyo Marakwet,RIFT VALLEY,21746
MARAKWET,Rural,17,1902,1695,3597,Elgeyo Marakwet,RIFT VALLEY,21747
MARAKWET,Rural,18,2131,1882,4013,Elgeyo Marakwet,RIFT VALLEY,21748
MARAKWET,Rural,19,1468,1343,2811,Elgeyo Marakwet,RIFT VALLEY,21749
MARAKWET,Rural,20,2043,2366,4409,Elgeyo Marakwet,RIFT VALLEY,21750
MARAKWET,Rural,21,1171,1282,2453,Elgeyo Marakwet,RIFT VALLEY,21751
MARAKWET,Rural,22,1499,1819,3318,Elgeyo Marakwet,RIFT VALLEY,21752
MARAKWET,Rural,23,1314,1435,2749,Elgeyo Marakwet,RIFT VALLEY,21753
MARAKWET,Rural,24,1340,1490,2830,Elgeyo Marakwet,RIFT VALLEY,21754
MARAKWET,Rural,25,1653,1815,3468,Elgeyo Marakwet,RIFT VALLEY,21755
MARAKWET,Rural,26,1102,1252,2354,Elgeyo Marakwet,RIFT VALLEY,21756
MARAKWET,Rural,27,1056,1012,2068,Elgeyo Marakwet,RIFT VALLEY,21757
MARAKWET,Rural,28,1016,1321,2337,Elgeyo Marakwet,RIFT VALLEY,21758
MARAKWET,Rural,29,757,844,1601,Elgeyo Marakwet,RIFT VALLEY,21759
MARAKWET,Rural,30,1525,1635,3160,Elgeyo Marakwet,RIFT VALLEY,21760
MARAKWET,Rural,31,726,616,1342,Elgeyo Marakwet,RIFT VALLEY,21761
MARAKWET,Rural,32,1034,1074,2108,Elgeyo Marakwet,RIFT VALLEY,21762
MARAKWET,Rural,33,624,648,1272,Elgeyo Marakwet,RIFT VALLEY,21763
MARAKWET,Rural,34,674,671,1345,Elgeyo Marakwet,RIFT VALLEY,21764
MARAKWET,Rural,35,1505,1411,2916,Elgeyo Marakwet,RIFT VALLEY,21765
MARAKWET,Rural,36,609,610,1219,Elgeyo Marakwet,RIFT VALLEY,21766
MARAKWET,Rural,37,620,602,1222,Elgeyo Marakwet,RIFT VALLEY,21767
MARAKWET,Rural,38,520,663,1183,Elgeyo Marakwet,RIFT VALLEY,21768
MARAKWET,Rural,39,441,469,910,Elgeyo Marakwet,RIFT VALLEY,21769
MARAKWET,Rural,40,1087,1215,2302,Elgeyo Marakwet,RIFT VALLEY,21770
MARAKWET,Rural,41,359,341,700,Elgeyo Marakwet,RIFT VALLEY,21771
MARAKWET,Rural,42,503,515,1018,Elgeyo Marakwet,RIFT VALLEY,21772
MARAKWET,Rural,43,324,320,644,Elgeyo Marakwet,RIFT VALLEY,21773
MARAKWET,Rural,44,373,355,728,Elgeyo Marakwet,RIFT VALLEY,21774
MARAKWET,Rural,45,762,879,1641,Elgeyo Marakwet,RIFT VALLEY,21775
MARAKWET,Rural,46,435,440,875,Elgeyo Marakwet,RIFT VALLEY,21776
MARAKWET,Rural,47,426,379,805,Elgeyo Marakwet,RIFT VALLEY,21777
MARAKWET,Rural,48,606,684,1290,Elgeyo Marakwet,RIFT VALLEY,21778
MARAKWET,Rural,49,432,357,789,Elgeyo Marakwet,RIFT VALLEY,21779
MARAKWET,Rural,50,844,887,1731,Elgeyo Marakwet,RIFT VALLEY,21780
MARAKWET,Rural,51,298,252,550,Elgeyo Marakwet,RIFT VALLEY,21781
MARAKWET,Rural,52,348,349,697,Elgeyo Marakwet,RIFT VALLEY,21782
MARAKWET,Rural,53,299,251,550,Elgeyo Marakwet,RIFT VALLEY,21783
MARAKWET,Rural,54,282,296,578,Elgeyo Marakwet,RIFT VALLEY,21784
MARAKWET,Rural,55,439,509,948,Elgeyo Marakwet,RIFT VALLEY,21785
MARAKWET,Rural,56,314,303,617,Elgeyo Marakwet,RIFT VALLEY,21786
MARAKWET,Rural,57,333,246,579,Elgeyo Marakwet,RIFT VALLEY,21787
MARAKWET,Rural,58,254,302,556,Elgeyo Marakwet,RIFT VALLEY,21788
MARAKWET,Rural,59,250,233,483,Elgeyo Marakwet,RIFT VALLEY,21789
MARAKWET,Rural,60,654,798,1452,Elgeyo Marakwet,RIFT VALLEY,21790
MARAKWET,Rural,61,248,215,463,Elgeyo Marakwet,RIFT VALLEY,21791
MARAKWET,Rural,62,234,199,433,Elgeyo Marakwet,RIFT VALLEY,21792
MARAKWET,Rural,63,190,167,357,Elgeyo Marakwet,RIFT VALLEY,21793
MARAKWET,Rural,64,205,212,417,Elgeyo Marakwet,RIFT VALLEY,21794
MARAKWET,Rural,65,334,492,826,Elgeyo Marakwet,RIFT VALLEY,21795
MARAKWET,Rural,66,165,151,316,Elgeyo Marakwet,RIFT VALLEY,21796
MARAKWET,Rural,67,187,162,349,Elgeyo Marakwet,RIFT VALLEY,21797
MARAKWET,Rural,68,173,234,407,Elgeyo Marakwet,RIFT VALLEY,21798
MARAKWET,Rural,69,149,191,340,Elgeyo Marakwet,RIFT VALLEY,21799
MARAKWET,Rural,70,439,540,979,Elgeyo Marakwet,RIFT VALLEY,21800
MARAKWET,Rural,71,76,98,174,Elgeyo Marakwet,RIFT VALLEY,21801
MARAKWET,Rural,72,136,137,273,Elgeyo Marakwet,RIFT VALLEY,21802
MARAKWET,Rural,73,101,101,202,Elgeyo Marakwet,RIFT VALLEY,21803
MARAKWET,Rural,74,117,118,235,Elgeyo Marakwet,RIFT VALLEY,21804
MARAKWET,Rural,75,184,212,396,Elgeyo Marakwet,RIFT VALLEY,21805
MARAKWET,Rural,76,90,73,163,Elgeyo Marakwet,RIFT VALLEY,21806
MARAKWET,Rural,77,71,52,123,Elgeyo Marakwet,RIFT VALLEY,21807
MARAKWET,Rural,78,106,109,215,Elgeyo Marakwet,RIFT VALLEY,21808
MARAKWET,Rural,79,103,143,246,Elgeyo Marakwet,RIFT VALLEY,21809
MARAKWET,Rural,80+,984,1382,2366,Elgeyo Marakwet,RIFT VALLEY,21810
MARAKWET,Rural,Age NS,28,33,61,Elgeyo Marakwet,RIFT VALLEY,21811
KEIYO,Rural,0,2259,2174,4433,Elgeyo Marakwet,RIFT VALLEY,21812
KEIYO,Rural,1,1990,1896,3886,Elgeyo Marakwet,RIFT VALLEY,21813
KEIYO,Rural,2,2300,2305,4605,Elgeyo Marakwet,RIFT VALLEY,21814
KEIYO,Rural,3,2248,2282,4530,Elgeyo Marakwet,RIFT VALLEY,21815
KEIYO,Rural,4,2220,2180,4400,Elgeyo Marakwet,RIFT VALLEY,21816
KEIYO,Rural,5,2311,2097,4408,Elgeyo Marakwet,RIFT VALLEY,21817
KEIYO,Rural,6,2151,2094,4245,Elgeyo Marakwet,RIFT VALLEY,21818
KEIYO,Rural,7,2130,2055,4185,Elgeyo Marakwet,RIFT VALLEY,21819
KEIYO,Rural,8,2005,2135,4140,Elgeyo Marakwet,RIFT VALLEY,21820
KEIYO,Rural,9,2162,2113,4275,Elgeyo Marakwet,RIFT VALLEY,21821
KEIYO,Rural,10,2263,2061,4324,Elgeyo Marakwet,RIFT VALLEY,21822
KEIYO,Rural,11,1721,1728,3449,Elgeyo Marakwet,RIFT VALLEY,21823
KEIYO,Rural,12,2172,2146,4318,Elgeyo Marakwet,RIFT VALLEY,21824
KEIYO,Rural,13,1872,1919,3791,Elgeyo Marakwet,RIFT VALLEY,21825
KEIYO,Rural,14,1894,1872,3766,Elgeyo Marakwet,RIFT VALLEY,21826
KEIYO,Rural,15,1731,1736,3467,Elgeyo Marakwet,RIFT VALLEY,21827
KEIYO,Rural,16,1615,1675,3290,Elgeyo Marakwet,RIFT VALLEY,21828
KEIYO,Rural,17,1575,1535,3110,Elgeyo Marakwet,RIFT VALLEY,21829
KEIYO,Rural,18,1553,1416,2969,Elgeyo Marakwet,RIFT VALLEY,21830
KEIYO,Rural,19,1346,1210,2556,Elgeyo Marakwet,RIFT VALLEY,21831
KEIYO,Rural,20,1467,1415,2882,Elgeyo Marakwet,RIFT VALLEY,21832
KEIYO,Rural,21,1128,998,2126,Elgeyo Marakwet,RIFT VALLEY,21833
KEIYO,Rural,22,1163,1310,2473,Elgeyo Marakwet,RIFT VALLEY,21834
KEIYO,Rural,23,1099,1204,2303,Elgeyo Marakwet,RIFT VALLEY,21835
KEIYO,Rural,24,1066,1109,2175,Elgeyo Marakwet,RIFT VALLEY,21836
KEIYO,Rural,25,1355,1426,2781,Elgeyo Marakwet,RIFT VALLEY,21837
KEIYO,Rural,26,897,944,1841,Elgeyo Marakwet,RIFT VALLEY,21838
KEIYO,Rural,27,1013,949,1962,Elgeyo Marakwet,RIFT VALLEY,21839
KEIYO,Rural,28,789,940,1729,Elgeyo Marakwet,RIFT VALLEY,21840
KEIYO,Rural,29,852,826,1678,Elgeyo Marakwet,RIFT VALLEY,21841
KEIYO,Rural,30,1146,1308,2454,Elgeyo Marakwet,RIFT VALLEY,21842
KEIYO,Rural,31,777,676,1453,Elgeyo Marakwet,RIFT VALLEY,21843
KEIYO,Rural,32,812,812,1624,Elgeyo Marakwet,RIFT VALLEY,21844
KEIYO,Rural,33,624,645,1269,Elgeyo Marakwet,RIFT VALLEY,21845
KEIYO,Rural,34,582,656,1238,Elgeyo Marakwet,RIFT VALLEY,21846
KEIYO,Rural,35,1156,1019,2175,Elgeyo Marakwet,RIFT VALLEY,21847
KEIYO,Rural,36,574,529,1103,Elgeyo Marakwet,RIFT VALLEY,21848
KEIYO,Rural,37,606,574,1180,Elgeyo Marakwet,RIFT VALLEY,21849
KEIYO,Rural,38,438,539,977,Elgeyo Marakwet,RIFT VALLEY,21850
KEIYO,Rural,39,446,512,958,Elgeyo Marakwet,RIFT VALLEY,21851
KEIYO,Rural,40,832,791,1623,Elgeyo Marakwet,RIFT VALLEY,21852
KEIYO,Rural,41,371,378,749,Elgeyo Marakwet,RIFT VALLEY,21853
KEIYO,Rural,42,409,404,813,Elgeyo Marakwet,RIFT VALLEY,21854
KEIYO,Rural,43,302,332,634,Elgeyo Marakwet,RIFT VALLEY,21855
KEIYO,Rural,44,369,357,726,Elgeyo Marakwet,RIFT VALLEY,21856
KEIYO,Rural,45,564,638,1202,Elgeyo Marakwet,RIFT VALLEY,21857
KEIYO,Rural,46,351,381,732,Elgeyo Marakwet,RIFT VALLEY,21858
KEIYO,Rural,47,333,399,732,Elgeyo Marakwet,RIFT VALLEY,21859
KEIYO,Rural,48,481,579,1060,Elgeyo Marakwet,RIFT VALLEY,21860
KEIYO,Rural,49,369,361,730,Elgeyo Marakwet,RIFT VALLEY,21861
KEIYO,Rural,50,575,638,1213,Elgeyo Marakwet,RIFT VALLEY,21862
KEIYO,Rural,51,357,247,604,Elgeyo Marakwet,RIFT VALLEY,21863
KEIYO,Rural,52,315,289,604,Elgeyo Marakwet,RIFT VALLEY,21864
KEIYO,Rural,53,228,254,482,Elgeyo Marakwet,RIFT VALLEY,21865
KEIYO,Rural,54,242,255,497,Elgeyo Marakwet,RIFT VALLEY,21866
KEIYO,Rural,55,406,369,775,Elgeyo Marakwet,RIFT VALLEY,21867
KEIYO,Rural,56,221,225,446,Elgeyo Marakwet,RIFT VALLEY,21868
KEIYO,Rural,57,384,293,677,Elgeyo Marakwet,RIFT VALLEY,21869
KEIYO,Rural,58,183,171,354,Elgeyo Marakwet,RIFT VALLEY,21870
KEIYO,Rural,59,248,220,468,Elgeyo Marakwet,RIFT VALLEY,21871
KEIYO,Rural,60,411,475,886,Elgeyo Marakwet,RIFT VALLEY,21872
KEIYO,Rural,61,216,190,406,Elgeyo Marakwet,RIFT VALLEY,21873
KEIYO,Rural,62,167,135,302,Elgeyo Marakwet,RIFT VALLEY,21874
KEIYO,Rural,63,150,105,255,Elgeyo Marakwet,RIFT VALLEY,21875
KEIYO,Rural,64,146,188,334,Elgeyo Marakwet,RIFT VALLEY,21876
KEIYO,Rural,65,254,304,558,Elgeyo Marakwet,RIFT VALLEY,21877
KEIYO,Rural,66,171,179,350,Elgeyo Marakwet,RIFT VALLEY,21878
KEIYO,Rural,67,159,133,292,Elgeyo Marakwet,RIFT VALLEY,21879
KEIYO,Rural,68,100,115,215,Elgeyo Marakwet,RIFT VALLEY,21880
KEIYO,Rural,69,129,141,270,Elgeyo Marakwet,RIFT VALLEY,21881
KEIYO,Rural,70,284,322,606,Elgeyo Marakwet,RIFT VALLEY,21882
KEIYO,Rural,71,70,98,168,Elgeyo Marakwet,RIFT VALLEY,21883
KEIYO,Rural,72,87,91,178,Elgeyo Marakwet,RIFT VALLEY,21884
KEIYO,Rural,73,75,52,127,Elgeyo Marakwet,RIFT VALLEY,21885
KEIYO,Rural,74,94,96,190,Elgeyo Marakwet,RIFT VALLEY,21886
KEIYO,Rural,75,98,172,270,Elgeyo Marakwet,RIFT VALLEY,21887
KEIYO,Rural,76,67,67,134,Elgeyo Marakwet,RIFT VALLEY,21888
KEIYO,Rural,77,56,57,113,Elgeyo Marakwet,RIFT VALLEY,21889
KEIYO,Rural,78,81,61,142,Elgeyo Marakwet,RIFT VALLEY,21890
KEIYO,Rural,79,95,124,219,Elgeyo Marakwet,RIFT VALLEY,21891
KEIYO,Rural,80+,680,988,1668,Elgeyo Marakwet,RIFT VALLEY,21892
KEIYO,Rural,Age NS,11,11,22,Elgeyo Marakwet,RIFT VALLEY,21893
NANDI NORTH,Rural,0,2568,2412,4980,Nandi,RIFT VALLEY,21894
NANDI NORTH,Rural,1,2507,2435,4942,Nandi,RIFT VALLEY,21895
NANDI NORTH,Rural,2,2869,2750,5619,Nandi,RIFT VALLEY,21896
NANDI NORTH,Rural,3,2746,2700,5446,Nandi,RIFT VALLEY,21897
NANDI NORTH,Rural,4,2683,2586,5269,Nandi,RIFT VALLEY,21898
NANDI NORTH,Rural,5,2689,2490,5179,Nandi,RIFT VALLEY,21899
NANDI NORTH,Rural,6,2562,2402,4964,Nandi,RIFT VALLEY,21900
NANDI NORTH,Rural,7,2488,2376,4864,Nandi,RIFT VALLEY,21901
NANDI NORTH,Rural,8,2282,2296,4578,Nandi,RIFT VALLEY,21902
NANDI NORTH,Rural,9,2456,2366,4822,Nandi,RIFT VALLEY,21903
NANDI NORTH,Rural,10,2371,2384,4755,Nandi,RIFT VALLEY,21904
NANDI NORTH,Rural,11,1998,2016,4014,Nandi,RIFT VALLEY,21905
NANDI NORTH,Rural,12,2356,2344,4700,Nandi,RIFT VALLEY,21906
NANDI NORTH,Rural,13,2209,2183,4392,Nandi,RIFT VALLEY,21907
NANDI NORTH,Rural,14,1947,1930,3877,Nandi,RIFT VALLEY,21908
NANDI NORTH,Rural,15,1813,1780,3593,Nandi,RIFT VALLEY,21909
NANDI NORTH,Rural,16,1690,1660,3350,Nandi,RIFT VALLEY,21910
NANDI NORTH,Rural,17,1897,1738,3635,Nandi,RIFT VALLEY,21911
NANDI NORTH,Rural,18,1811,1565,3376,Nandi,RIFT VALLEY,21912
NANDI NORTH,Rural,19,1640,1553,3193,Nandi,RIFT VALLEY,21913
NANDI NORTH,Rural,20,1742,1871,3613,Nandi,RIFT VALLEY,21914
NANDI NORTH,Rural,21,1331,1360,2691,Nandi,RIFT VALLEY,21915
NANDI NORTH,Rural,22,1527,1550,3077,Nandi,RIFT VALLEY,21916
NANDI NORTH,Rural,23,1327,1575,2902,Nandi,RIFT VALLEY,21917
NANDI NORTH,Rural,24,1373,1458,2831,Nandi,RIFT VALLEY,21918
NANDI NORTH,Rural,25,1407,1620,3027,Nandi,RIFT VALLEY,21919
NANDI NORTH,Rural,26,1134,1133,2267,Nandi,RIFT VALLEY,21920
NANDI NORTH,Rural,27,1243,1206,2449,Nandi,RIFT VALLEY,21921
NANDI NORTH,Rural,28,940,971,1911,Nandi,RIFT VALLEY,21922
NANDI NORTH,Rural,29,1027,1106,2133,Nandi,RIFT VALLEY,21923
NANDI NORTH,Rural,30,1241,1334,2575,Nandi,RIFT VALLEY,21924
NANDI NORTH,Rural,31,956,845,1801,Nandi,RIFT VALLEY,21925
NANDI NORTH,Rural,32,911,1021,1932,Nandi,RIFT VALLEY,21926
NANDI NORTH,Rural,33,836,823,1659,Nandi,RIFT VALLEY,21927
NANDI NORTH,Rural,34,797,809,1606,Nandi,RIFT VALLEY,21928
NANDI NORTH,Rural,35,1211,1085,2296,Nandi,RIFT VALLEY,21929
NANDI NORTH,Rural,36,715,755,1470,Nandi,RIFT VALLEY,21930
NANDI NORTH,Rural,37,802,752,1554,Nandi,RIFT VALLEY,21931
NANDI NORTH,Rural,38,566,699,1265,Nandi,RIFT VALLEY,21932
NANDI NORTH,Rural,39,697,701,1398,Nandi,RIFT VALLEY,21933
NANDI NORTH,Rural,40,863,853,1716,Nandi,RIFT VALLEY,21934
NANDI NORTH,Rural,41,552,521,1073,Nandi,RIFT VALLEY,21935
NANDI NORTH,Rural,42,482,502,984,Nandi,RIFT VALLEY,21936
NANDI NORTH,Rural,43,448,523,971,Nandi,RIFT VALLEY,21937
NANDI NORTH,Rural,44,417,393,810,Nandi,RIFT VALLEY,21938
NANDI NORTH,Rural,45,618,617,1235,Nandi,RIFT VALLEY,21939
NANDI NORTH,Rural,46,441,529,970,Nandi,RIFT VALLEY,21940
NANDI NORTH,Rural,47,453,515,968,Nandi,RIFT VALLEY,21941
NANDI NORTH,Rural,48,436,496,932,Nandi,RIFT VALLEY,21942
NANDI NORTH,Rural,49,409,413,822,Nandi,RIFT VALLEY,21943
NANDI NORTH,Rural,50,556,534,1090,Nandi,RIFT VALLEY,21944
NANDI NORTH,Rural,51,352,322,674,Nandi,RIFT VALLEY,21945
NANDI NORTH,Rural,52,345,351,696,Nandi,RIFT VALLEY,21946
NANDI NORTH,Rural,53,289,331,620,Nandi,RIFT VALLEY,21947
NANDI NORTH,Rural,54,284,303,587,Nandi,RIFT VALLEY,21948
NANDI NORTH,Rural,55,378,402,780,Nandi,RIFT VALLEY,21949
NANDI NORTH,Rural,56,258,283,541,Nandi,RIFT VALLEY,21950
NANDI NORTH,Rural,57,370,386,756,Nandi,RIFT VALLEY,21951
NANDI NORTH,Rural,58,163,180,343,Nandi,RIFT VALLEY,21952
NANDI NORTH,Rural,59,274,265,539,Nandi,RIFT VALLEY,21953
NANDI NORTH,Rural,60,294,396,690,Nandi,RIFT VALLEY,21954
NANDI NORTH,Rural,61,254,256,510,Nandi,RIFT VALLEY,21955
NANDI NORTH,Rural,62,199,184,383,Nandi,RIFT VALLEY,21956
NANDI NORTH,Rural,63,194,170,364,Nandi,RIFT VALLEY,21957
NANDI NORTH,Rural,64,176,217,393,Nandi,RIFT VALLEY,21958
NANDI NORTH,Rural,65,209,271,480,Nandi,RIFT VALLEY,21959
NANDI NORTH,Rural,66,182,219,401,Nandi,RIFT VALLEY,21960
NANDI NORTH,Rural,67,217,191,408,Nandi,RIFT VALLEY,21961
NANDI NORTH,Rural,68,122,108,230,Nandi,RIFT VALLEY,21962
NANDI NORTH,Rural,69,144,152,296,Nandi,RIFT VALLEY,21963
NANDI NORTH,Rural,70,226,288,514,Nandi,RIFT VALLEY,21964
NANDI NORTH,Rural,71,93,90,183,Nandi,RIFT VALLEY,21965
NANDI NORTH,Rural,72,155,77,232,Nandi,RIFT VALLEY,21966
NANDI NORTH,Rural,73,129,99,228,Nandi,RIFT VALLEY,21967
NANDI NORTH,Rural,74,99,104,203,Nandi,RIFT VALLEY,21968
NANDI NORTH,Rural,75,146,175,321,Nandi,RIFT VALLEY,21969
NANDI NORTH,Rural,76,94,87,181,Nandi,RIFT VALLEY,21970
NANDI NORTH,Rural,77,105,84,189,Nandi,RIFT VALLEY,21971
NANDI NORTH,Rural,78,67,87,154,Nandi,RIFT VALLEY,21972
NANDI NORTH,Rural,79,98,181,279,Nandi,RIFT VALLEY,21973
NANDI NORTH,Rural,80+,1183,1554,2737,Nandi,RIFT VALLEY,21974
NANDI NORTH,Rural,Age NS,60,57,117,Nandi,RIFT VALLEY,21975
NANDI CENTRAL,Rural,0,2388,2332,4720,Nandi,RIFT VALLEY,21976
NANDI CENTRAL,Rural,1,2223,2133,4356,Nandi,RIFT VALLEY,21977
NANDI CENTRAL,Rural,2,2570,2459,5029,Nandi,RIFT VALLEY,21978
NANDI CENTRAL,Rural,3,2420,2408,4828,Nandi,RIFT VALLEY,21979
NANDI CENTRAL,Rural,4,2367,2404,4771,Nandi,RIFT VALLEY,21980
NANDI CENTRAL,Rural,5,2444,2309,4753,Nandi,RIFT VALLEY,21981
NANDI CENTRAL,Rural,6,2283,2274,4557,Nandi,RIFT VALLEY,21982
NANDI CENTRAL,Rural,7,2197,2166,4363,Nandi,RIFT VALLEY,21983
NANDI CENTRAL,Rural,8,2044,2163,4207,Nandi,RIFT VALLEY,21984
NANDI CENTRAL,Rural,9,2206,2276,4482,Nandi,RIFT VALLEY,21985
NANDI CENTRAL,Rural,10,2280,2255,4535,Nandi,RIFT VALLEY,21986
NANDI CENTRAL,Rural,11,1788,1650,3438,Nandi,RIFT VALLEY,21987
NANDI CENTRAL,Rural,12,2076,2053,4129,Nandi,RIFT VALLEY,21988
NANDI CENTRAL,Rural,13,1839,1959,3798,Nandi,RIFT VALLEY,21989
NANDI CENTRAL,Rural,14,1640,1700,3340,Nandi,RIFT VALLEY,21990
NANDI CENTRAL,Rural,15,1726,1623,3349,Nandi,RIFT VALLEY,21991
NANDI CENTRAL,Rural,16,1597,1561,3158,Nandi,RIFT VALLEY,21992
NANDI CENTRAL,Rural,17,1691,1506,3197,Nandi,RIFT VALLEY,21993
NANDI CENTRAL,Rural,18,1759,1502,3261,Nandi,RIFT VALLEY,21994
NANDI CENTRAL,Rural,19,1485,1287,2772,Nandi,RIFT VALLEY,21995
NANDI CENTRAL,Rural,20,1447,1557,3004,Nandi,RIFT VALLEY,21996
NANDI CENTRAL,Rural,21,1151,1182,2333,Nandi,RIFT VALLEY,21997
NANDI CENTRAL,Rural,22,1223,1431,2654,Nandi,RIFT VALLEY,21998
NANDI CENTRAL,Rural,23,1112,1346,2458,Nandi,RIFT VALLEY,21999
NANDI CENTRAL,Rural,24,1013,1245,2258,Nandi,RIFT VALLEY,22000
NANDI CENTRAL,Rural,25,1253,1439,2692,Nandi,RIFT VALLEY,22001
NANDI CENTRAL,Rural,26,929,1001,1930,Nandi,RIFT VALLEY,22002
NANDI CENTRAL,Rural,27,1033,1056,2089,Nandi,RIFT VALLEY,22003
NANDI CENTRAL,Rural,28,791,963,1754,Nandi,RIFT VALLEY,22004
NANDI CENTRAL,Rural,29,855,950,1805,Nandi,RIFT VALLEY,22005
NANDI CENTRAL,Rural,30,1084,1209,2293,Nandi,RIFT VALLEY,22006
NANDI CENTRAL,Rural,31,807,754,1561,Nandi,RIFT VALLEY,22007
NANDI CENTRAL,Rural,32,835,861,1696,Nandi,RIFT VALLEY,22008
NANDI CENTRAL,Rural,33,691,645,1336,Nandi,RIFT VALLEY,22009
NANDI CENTRAL,Rural,34,699,712,1411,Nandi,RIFT VALLEY,22010
NANDI CENTRAL,Rural,35,941,997,1938,Nandi,RIFT VALLEY,22011
NANDI CENTRAL,Rural,36,594,624,1218,Nandi,RIFT VALLEY,22012
NANDI CENTRAL,Rural,37,642,662,1304,Nandi,RIFT VALLEY,22013
NANDI CENTRAL,Rural,38,568,584,1152,Nandi,RIFT VALLEY,22014
NANDI CENTRAL,Rural,39,547,604,1151,Nandi,RIFT VALLEY,22015
NANDI CENTRAL,Rural,40,731,812,1543,Nandi,RIFT VALLEY,22016
NANDI CENTRAL,Rural,41,466,431,897,Nandi,RIFT VALLEY,22017
NANDI CENTRAL,Rural,42,499,505,1004,Nandi,RIFT VALLEY,22018
NANDI CENTRAL,Rural,43,422,446,868,Nandi,RIFT VALLEY,22019
NANDI CENTRAL,Rural,44,324,379,703,Nandi,RIFT VALLEY,22020
NANDI CENTRAL,Rural,45,525,623,1148,Nandi,RIFT VALLEY,22021
NANDI CENTRAL,Rural,46,383,421,804,Nandi,RIFT VALLEY,22022
NANDI CENTRAL,Rural,47,402,436,838,Nandi,RIFT VALLEY,22023
NANDI CENTRAL,Rural,48,361,506,867,Nandi,RIFT VALLEY,22024
NANDI CENTRAL,Rural,49,411,426,837,Nandi,RIFT VALLEY,22025
NANDI CENTRAL,Rural,50,491,535,1026,Nandi,RIFT VALLEY,22026
NANDI CENTRAL,Rural,51,317,321,638,Nandi,RIFT VALLEY,22027
NANDI CENTRAL,Rural,52,308,334,642,Nandi,RIFT VALLEY,22028
NANDI CENTRAL,Rural,53,271,330,601,Nandi,RIFT VALLEY,22029
NANDI CENTRAL,Rural,54,278,297,575,Nandi,RIFT VALLEY,22030
NANDI CENTRAL,Rural,55,371,401,772,Nandi,RIFT VALLEY,22031
NANDI CENTRAL,Rural,56,259,251,510,Nandi,RIFT VALLEY,22032
NANDI CENTRAL,Rural,57,332,355,687,Nandi,RIFT VALLEY,22033
NANDI CENTRAL,Rural,58,184,163,347,Nandi,RIFT VALLEY,22034
NANDI CENTRAL,Rural,59,262,255,517,Nandi,RIFT VALLEY,22035
NANDI CENTRAL,Rural,60,301,343,644,Nandi,RIFT VALLEY,22036
NANDI CENTRAL,Rural,61,233,199,432,Nandi,RIFT VALLEY,22037
NANDI CENTRAL,Rural,62,172,162,334,Nandi,RIFT VALLEY,22038
NANDI CENTRAL,Rural,63,175,156,331,Nandi,RIFT VALLEY,22039
NANDI CENTRAL,Rural,64,146,198,344,Nandi,RIFT VALLEY,22040
NANDI CENTRAL,Rural,65,193,242,435,Nandi,RIFT VALLEY,22041
NANDI CENTRAL,Rural,66,136,192,328,Nandi,RIFT VALLEY,22042
NANDI CENTRAL,Rural,67,186,140,326,Nandi,RIFT VALLEY,22043
NANDI CENTRAL,Rural,68,83,102,185,Nandi,RIFT VALLEY,22044
NANDI CENTRAL,Rural,69,142,160,302,Nandi,RIFT VALLEY,22045
NANDI CENTRAL,Rural,70,213,238,451,Nandi,RIFT VALLEY,22046
NANDI CENTRAL,Rural,71,119,88,207,Nandi,RIFT VALLEY,22047
NANDI CENTRAL,Rural,72,93,109,202,Nandi,RIFT VALLEY,22048
NANDI CENTRAL,Rural,73,104,107,211,Nandi,RIFT VALLEY,22049
NANDI CENTRAL,Rural,74,81,81,162,Nandi,RIFT VALLEY,22050
NANDI CENTRAL,Rural,75,120,122,242,Nandi,RIFT VALLEY,22051
NANDI CENTRAL,Rural,76,76,71,147,Nandi,RIFT VALLEY,22052
NANDI CENTRAL,Rural,77,78,82,160,Nandi,RIFT VALLEY,22053
NANDI CENTRAL,Rural,78,57,66,123,Nandi,RIFT VALLEY,22054
NANDI CENTRAL,Rural,79,80,114,194,Nandi,RIFT VALLEY,22055
NANDI CENTRAL,Rural,80+,701,1016,1717,Nandi,RIFT VALLEY,22056
NANDI CENTRAL,Rural,Age NS,20,18,38,Nandi,RIFT VALLEY,22057
NANDI EAST,Rural,0,1911,1880,3791,Nandi,RIFT VALLEY,22058
NANDI EAST,Rural,1,1695,1715,3410,Nandi,RIFT VALLEY,22059
NANDI EAST,Rural,2,2081,1930,4011,Nandi,RIFT VALLEY,22060
NANDI EAST,Rural,3,1865,2013,3878,Nandi,RIFT VALLEY,22061
NANDI EAST,Rural,4,1981,1929,3910,Nandi,RIFT VALLEY,22062
NANDI EAST,Rural,5,1936,1863,3799,Nandi,RIFT VALLEY,22063
NANDI EAST,Rural,6,1804,1675,3479,Nandi,RIFT VALLEY,22064
NANDI EAST,Rural,7,1702,1646,3348,Nandi,RIFT VALLEY,22065
NANDI EAST,Rural,8,1549,1635,3184,Nandi,RIFT VALLEY,22066
NANDI EAST,Rural,9,1651,1664,3315,Nandi,RIFT VALLEY,22067
NANDI EAST,Rural,10,1639,1605,3244,Nandi,RIFT VALLEY,22068
NANDI EAST,Rural,11,1208,1265,2473,Nandi,RIFT VALLEY,22069
NANDI EAST,Rural,12,1535,1458,2993,Nandi,RIFT VALLEY,22070
NANDI EAST,Rural,13,1322,1458,2780,Nandi,RIFT VALLEY,22071
NANDI EAST,Rural,14,1301,1321,2622,Nandi,RIFT VALLEY,22072
NANDI EAST,Rural,15,1148,1158,2306,Nandi,RIFT VALLEY,22073
NANDI EAST,Rural,16,1151,1076,2227,Nandi,RIFT VALLEY,22074
NANDI EAST,Rural,17,1110,1090,2200,Nandi,RIFT VALLEY,22075
NANDI EAST,Rural,18,1124,1039,2163,Nandi,RIFT VALLEY,22076
NANDI EAST,Rural,19,1011,1106,2117,Nandi,RIFT VALLEY,22077
NANDI EAST,Rural,20,1128,1410,2538,Nandi,RIFT VALLEY,22078
NANDI EAST,Rural,21,893,1032,1925,Nandi,RIFT VALLEY,22079
NANDI EAST,Rural,22,1144,1311,2455,Nandi,RIFT VALLEY,22080
NANDI EAST,Rural,23,1064,1132,2196,Nandi,RIFT VALLEY,22081
NANDI EAST,Rural,24,1016,1063,2079,Nandi,RIFT VALLEY,22082
NANDI EAST,Rural,25,1168,1240,2408,Nandi,RIFT VALLEY,22083
NANDI EAST,Rural,26,946,914,1860,Nandi,RIFT VALLEY,22084
NANDI EAST,Rural,27,1052,867,1919,Nandi,RIFT VALLEY,22085
NANDI EAST,Rural,28,867,858,1725,Nandi,RIFT VALLEY,22086
NANDI EAST,Rural,29,877,774,1651,Nandi,RIFT VALLEY,22087
NANDI EAST,Rural,30,1118,1039,2157,Nandi,RIFT VALLEY,22088
NANDI EAST,Rural,31,778,600,1378,Nandi,RIFT VALLEY,22089
NANDI EAST,Rural,32,958,761,1719,Nandi,RIFT VALLEY,22090
NANDI EAST,Rural,33,743,565,1308,Nandi,RIFT VALLEY,22091
NANDI EAST,Rural,34,752,566,1318,Nandi,RIFT VALLEY,22092
NANDI EAST,Rural,35,1059,834,1893,Nandi,RIFT VALLEY,22093
NANDI EAST,Rural,36,655,531,1186,Nandi,RIFT VALLEY,22094
NANDI EAST,Rural,37,667,538,1205,Nandi,RIFT VALLEY,22095
NANDI EAST,Rural,38,574,478,1052,Nandi,RIFT VALLEY,22096
NANDI EAST,Rural,39,634,432,1066,Nandi,RIFT VALLEY,22097
NANDI EAST,Rural,40,715,599,1314,Nandi,RIFT VALLEY,22098
NANDI EAST,Rural,41,419,343,762,Nandi,RIFT VALLEY,22099
NANDI EAST,Rural,42,412,361,773,Nandi,RIFT VALLEY,22100
NANDI EAST,Rural,43,417,318,735,Nandi,RIFT VALLEY,22101
NANDI EAST,Rural,44,324,251,575,Nandi,RIFT VALLEY,22102
NANDI EAST,Rural,45,569,463,1032,Nandi,RIFT VALLEY,22103
NANDI EAST,Rural,46,378,264,642,Nandi,RIFT VALLEY,22104
NANDI EAST,Rural,47,386,292,678,Nandi,RIFT VALLEY,22105
NANDI EAST,Rural,48,409,368,777,Nandi,RIFT VALLEY,22106
NANDI EAST,Rural,49,397,281,678,Nandi,RIFT VALLEY,22107
NANDI EAST,Rural,50,421,354,775,Nandi,RIFT VALLEY,22108
NANDI EAST,Rural,51,275,182,457,Nandi,RIFT VALLEY,22109
NANDI EAST,Rural,52,247,172,419,Nandi,RIFT VALLEY,22110
NANDI EAST,Rural,53,224,134,358,Nandi,RIFT VALLEY,22111
NANDI EAST,Rural,54,207,157,364,Nandi,RIFT VALLEY,22112
NANDI EAST,Rural,55,276,206,482,Nandi,RIFT VALLEY,22113
NANDI EAST,Rural,56,159,102,261,Nandi,RIFT VALLEY,22114
NANDI EAST,Rural,57,232,197,429,Nandi,RIFT VALLEY,22115
NANDI EAST,Rural,58,133,112,245,Nandi,RIFT VALLEY,22116
NANDI EAST,Rural,59,189,114,303,Nandi,RIFT VALLEY,22117
NANDI EAST,Rural,60,178,218,396,Nandi,RIFT VALLEY,22118
NANDI EAST,Rural,61,145,103,248,Nandi,RIFT VALLEY,22119
NANDI EAST,Rural,62,107,76,183,Nandi,RIFT VALLEY,22120
NANDI EAST,Rural,63,96,67,163,Nandi,RIFT VALLEY,22121
NANDI EAST,Rural,64,91,110,201,Nandi,RIFT VALLEY,22122
NANDI EAST,Rural,65,108,132,240,Nandi,RIFT VALLEY,22123
NANDI EAST,Rural,66,91,73,164,Nandi,RIFT VALLEY,22124
NANDI EAST,Rural,67,107,92,199,Nandi,RIFT VALLEY,22125
NANDI EAST,Rural,68,62,40,102,Nandi,RIFT VALLEY,22126
NANDI EAST,Rural,69,65,92,157,Nandi,RIFT VALLEY,22127
NANDI EAST,Rural,70,139,133,272,Nandi,RIFT VALLEY,22128
NANDI EAST,Rural,71,61,47,108,Nandi,RIFT VALLEY,22129
NANDI EAST,Rural,72,63,55,118,Nandi,RIFT VALLEY,22130
NANDI EAST,Rural,73,74,38,112,Nandi,RIFT VALLEY,22131
NANDI EAST,Rural,74,46,48,94,Nandi,RIFT VALLEY,22132
NANDI EAST,Rural,75,58,64,122,Nandi,RIFT VALLEY,22133
NANDI EAST,Rural,76,48,42,90,Nandi,RIFT VALLEY,22134
NANDI EAST,Rural,77,58,32,90,Nandi,RIFT VALLEY,22135
NANDI EAST,Rural,78,48,44,92,Nandi,RIFT VALLEY,22136
NANDI EAST,Rural,79,64,88,152,Nandi,RIFT VALLEY,22137
NANDI EAST,Rural,80+,405,549,954,Nandi,RIFT VALLEY,22138
NANDI EAST,Rural,Age NS,21,13,34,Nandi,RIFT VALLEY,22139
NANDI SOUTH,Rural,0,2635,2550,5185,Nandi,RIFT VALLEY,22140
NANDI SOUTH,Rural,1,2422,2391,4813,Nandi,RIFT VALLEY,22141
NANDI SOUTH,Rural,2,2618,2649,5267,Nandi,RIFT VALLEY,22142
NANDI SOUTH,Rural,3,2782,2589,5371,Nandi,RIFT VALLEY,22143
NANDI SOUTH,Rural,4,2653,2607,5260,Nandi,RIFT VALLEY,22144
NANDI SOUTH,Rural,5,2637,2521,5158,Nandi,RIFT VALLEY,22145
NANDI SOUTH,Rural,6,2491,2468,4959,Nandi,RIFT VALLEY,22146
NANDI SOUTH,Rural,7,2513,2414,4927,Nandi,RIFT VALLEY,22147
NANDI SOUTH,Rural,8,2277,2415,4692,Nandi,RIFT VALLEY,22148
NANDI SOUTH,Rural,9,2575,2456,5031,Nandi,RIFT VALLEY,22149
NANDI SOUTH,Rural,10,2462,2513,4975,Nandi,RIFT VALLEY,22150
NANDI SOUTH,Rural,11,1884,1901,3785,Nandi,RIFT VALLEY,22151
NANDI SOUTH,Rural,12,2217,2247,4464,Nandi,RIFT VALLEY,22152
NANDI SOUTH,Rural,13,2193,2286,4479,Nandi,RIFT VALLEY,22153
NANDI SOUTH,Rural,14,1836,1888,3724,Nandi,RIFT VALLEY,22154
NANDI SOUTH,Rural,15,1930,1881,3811,Nandi,RIFT VALLEY,22155
NANDI SOUTH,Rural,16,1709,1844,3553,Nandi,RIFT VALLEY,22156
NANDI SOUTH,Rural,17,1874,1740,3614,Nandi,RIFT VALLEY,22157
NANDI SOUTH,Rural,18,1851,1626,3477,Nandi,RIFT VALLEY,22158
NANDI SOUTH,Rural,19,1629,1551,3180,Nandi,RIFT VALLEY,22159
NANDI SOUTH,Rural,20,1657,1827,3484,Nandi,RIFT VALLEY,22160
NANDI SOUTH,Rural,21,1252,1417,2669,Nandi,RIFT VALLEY,22161
NANDI SOUTH,Rural,22,1410,1615,3025,Nandi,RIFT VALLEY,22162
NANDI SOUTH,Rural,23,1314,1541,2855,Nandi,RIFT VALLEY,22163
NANDI SOUTH,Rural,24,1223,1385,2608,Nandi,RIFT VALLEY,22164
NANDI SOUTH,Rural,25,1423,1494,2917,Nandi,RIFT VALLEY,22165
NANDI SOUTH,Rural,26,1011,1023,2034,Nandi,RIFT VALLEY,22166
NANDI SOUTH,Rural,27,1095,1167,2262,Nandi,RIFT VALLEY,22167
NANDI SOUTH,Rural,28,870,986,1856,Nandi,RIFT VALLEY,22168
NANDI SOUTH,Rural,29,937,912,1849,Nandi,RIFT VALLEY,22169
NANDI SOUTH,Rural,30,1112,1199,2311,Nandi,RIFT VALLEY,22170
NANDI SOUTH,Rural,31,830,810,1640,Nandi,RIFT VALLEY,22171
NANDI SOUTH,Rural,32,906,944,1850,Nandi,RIFT VALLEY,22172
NANDI SOUTH,Rural,33,715,761,1476,Nandi,RIFT VALLEY,22173
NANDI SOUTH,Rural,34,715,778,1493,Nandi,RIFT VALLEY,22174
NANDI SOUTH,Rural,35,1083,1135,2218,Nandi,RIFT VALLEY,22175
NANDI SOUTH,Rural,36,667,729,1396,Nandi,RIFT VALLEY,22176
NANDI SOUTH,Rural,37,686,705,1391,Nandi,RIFT VALLEY,22177
NANDI SOUTH,Rural,38,550,615,1165,Nandi,RIFT VALLEY,22178
NANDI SOUTH,Rural,39,634,619,1253,Nandi,RIFT VALLEY,22179
NANDI SOUTH,Rural,40,764,867,1631,Nandi,RIFT VALLEY,22180
NANDI SOUTH,Rural,41,556,483,1039,Nandi,RIFT VALLEY,22181
NANDI SOUTH,Rural,42,491,524,1015,Nandi,RIFT VALLEY,22182
NANDI SOUTH,Rural,43,390,509,899,Nandi,RIFT VALLEY,22183
NANDI SOUTH,Rural,44,434,408,842,Nandi,RIFT VALLEY,22184
NANDI SOUTH,Rural,45,614,673,1287,Nandi,RIFT VALLEY,22185
NANDI SOUTH,Rural,46,439,489,928,Nandi,RIFT VALLEY,22186
NANDI SOUTH,Rural,47,423,479,902,Nandi,RIFT VALLEY,22187
NANDI SOUTH,Rural,48,465,511,976,Nandi,RIFT VALLEY,22188
NANDI SOUTH,Rural,49,455,444,899,Nandi,RIFT VALLEY,22189
NANDI SOUTH,Rural,50,566,650,1216,Nandi,RIFT VALLEY,22190
NANDI SOUTH,Rural,51,400,338,738,Nandi,RIFT VALLEY,22191
NANDI SOUTH,Rural,52,370,337,707,Nandi,RIFT VALLEY,22192
NANDI SOUTH,Rural,53,308,339,647,Nandi,RIFT VALLEY,22193
NANDI SOUTH,Rural,54,299,307,606,Nandi,RIFT VALLEY,22194
NANDI SOUTH,Rural,55,414,480,894,Nandi,RIFT VALLEY,22195
NANDI SOUTH,Rural,56,308,266,574,Nandi,RIFT VALLEY,22196
NANDI SOUTH,Rural,57,426,412,838,Nandi,RIFT VALLEY,22197
NANDI SOUTH,Rural,58,224,186,410,Nandi,RIFT VALLEY,22198
NANDI SOUTH,Rural,59,273,278,551,Nandi,RIFT VALLEY,22199
NANDI SOUTH,Rural,60,363,434,797,Nandi,RIFT VALLEY,22200
NANDI SOUTH,Rural,61,284,265,549,Nandi,RIFT VALLEY,22201
NANDI SOUTH,Rural,62,216,178,394,Nandi,RIFT VALLEY,22202
NANDI SOUTH,Rural,63,198,146,344,Nandi,RIFT VALLEY,22203
NANDI SOUTH,Rural,64,211,218,429,Nandi,RIFT VALLEY,22204
NANDI SOUTH,Rural,65,253,244,497,Nandi,RIFT VALLEY,22205
NANDI SOUTH,Rural,66,201,192,393,Nandi,RIFT VALLEY,22206
NANDI SOUTH,Rural,67,196,178,374,Nandi,RIFT VALLEY,22207
NANDI SOUTH,Rural,68,107,102,209,Nandi,RIFT VALLEY,22208
NANDI SOUTH,Rural,69,153,204,357,Nandi,RIFT VALLEY,22209
NANDI SOUTH,Rural,70,239,276,515,Nandi,RIFT VALLEY,22210
NANDI SOUTH,Rural,71,114,126,240,Nandi,RIFT VALLEY,22211
NANDI SOUTH,Rural,72,119,99,218,Nandi,RIFT VALLEY,22212
NANDI SOUTH,Rural,73,134,109,243,Nandi,RIFT VALLEY,22213
NANDI SOUTH,Rural,74,115,136,251,Nandi,RIFT VALLEY,22214
NANDI SOUTH,Rural,75,121,146,267,Nandi,RIFT VALLEY,22215
NANDI SOUTH,Rural,76,104,119,223,Nandi,RIFT VALLEY,22216
NANDI SOUTH,Rural,77,100,89,189,Nandi,RIFT VALLEY,22217
NANDI SOUTH,Rural,78,66,67,133,Nandi,RIFT VALLEY,22218
NANDI SOUTH,Rural,79,105,171,276,Nandi,RIFT VALLEY,22219
NANDI SOUTH,Rural,80+,891,1051,1942,Nandi,RIFT VALLEY,22220
NANDI SOUTH,Rural,Age NS,22,29,51,Nandi,RIFT VALLEY,22221
TINDERET,Rural,0,1464,1427,2891,Nandi,RIFT VALLEY,22222
TINDERET,Rural,1,1321,1302,2623,Nandi,RIFT VALLEY,22223
TINDERET,Rural,2,1343,1347,2690,Nandi,RIFT VALLEY,22224
TINDERET,Rural,3,1425,1371,2796,Nandi,RIFT VALLEY,22225
TINDERET,Rural,4,1383,1438,2821,Nandi,RIFT VALLEY,22226
TINDERET,Rural,5,1416,1372,2788,Nandi,RIFT VALLEY,22227
TINDERET,Rural,6,1300,1194,2494,Nandi,RIFT VALLEY,22228
TINDERET,Rural,7,1297,1173,2470,Nandi,RIFT VALLEY,22229
TINDERET,Rural,8,1239,1160,2399,Nandi,RIFT VALLEY,22230
TINDERET,Rural,9,1267,1174,2441,Nandi,RIFT VALLEY,22231
TINDERET,Rural,10,1285,1232,2517,Nandi,RIFT VALLEY,22232
TINDERET,Rural,11,927,913,1840,Nandi,RIFT VALLEY,22233
TINDERET,Rural,12,1164,1192,2356,Nandi,RIFT VALLEY,22234
TINDERET,Rural,13,1030,1109,2139,Nandi,RIFT VALLEY,22235
TINDERET,Rural,14,967,994,1961,Nandi,RIFT VALLEY,22236
TINDERET,Rural,15,932,926,1858,Nandi,RIFT VALLEY,22237
TINDERET,Rural,16,875,851,1726,Nandi,RIFT VALLEY,22238
TINDERET,Rural,17,936,831,1767,Nandi,RIFT VALLEY,22239
TINDERET,Rural,18,929,806,1735,Nandi,RIFT VALLEY,22240
TINDERET,Rural,19,766,743,1509,Nandi,RIFT VALLEY,22241
TINDERET,Rural,20,846,953,1799,Nandi,RIFT VALLEY,22242
TINDERET,Rural,21,643,663,1306,Nandi,RIFT VALLEY,22243
TINDERET,Rural,22,755,799,1554,Nandi,RIFT VALLEY,22244
TINDERET,Rural,23,680,720,1400,Nandi,RIFT VALLEY,22245
TINDERET,Rural,24,610,642,1252,Nandi,RIFT VALLEY,22246
TINDERET,Rural,25,795,795,1590,Nandi,RIFT VALLEY,22247
TINDERET,Rural,26,603,499,1102,Nandi,RIFT VALLEY,22248
TINDERET,Rural,27,592,570,1162,Nandi,RIFT VALLEY,22249
TINDERET,Rural,28,450,425,875,Nandi,RIFT VALLEY,22250
TINDERET,Rural,29,512,394,906,Nandi,RIFT VALLEY,22251
TINDERET,Rural,30,619,609,1228,Nandi,RIFT VALLEY,22252
TINDERET,Rural,31,450,382,832,Nandi,RIFT VALLEY,22253
TINDERET,Rural,32,420,419,839,Nandi,RIFT VALLEY,22254
TINDERET,Rural,33,332,303,635,Nandi,RIFT VALLEY,22255
TINDERET,Rural,34,385,325,710,Nandi,RIFT VALLEY,22256
TINDERET,Rural,35,555,501,1056,Nandi,RIFT VALLEY,22257
TINDERET,Rural,36,319,263,582,Nandi,RIFT VALLEY,22258
TINDERET,Rural,37,360,296,656,Nandi,RIFT VALLEY,22259
TINDERET,Rural,38,274,252,526,Nandi,RIFT VALLEY,22260
TINDERET,Rural,39,266,275,541,Nandi,RIFT VALLEY,22261
TINDERET,Rural,40,356,374,730,Nandi,RIFT VALLEY,22262
TINDERET,Rural,41,223,209,432,Nandi,RIFT VALLEY,22263
TINDERET,Rural,42,214,214,428,Nandi,RIFT VALLEY,22264
TINDERET,Rural,43,150,169,319,Nandi,RIFT VALLEY,22265
TINDERET,Rural,44,172,176,348,Nandi,RIFT VALLEY,22266
TINDERET,Rural,45,303,295,598,Nandi,RIFT VALLEY,22267
TINDERET,Rural,46,191,172,363,Nandi,RIFT VALLEY,22268
TINDERET,Rural,47,154,187,341,Nandi,RIFT VALLEY,22269
TINDERET,Rural,48,232,359,591,Nandi,RIFT VALLEY,22270
TINDERET,Rural,49,173,158,331,Nandi,RIFT VALLEY,22271
TINDERET,Rural,50,240,258,498,Nandi,RIFT VALLEY,22272
TINDERET,Rural,51,158,136,294,Nandi,RIFT VALLEY,22273
TINDERET,Rural,52,173,144,317,Nandi,RIFT VALLEY,22274
TINDERET,Rural,53,127,102,229,Nandi,RIFT VALLEY,22275
TINDERET,Rural,54,126,134,260,Nandi,RIFT VALLEY,22276
TINDERET,Rural,55,167,190,357,Nandi,RIFT VALLEY,22277
TINDERET,Rural,56,119,98,217,Nandi,RIFT VALLEY,22278
TINDERET,Rural,57,166,150,316,Nandi,RIFT VALLEY,22279
TINDERET,Rural,58,68,77,145,Nandi,RIFT VALLEY,22280
TINDERET,Rural,59,127,103,230,Nandi,RIFT VALLEY,22281
TINDERET,Rural,60,164,158,322,Nandi,RIFT VALLEY,22282
TINDERET,Rural,61,124,90,214,Nandi,RIFT VALLEY,22283
TINDERET,Rural,62,89,61,150,Nandi,RIFT VALLEY,22284
TINDERET,Rural,63,72,57,129,Nandi,RIFT VALLEY,22285
TINDERET,Rural,64,63,73,136,Nandi,RIFT VALLEY,22286
TINDERET,Rural,65,87,109,196,Nandi,RIFT VALLEY,22287
TINDERET,Rural,66,47,41,88,Nandi,RIFT VALLEY,22288
TINDERET,Rural,67,96,55,151,Nandi,RIFT VALLEY,22289
TINDERET,Rural,68,54,39,93,Nandi,RIFT VALLEY,22290
TINDERET,Rural,69,71,90,161,Nandi,RIFT VALLEY,22291
TINDERET,Rural,70,119,118,237,Nandi,RIFT VALLEY,22292
TINDERET,Rural,71,35,25,60,Nandi,RIFT VALLEY,22293
TINDERET,Rural,72,52,33,85,Nandi,RIFT VALLEY,22294
TINDERET,Rural,73,48,33,81,Nandi,RIFT VALLEY,22295
TINDERET,Rural,74,47,47,94,Nandi,RIFT VALLEY,22296
TINDERET,Rural,75,54,44,98,Nandi,RIFT VALLEY,22297
TINDERET,Rural,76,30,32,62,Nandi,RIFT VALLEY,22298
TINDERET,Rural,77,39,27,66,Nandi,RIFT VALLEY,22299
TINDERET,Rural,78,31,23,54,Nandi,RIFT VALLEY,22300
TINDERET,Rural,79,45,56,101,Nandi,RIFT VALLEY,22301
TINDERET,Rural,80+,363,383,746,Nandi,RIFT VALLEY,22302
TINDERET,Rural,Age NS,8,7,15,Nandi,RIFT VALLEY,22303
LAIKIPIA NORTH,Rural,0,600,596,1196,Laikipia,RIFT VALLEY,22304
LAIKIPIA NORTH,Rural,1,445,439,884,Laikipia,RIFT VALLEY,22305
LAIKIPIA NORTH,Rural,2,669,626,1295,Laikipia,RIFT VALLEY,22306
LAIKIPIA NORTH,Rural,3,606,603,1209,Laikipia,RIFT VALLEY,22307
LAIKIPIA NORTH,Rural,4,685,597,1282,Laikipia,RIFT VALLEY,22308
LAIKIPIA NORTH,Rural,5,626,565,1191,Laikipia,RIFT VALLEY,22309
LAIKIPIA NORTH,Rural,6,630,561,1191,Laikipia,RIFT VALLEY,22310
LAIKIPIA NORTH,Rural,7,569,551,1120,Laikipia,RIFT VALLEY,22311
LAIKIPIA NORTH,Rural,8,641,573,1214,Laikipia,RIFT VALLEY,22312
LAIKIPIA NORTH,Rural,9,478,479,957,Laikipia,RIFT VALLEY,22313
LAIKIPIA NORTH,Rural,10,762,702,1464,Laikipia,RIFT VALLEY,22314
LAIKIPIA NORTH,Rural,11,335,326,661,Laikipia,RIFT VALLEY,22315
LAIKIPIA NORTH,Rural,12,576,527,1103,Laikipia,RIFT VALLEY,22316
LAIKIPIA NORTH,Rural,13,433,357,790,Laikipia,RIFT VALLEY,22317
LAIKIPIA NORTH,Rural,14,401,343,744,Laikipia,RIFT VALLEY,22318
LAIKIPIA NORTH,Rural,15,461,394,855,Laikipia,RIFT VALLEY,22319
LAIKIPIA NORTH,Rural,16,359,295,654,Laikipia,RIFT VALLEY,22320
LAIKIPIA NORTH,Rural,17,291,239,530,Laikipia,RIFT VALLEY,22321
LAIKIPIA NORTH,Rural,18,385,313,698,Laikipia,RIFT VALLEY,22322
LAIKIPIA NORTH,Rural,19,241,258,499,Laikipia,RIFT VALLEY,22323
LAIKIPIA NORTH,Rural,20,403,483,886,Laikipia,RIFT VALLEY,22324
LAIKIPIA NORTH,Rural,21,210,194,404,Laikipia,RIFT VALLEY,22325
LAIKIPIA NORTH,Rural,22,256,279,535,Laikipia,RIFT VALLEY,22326
LAIKIPIA NORTH,Rural,23,229,213,442,Laikipia,RIFT VALLEY,22327
LAIKIPIA NORTH,Rural,24,215,250,465,Laikipia,RIFT VALLEY,22328
LAIKIPIA NORTH,Rural,25,326,395,721,Laikipia,RIFT VALLEY,22329
LAIKIPIA NORTH,Rural,26,187,204,391,Laikipia,RIFT VALLEY,22330
LAIKIPIA NORTH,Rural,27,206,192,398,Laikipia,RIFT VALLEY,22331
LAIKIPIA NORTH,Rural,28,184,226,410,Laikipia,RIFT VALLEY,22332
LAIKIPIA NORTH,Rural,29,144,125,269,Laikipia,RIFT VALLEY,22333
LAIKIPIA NORTH,Rural,30,330,345,675,Laikipia,RIFT VALLEY,22334
LAIKIPIA NORTH,Rural,31,110,94,204,Laikipia,RIFT VALLEY,22335
LAIKIPIA NORTH,Rural,32,193,190,383,Laikipia,RIFT VALLEY,22336
LAIKIPIA NORTH,Rural,33,87,111,198,Laikipia,RIFT VALLEY,22337
LAIKIPIA NORTH,Rural,34,105,81,186,Laikipia,RIFT VALLEY,22338
LAIKIPIA NORTH,Rural,35,240,230,470,Laikipia,RIFT VALLEY,22339
LAIKIPIA NORTH,Rural,36,140,111,251,Laikipia,RIFT VALLEY,22340
LAIKIPIA NORTH,Rural,37,107,117,224,Laikipia,RIFT VALLEY,22341
LAIKIPIA NORTH,Rural,38,121,116,237,Laikipia,RIFT VALLEY,22342
LAIKIPIA NORTH,Rural,39,99,77,176,Laikipia,RIFT VALLEY,22343
LAIKIPIA NORTH,Rural,40,239,233,472,Laikipia,RIFT VALLEY,22344
LAIKIPIA NORTH,Rural,41,55,40,95,Laikipia,RIFT VALLEY,22345
LAIKIPIA NORTH,Rural,42,77,85,162,Laikipia,RIFT VALLEY,22346
LAIKIPIA NORTH,Rural,43,67,46,113,Laikipia,RIFT VALLEY,22347
LAIKIPIA NORTH,Rural,44,52,46,98,Laikipia,RIFT VALLEY,22348
LAIKIPIA NORTH,Rural,45,178,150,328,Laikipia,RIFT VALLEY,22349
LAIKIPIA NORTH,Rural,46,75,49,124,Laikipia,RIFT VALLEY,22350
LAIKIPIA NORTH,Rural,47,72,34,106,Laikipia,RIFT VALLEY,22351
LAIKIPIA NORTH,Rural,48,80,48,128,Laikipia,RIFT VALLEY,22352
LAIKIPIA NORTH,Rural,49,76,61,137,Laikipia,RIFT VALLEY,22353
LAIKIPIA NORTH,Rural,50,157,148,305,Laikipia,RIFT VALLEY,22354
LAIKIPIA NORTH,Rural,51,42,29,71,Laikipia,RIFT VALLEY,22355
LAIKIPIA NORTH,Rural,52,58,51,109,Laikipia,RIFT VALLEY,22356
LAIKIPIA NORTH,Rural,53,27,28,55,Laikipia,RIFT VALLEY,22357
LAIKIPIA NORTH,Rural,54,46,37,83,Laikipia,RIFT VALLEY,22358
LAIKIPIA NORTH,Rural,55,66,57,123,Laikipia,RIFT VALLEY,22359
LAIKIPIA NORTH,Rural,56,40,34,74,Laikipia,RIFT VALLEY,22360
LAIKIPIA NORTH,Rural,57,29,26,55,Laikipia,RIFT VALLEY,22361
LAIKIPIA NORTH,Rural,58,25,18,43,Laikipia,RIFT VALLEY,22362
LAIKIPIA NORTH,Rural,59,30,36,66,Laikipia,RIFT VALLEY,22363
LAIKIPIA NORTH,Rural,60,99,108,207,Laikipia,RIFT VALLEY,22364
LAIKIPIA NORTH,Rural,61,36,20,56,Laikipia,RIFT VALLEY,22365
LAIKIPIA NORTH,Rural,62,24,21,45,Laikipia,RIFT VALLEY,22366
LAIKIPIA NORTH,Rural,63,24,15,39,Laikipia,RIFT VALLEY,22367
LAIKIPIA NORTH,Rural,64,18,27,45,Laikipia,RIFT VALLEY,22368
LAIKIPIA NORTH,Rural,65,40,34,74,Laikipia,RIFT VALLEY,22369
LAIKIPIA NORTH,Rural,66,8,3,11,Laikipia,RIFT VALLEY,22370
LAIKIPIA NORTH,Rural,67,19,13,32,Laikipia,RIFT VALLEY,22371
LAIKIPIA NORTH,Rural,68,14,14,28,Laikipia,RIFT VALLEY,22372
LAIKIPIA NORTH,Rural,69,25,21,46,Laikipia,RIFT VALLEY,22373
LAIKIPIA NORTH,Rural,70,59,60,119,Laikipia,RIFT VALLEY,22374
LAIKIPIA NORTH,Rural,71,10,11,21,Laikipia,RIFT VALLEY,22375
LAIKIPIA NORTH,Rural,72,12,7,19,Laikipia,RIFT VALLEY,22376
LAIKIPIA NORTH,Rural,73,10,12,22,Laikipia,RIFT VALLEY,22377
LAIKIPIA NORTH,Rural,74,12,4,16,Laikipia,RIFT VALLEY,22378
LAIKIPIA NORTH,Rural,75,20,19,39,Laikipia,RIFT VALLEY,22379
LAIKIPIA NORTH,Rural,76,10,10,20,Laikipia,RIFT VALLEY,22380
LAIKIPIA NORTH,Rural,77,6,3,9,Laikipia,RIFT VALLEY,22381
LAIKIPIA NORTH,Rural,78,7,9,16,Laikipia,RIFT VALLEY,22382
LAIKIPIA NORTH,Rural,79,14,5,19,Laikipia,RIFT VALLEY,22383
LAIKIPIA NORTH,Rural,80+,111,130,241,Laikipia,RIFT VALLEY,22384
LAIKIPIA NORTH,Rural,Age NS,4,2,6,Laikipia,RIFT VALLEY,22385
LAIKIPIA EAST,Rural,0,1297,1210,2507,Laikipia,RIFT VALLEY,22386
LAIKIPIA EAST,Rural,1,1184,1116,2300,Laikipia,RIFT VALLEY,22387
LAIKIPIA EAST,Rural,2,1320,1291,2611,Laikipia,RIFT VALLEY,22388
LAIKIPIA EAST,Rural,3,1381,1334,2715,Laikipia,RIFT VALLEY,22389
LAIKIPIA EAST,Rural,4,1445,1291,2736,Laikipia,RIFT VALLEY,22390
LAIKIPIA EAST,Rural,5,1411,1303,2714,Laikipia,RIFT VALLEY,22391
LAIKIPIA EAST,Rural,6,1370,1277,2647,Laikipia,RIFT VALLEY,22392
LAIKIPIA EAST,Rural,7,1348,1285,2633,Laikipia,RIFT VALLEY,22393
LAIKIPIA EAST,Rural,8,1333,1269,2602,Laikipia,RIFT VALLEY,22394
LAIKIPIA EAST,Rural,9,1375,1260,2635,Laikipia,RIFT VALLEY,22395
LAIKIPIA EAST,Rural,10,1459,1346,2805,Laikipia,RIFT VALLEY,22396
LAIKIPIA EAST,Rural,11,1025,1098,2123,Laikipia,RIFT VALLEY,22397
LAIKIPIA EAST,Rural,12,1379,1237,2616,Laikipia,RIFT VALLEY,22398
LAIKIPIA EAST,Rural,13,1255,1203,2458,Laikipia,RIFT VALLEY,22399
LAIKIPIA EAST,Rural,14,1154,1142,2296,Laikipia,RIFT VALLEY,22400
LAIKIPIA EAST,Rural,15,1036,972,2008,Laikipia,RIFT VALLEY,22401
LAIKIPIA EAST,Rural,16,971,855,1826,Laikipia,RIFT VALLEY,22402
LAIKIPIA EAST,Rural,17,1051,842,1893,Laikipia,RIFT VALLEY,22403
LAIKIPIA EAST,Rural,18,993,831,1824,Laikipia,RIFT VALLEY,22404
LAIKIPIA EAST,Rural,19,801,676,1477,Laikipia,RIFT VALLEY,22405
LAIKIPIA EAST,Rural,20,991,942,1933,Laikipia,RIFT VALLEY,22406
LAIKIPIA EAST,Rural,21,634,620,1254,Laikipia,RIFT VALLEY,22407
LAIKIPIA EAST,Rural,22,773,791,1564,Laikipia,RIFT VALLEY,22408
LAIKIPIA EAST,Rural,23,733,745,1478,Laikipia,RIFT VALLEY,22409
LAIKIPIA EAST,Rural,24,671,757,1428,Laikipia,RIFT VALLEY,22410
LAIKIPIA EAST,Rural,25,947,1030,1977,Laikipia,RIFT VALLEY,22411
LAIKIPIA EAST,Rural,26,616,718,1334,Laikipia,RIFT VALLEY,22412
LAIKIPIA EAST,Rural,27,712,652,1364,Laikipia,RIFT VALLEY,22413
LAIKIPIA EAST,Rural,28,646,758,1404,Laikipia,RIFT VALLEY,22414
LAIKIPIA EAST,Rural,29,589,566,1155,Laikipia,RIFT VALLEY,22415
LAIKIPIA EAST,Rural,30,995,1118,2113,Laikipia,RIFT VALLEY,22416
LAIKIPIA EAST,Rural,31,493,473,966,Laikipia,RIFT VALLEY,22417
LAIKIPIA EAST,Rural,32,617,701,1318,Laikipia,RIFT VALLEY,22418
LAIKIPIA EAST,Rural,33,502,430,932,Laikipia,RIFT VALLEY,22419
LAIKIPIA EAST,Rural,34,538,488,1026,Laikipia,RIFT VALLEY,22420
LAIKIPIA EAST,Rural,35,920,873,1793,Laikipia,RIFT VALLEY,22421
LAIKIPIA EAST,Rural,36,519,506,1025,Laikipia,RIFT VALLEY,22422
LAIKIPIA EAST,Rural,37,429,514,943,Laikipia,RIFT VALLEY,22423
LAIKIPIA EAST,Rural,38,446,575,1021,Laikipia,RIFT VALLEY,22424
LAIKIPIA EAST,Rural,39,385,440,825,Laikipia,RIFT VALLEY,22425
LAIKIPIA EAST,Rural,40,817,882,1699,Laikipia,RIFT VALLEY,22426
LAIKIPIA EAST,Rural,41,343,311,654,Laikipia,RIFT VALLEY,22427
LAIKIPIA EAST,Rural,42,407,451,858,Laikipia,RIFT VALLEY,22428
LAIKIPIA EAST,Rural,43,327,338,665,Laikipia,RIFT VALLEY,22429
LAIKIPIA EAST,Rural,44,303,300,603,Laikipia,RIFT VALLEY,22430
LAIKIPIA EAST,Rural,45,620,752,1372,Laikipia,RIFT VALLEY,22431
LAIKIPIA EAST,Rural,46,365,413,778,Laikipia,RIFT VALLEY,22432
LAIKIPIA EAST,Rural,47,312,349,661,Laikipia,RIFT VALLEY,22433
LAIKIPIA EAST,Rural,48,303,373,676,Laikipia,RIFT VALLEY,22434
LAIKIPIA EAST,Rural,49,307,336,643,Laikipia,RIFT VALLEY,22435
LAIKIPIA EAST,Rural,50,538,661,1199,Laikipia,RIFT VALLEY,22436
LAIKIPIA EAST,Rural,51,215,227,442,Laikipia,RIFT VALLEY,22437
LAIKIPIA EAST,Rural,52,274,297,571,Laikipia,RIFT VALLEY,22438
LAIKIPIA EAST,Rural,53,175,175,350,Laikipia,RIFT VALLEY,22439
LAIKIPIA EAST,Rural,54,195,203,398,Laikipia,RIFT VALLEY,22440
LAIKIPIA EAST,Rural,55,321,374,695,Laikipia,RIFT VALLEY,22441
LAIKIPIA EAST,Rural,56,236,229,465,Laikipia,RIFT VALLEY,22442
LAIKIPIA EAST,Rural,57,285,266,551,Laikipia,RIFT VALLEY,22443
LAIKIPIA EAST,Rural,58,193,193,386,Laikipia,RIFT VALLEY,22444
LAIKIPIA EAST,Rural,59,186,191,377,Laikipia,RIFT VALLEY,22445
LAIKIPIA EAST,Rural,60,458,493,951,Laikipia,RIFT VALLEY,22446
LAIKIPIA EAST,Rural,61,184,185,369,Laikipia,RIFT VALLEY,22447
LAIKIPIA EAST,Rural,62,224,178,402,Laikipia,RIFT VALLEY,22448
LAIKIPIA EAST,Rural,63,149,138,287,Laikipia,RIFT VALLEY,22449
LAIKIPIA EAST,Rural,64,144,145,289,Laikipia,RIFT VALLEY,22450
LAIKIPIA EAST,Rural,65,218,264,482,Laikipia,RIFT VALLEY,22451
LAIKIPIA EAST,Rural,66,133,179,312,Laikipia,RIFT VALLEY,22452
LAIKIPIA EAST,Rural,67,136,127,263,Laikipia,RIFT VALLEY,22453
LAIKIPIA EAST,Rural,68,110,92,202,Laikipia,RIFT VALLEY,22454
LAIKIPIA EAST,Rural,69,118,110,228,Laikipia,RIFT VALLEY,22455
LAIKIPIA EAST,Rural,70,239,267,506,Laikipia,RIFT VALLEY,22456
LAIKIPIA EAST,Rural,71,75,65,140,Laikipia,RIFT VALLEY,22457
LAIKIPIA EAST,Rural,72,94,71,165,Laikipia,RIFT VALLEY,22458
LAIKIPIA EAST,Rural,73,92,78,170,Laikipia,RIFT VALLEY,22459
LAIKIPIA EAST,Rural,74,87,80,167,Laikipia,RIFT VALLEY,22460
LAIKIPIA EAST,Rural,75,114,117,231,Laikipia,RIFT VALLEY,22461
LAIKIPIA EAST,Rural,76,49,63,112,Laikipia,RIFT VALLEY,22462
LAIKIPIA EAST,Rural,77,40,41,81,Laikipia,RIFT VALLEY,22463
LAIKIPIA EAST,Rural,78,49,51,100,Laikipia,RIFT VALLEY,22464
LAIKIPIA EAST,Rural,79,62,67,129,Laikipia,RIFT VALLEY,22465
LAIKIPIA EAST,Rural,80+,565,801,1366,Laikipia,RIFT VALLEY,22466
LAIKIPIA EAST,Rural,Age NS,40,29,69,Laikipia,RIFT VALLEY,22467
LAIKIPIA WEST,Rural,0,2800,2717,5517,Laikipia,RIFT VALLEY,22468
LAIKIPIA WEST,Rural,1,2336,2317,4653,Laikipia,RIFT VALLEY,22469
LAIKIPIA WEST,Rural,2,2736,2755,5491,Laikipia,RIFT VALLEY,22470
LAIKIPIA WEST,Rural,3,2866,2835,5701,Laikipia,RIFT VALLEY,22471
LAIKIPIA WEST,Rural,4,2879,2889,5768,Laikipia,RIFT VALLEY,22472
LAIKIPIA WEST,Rural,5,2908,2885,5793,Laikipia,RIFT VALLEY,22473
LAIKIPIA WEST,Rural,6,2689,2619,5308,Laikipia,RIFT VALLEY,22474
LAIKIPIA WEST,Rural,7,2752,2576,5328,Laikipia,RIFT VALLEY,22475
LAIKIPIA WEST,Rural,8,2517,2581,5098,Laikipia,RIFT VALLEY,22476
LAIKIPIA WEST,Rural,9,2739,2679,5418,Laikipia,RIFT VALLEY,22477
LAIKIPIA WEST,Rural,10,2902,2713,5615,Laikipia,RIFT VALLEY,22478
LAIKIPIA WEST,Rural,11,2062,2108,4170,Laikipia,RIFT VALLEY,22479
LAIKIPIA WEST,Rural,12,2842,2645,5487,Laikipia,RIFT VALLEY,22480
LAIKIPIA WEST,Rural,13,2383,2297,4680,Laikipia,RIFT VALLEY,22481
LAIKIPIA WEST,Rural,14,2313,2120,4433,Laikipia,RIFT VALLEY,22482
LAIKIPIA WEST,Rural,15,2182,2059,4241,Laikipia,RIFT VALLEY,22483
LAIKIPIA WEST,Rural,16,1999,1828,3827,Laikipia,RIFT VALLEY,22484
LAIKIPIA WEST,Rural,17,1913,1620,3533,Laikipia,RIFT VALLEY,22485
LAIKIPIA WEST,Rural,18,1909,1629,3538,Laikipia,RIFT VALLEY,22486
LAIKIPIA WEST,Rural,19,1517,1340,2857,Laikipia,RIFT VALLEY,22487
LAIKIPIA WEST,Rural,20,1693,1743,3436,Laikipia,RIFT VALLEY,22488
LAIKIPIA WEST,Rural,21,1199,1228,2427,Laikipia,RIFT VALLEY,22489
LAIKIPIA WEST,Rural,22,1251,1382,2633,Laikipia,RIFT VALLEY,22490
LAIKIPIA WEST,Rural,23,1060,1276,2336,Laikipia,RIFT VALLEY,22491
LAIKIPIA WEST,Rural,24,1051,1124,2175,Laikipia,RIFT VALLEY,22492
LAIKIPIA WEST,Rural,25,1445,1773,3218,Laikipia,RIFT VALLEY,22493
LAIKIPIA WEST,Rural,26,950,1130,2080,Laikipia,RIFT VALLEY,22494
LAIKIPIA WEST,Rural,27,1017,1066,2083,Laikipia,RIFT VALLEY,22495
LAIKIPIA WEST,Rural,28,892,1231,2123,Laikipia,RIFT VALLEY,22496
LAIKIPIA WEST,Rural,29,853,937,1790,Laikipia,RIFT VALLEY,22497
LAIKIPIA WEST,Rural,30,1433,1765,3198,Laikipia,RIFT VALLEY,22498
LAIKIPIA WEST,Rural,31,837,785,1622,Laikipia,RIFT VALLEY,22499
LAIKIPIA WEST,Rural,32,968,1108,2076,Laikipia,RIFT VALLEY,22500
LAIKIPIA WEST,Rural,33,683,687,1370,Laikipia,RIFT VALLEY,22501
LAIKIPIA WEST,Rural,34,735,828,1563,Laikipia,RIFT VALLEY,22502
LAIKIPIA WEST,Rural,35,1332,1485,2817,Laikipia,RIFT VALLEY,22503
LAIKIPIA WEST,Rural,36,694,800,1494,Laikipia,RIFT VALLEY,22504
LAIKIPIA WEST,Rural,37,613,705,1318,Laikipia,RIFT VALLEY,22505
LAIKIPIA WEST,Rural,38,770,887,1657,Laikipia,RIFT VALLEY,22506
LAIKIPIA WEST,Rural,39,622,708,1330,Laikipia,RIFT VALLEY,22507
LAIKIPIA WEST,Rural,40,1246,1430,2676,Laikipia,RIFT VALLEY,22508
LAIKIPIA WEST,Rural,41,534,527,1061,Laikipia,RIFT VALLEY,22509
LAIKIPIA WEST,Rural,42,610,702,1312,Laikipia,RIFT VALLEY,22510
LAIKIPIA WEST,Rural,43,488,604,1092,Laikipia,RIFT VALLEY,22511
LAIKIPIA WEST,Rural,44,410,527,937,Laikipia,RIFT VALLEY,22512
LAIKIPIA WEST,Rural,45,926,1100,2026,Laikipia,RIFT VALLEY,22513
LAIKIPIA WEST,Rural,46,585,597,1182,Laikipia,RIFT VALLEY,22514
LAIKIPIA WEST,Rural,47,477,537,1014,Laikipia,RIFT VALLEY,22515
LAIKIPIA WEST,Rural,48,491,659,1150,Laikipia,RIFT VALLEY,22516
LAIKIPIA WEST,Rural,49,483,535,1018,Laikipia,RIFT VALLEY,22517
LAIKIPIA WEST,Rural,50,738,1046,1784,Laikipia,RIFT VALLEY,22518
LAIKIPIA WEST,Rural,51,327,372,699,Laikipia,RIFT VALLEY,22519
LAIKIPIA WEST,Rural,52,436,436,872,Laikipia,RIFT VALLEY,22520
LAIKIPIA WEST,Rural,53,285,291,576,Laikipia,RIFT VALLEY,22521
LAIKIPIA WEST,Rural,54,284,331,615,Laikipia,RIFT VALLEY,22522
LAIKIPIA WEST,Rural,55,478,575,1053,Laikipia,RIFT VALLEY,22523
LAIKIPIA WEST,Rural,56,350,430,780,Laikipia,RIFT VALLEY,22524
LAIKIPIA WEST,Rural,57,411,471,882,Laikipia,RIFT VALLEY,22525
LAIKIPIA WEST,Rural,58,270,316,586,Laikipia,RIFT VALLEY,22526
LAIKIPIA WEST,Rural,59,309,308,617,Laikipia,RIFT VALLEY,22527
LAIKIPIA WEST,Rural,60,680,795,1475,Laikipia,RIFT VALLEY,22528
LAIKIPIA WEST,Rural,61,273,315,588,Laikipia,RIFT VALLEY,22529
LAIKIPIA WEST,Rural,62,287,266,553,Laikipia,RIFT VALLEY,22530
LAIKIPIA WEST,Rural,63,281,256,537,Laikipia,RIFT VALLEY,22531
LAIKIPIA WEST,Rural,64,266,265,531,Laikipia,RIFT VALLEY,22532
LAIKIPIA WEST,Rural,65,400,459,859,Laikipia,RIFT VALLEY,22533
LAIKIPIA WEST,Rural,66,251,421,672,Laikipia,RIFT VALLEY,22534
LAIKIPIA WEST,Rural,67,270,229,499,Laikipia,RIFT VALLEY,22535
LAIKIPIA WEST,Rural,68,181,173,354,Laikipia,RIFT VALLEY,22536
LAIKIPIA WEST,Rural,69,228,222,450,Laikipia,RIFT VALLEY,22537
LAIKIPIA WEST,Rural,70,416,488,904,Laikipia,RIFT VALLEY,22538
LAIKIPIA WEST,Rural,71,145,141,286,Laikipia,RIFT VALLEY,22539
LAIKIPIA WEST,Rural,72,147,144,291,Laikipia,RIFT VALLEY,22540
LAIKIPIA WEST,Rural,73,144,127,271,Laikipia,RIFT VALLEY,22541
LAIKIPIA WEST,Rural,74,138,158,296,Laikipia,RIFT VALLEY,22542
LAIKIPIA WEST,Rural,75,206,213,419,Laikipia,RIFT VALLEY,22543
LAIKIPIA WEST,Rural,76,103,124,227,Laikipia,RIFT VALLEY,22544
LAIKIPIA WEST,Rural,77,105,74,179,Laikipia,RIFT VALLEY,22545
LAIKIPIA WEST,Rural,78,99,98,197,Laikipia,RIFT VALLEY,22546
LAIKIPIA WEST,Rural,79,110,140,250,Laikipia,RIFT VALLEY,22547
LAIKIPIA WEST,Rural,80+,1010,1336,2346,Laikipia,RIFT VALLEY,22548
LAIKIPIA WEST,Rural,Age NS,58,52,110,Laikipia,RIFT VALLEY,22549
NAKURU,Rural,0,2407,2227,4634,Nakuru,RIFT VALLEY,22550
NAKURU,Rural,1,2102,2055,4157,Nakuru,RIFT VALLEY,22551
NAKURU,Rural,2,2317,2314,4631,Nakuru,RIFT VALLEY,22552
NAKURU,Rural,3,2312,2312,4624,Nakuru,RIFT VALLEY,22553
NAKURU,Rural,4,2497,2269,4766,Nakuru,RIFT VALLEY,22554
NAKURU,Rural,5,2485,2161,4646,Nakuru,RIFT VALLEY,22555
NAKURU,Rural,6,2232,2198,4430,Nakuru,RIFT VALLEY,22556
NAKURU,Rural,7,2321,2248,4569,Nakuru,RIFT VALLEY,22557
NAKURU,Rural,8,2112,1998,4110,Nakuru,RIFT VALLEY,22558
NAKURU,Rural,9,2235,2154,4389,Nakuru,RIFT VALLEY,22559
NAKURU,Rural,10,2321,2172,4493,Nakuru,RIFT VALLEY,22560
NAKURU,Rural,11,1887,1729,3616,Nakuru,RIFT VALLEY,22561
NAKURU,Rural,12,2253,2068,4321,Nakuru,RIFT VALLEY,22562
NAKURU,Rural,13,2038,1995,4033,Nakuru,RIFT VALLEY,22563
NAKURU,Rural,14,1897,1819,3716,Nakuru,RIFT VALLEY,22564
NAKURU,Rural,15,1797,1707,3504,Nakuru,RIFT VALLEY,22565
NAKURU,Rural,16,1679,1582,3261,Nakuru,RIFT VALLEY,22566
NAKURU,Rural,17,1837,1496,3333,Nakuru,RIFT VALLEY,22567
NAKURU,Rural,18,1697,1446,3143,Nakuru,RIFT VALLEY,22568
NAKURU,Rural,19,1494,1200,2694,Nakuru,RIFT VALLEY,22569
NAKURU,Rural,20,1591,1583,3174,Nakuru,RIFT VALLEY,22570
NAKURU,Rural,21,1158,1149,2307,Nakuru,RIFT VALLEY,22571
NAKURU,Rural,22,1290,1423,2713,Nakuru,RIFT VALLEY,22572
NAKURU,Rural,23,1229,1249,2478,Nakuru,RIFT VALLEY,22573
NAKURU,Rural,24,1119,1195,2314,Nakuru,RIFT VALLEY,22574
NAKURU,Rural,25,1484,1425,2909,Nakuru,RIFT VALLEY,22575
NAKURU,Rural,26,1047,1059,2106,Nakuru,RIFT VALLEY,22576
NAKURU,Rural,27,1040,1007,2047,Nakuru,RIFT VALLEY,22577
NAKURU,Rural,28,836,1060,1896,Nakuru,RIFT VALLEY,22578
NAKURU,Rural,29,824,825,1649,Nakuru,RIFT VALLEY,22579
NAKURU,Rural,30,1181,1311,2492,Nakuru,RIFT VALLEY,22580
NAKURU,Rural,31,809,664,1473,Nakuru,RIFT VALLEY,22581
NAKURU,Rural,32,968,902,1870,Nakuru,RIFT VALLEY,22582
NAKURU,Rural,33,626,624,1250,Nakuru,RIFT VALLEY,22583
NAKURU,Rural,34,670,706,1376,Nakuru,RIFT VALLEY,22584
NAKURU,Rural,35,1116,1125,2241,Nakuru,RIFT VALLEY,22585
NAKURU,Rural,36,653,649,1302,Nakuru,RIFT VALLEY,22586
NAKURU,Rural,37,627,606,1233,Nakuru,RIFT VALLEY,22587
NAKURU,Rural,38,622,726,1348,Nakuru,RIFT VALLEY,22588
NAKURU,Rural,39,597,636,1233,Nakuru,RIFT VALLEY,22589
NAKURU,Rural,40,910,1008,1918,Nakuru,RIFT VALLEY,22590
NAKURU,Rural,41,433,510,943,Nakuru,RIFT VALLEY,22591
NAKURU,Rural,42,546,526,1072,Nakuru,RIFT VALLEY,22592
NAKURU,Rural,43,417,393,810,Nakuru,RIFT VALLEY,22593
NAKURU,Rural,44,395,378,773,Nakuru,RIFT VALLEY,22594
NAKURU,Rural,45,718,787,1505,Nakuru,RIFT VALLEY,22595
NAKURU,Rural,46,436,480,916,Nakuru,RIFT VALLEY,22596
NAKURU,Rural,47,402,410,812,Nakuru,RIFT VALLEY,22597
NAKURU,Rural,48,515,568,1083,Nakuru,RIFT VALLEY,22598
NAKURU,Rural,49,430,441,871,Nakuru,RIFT VALLEY,22599
NAKURU,Rural,50,640,782,1422,Nakuru,RIFT VALLEY,22600
NAKURU,Rural,51,326,345,671,Nakuru,RIFT VALLEY,22601
NAKURU,Rural,52,348,357,705,Nakuru,RIFT VALLEY,22602
NAKURU,Rural,53,254,258,512,Nakuru,RIFT VALLEY,22603
NAKURU,Rural,54,270,299,569,Nakuru,RIFT VALLEY,22604
NAKURU,Rural,55,418,469,887,Nakuru,RIFT VALLEY,22605
NAKURU,Rural,56,353,306,659,Nakuru,RIFT VALLEY,22606
NAKURU,Rural,57,341,371,712,Nakuru,RIFT VALLEY,22607
NAKURU,Rural,58,232,243,475,Nakuru,RIFT VALLEY,22608
NAKURU,Rural,59,281,253,534,Nakuru,RIFT VALLEY,22609
NAKURU,Rural,60,505,565,1070,Nakuru,RIFT VALLEY,22610
NAKURU,Rural,61,211,225,436,Nakuru,RIFT VALLEY,22611
NAKURU,Rural,62,241,178,419,Nakuru,RIFT VALLEY,22612
NAKURU,Rural,63,178,172,350,Nakuru,RIFT VALLEY,22613
NAKURU,Rural,64,179,186,365,Nakuru,RIFT VALLEY,22614
NAKURU,Rural,65,278,274,552,Nakuru,RIFT VALLEY,22615
NAKURU,Rural,66,171,209,380,Nakuru,RIFT VALLEY,22616
NAKURU,Rural,67,191,146,337,Nakuru,RIFT VALLEY,22617
NAKURU,Rural,68,119,135,254,Nakuru,RIFT VALLEY,22618
NAKURU,Rural,69,146,173,319,Nakuru,RIFT VALLEY,22619
NAKURU,Rural,70,323,343,666,Nakuru,RIFT VALLEY,22620
NAKURU,Rural,71,93,102,195,Nakuru,RIFT VALLEY,22621
NAKURU,Rural,72,122,84,206,Nakuru,RIFT VALLEY,22622
NAKURU,Rural,73,97,90,187,Nakuru,RIFT VALLEY,22623
NAKURU,Rural,74,119,132,251,Nakuru,RIFT VALLEY,22624
NAKURU,Rural,75,110,144,254,Nakuru,RIFT VALLEY,22625
NAKURU,Rural,76,84,90,174,Nakuru,RIFT VALLEY,22626
NAKURU,Rural,77,92,88,180,Nakuru,RIFT VALLEY,22627
NAKURU,Rural,78,76,85,161,Nakuru,RIFT VALLEY,22628
NAKURU,Rural,79,88,115,203,Nakuru,RIFT VALLEY,22629
NAKURU,Rural,80+,793,1030,1823,Nakuru,RIFT VALLEY,22630
NAKURU,Rural,Age NS,27,24,51,Nakuru,RIFT VALLEY,22631
NAKURU NORTH,Rural,0,1936,1858,3794,Nakuru,RIFT VALLEY,22632
NAKURU NORTH,Rural,1,1742,1623,3365,Nakuru,RIFT VALLEY,22633
NAKURU NORTH,Rural,2,2018,1955,3973,Nakuru,RIFT VALLEY,22634
NAKURU NORTH,Rural,3,2062,2090,4152,Nakuru,RIFT VALLEY,22635
NAKURU NORTH,Rural,4,2146,2162,4308,Nakuru,RIFT VALLEY,22636
NAKURU NORTH,Rural,5,2270,2073,4343,Nakuru,RIFT VALLEY,22637
NAKURU NORTH,Rural,6,2025,2049,4074,Nakuru,RIFT VALLEY,22638
NAKURU NORTH,Rural,7,2050,1999,4049,Nakuru,RIFT VALLEY,22639
NAKURU NORTH,Rural,8,1911,1988,3899,Nakuru,RIFT VALLEY,22640
NAKURU NORTH,Rural,9,2167,2055,4222,Nakuru,RIFT VALLEY,22641
NAKURU NORTH,Rural,10,2249,2138,4387,Nakuru,RIFT VALLEY,22642
NAKURU NORTH,Rural,11,1743,1695,3438,Nakuru,RIFT VALLEY,22643
NAKURU NORTH,Rural,12,2187,2248,4435,Nakuru,RIFT VALLEY,22644
NAKURU NORTH,Rural,13,2040,2108,4148,Nakuru,RIFT VALLEY,22645
NAKURU NORTH,Rural,14,1898,1724,3622,Nakuru,RIFT VALLEY,22646
NAKURU NORTH,Rural,15,1767,1607,3374,Nakuru,RIFT VALLEY,22647
NAKURU NORTH,Rural,16,1593,1417,3010,Nakuru,RIFT VALLEY,22648
NAKURU NORTH,Rural,17,1582,1411,2993,Nakuru,RIFT VALLEY,22649
NAKURU NORTH,Rural,18,1606,1320,2926,Nakuru,RIFT VALLEY,22650
NAKURU NORTH,Rural,19,1228,1075,2303,Nakuru,RIFT VALLEY,22651
NAKURU NORTH,Rural,20,1450,1337,2787,Nakuru,RIFT VALLEY,22652
NAKURU NORTH,Rural,21,993,997,1990,Nakuru,RIFT VALLEY,22653
NAKURU NORTH,Rural,22,1041,1245,2286,Nakuru,RIFT VALLEY,22654
NAKURU NORTH,Rural,23,934,1116,2050,Nakuru,RIFT VALLEY,22655
NAKURU NORTH,Rural,24,939,1076,2015,Nakuru,RIFT VALLEY,22656
NAKURU NORTH,Rural,25,1147,1456,2603,Nakuru,RIFT VALLEY,22657
NAKURU NORTH,Rural,26,848,942,1790,Nakuru,RIFT VALLEY,22658
NAKURU NORTH,Rural,27,896,966,1862,Nakuru,RIFT VALLEY,22659
NAKURU NORTH,Rural,28,786,1007,1793,Nakuru,RIFT VALLEY,22660
NAKURU NORTH,Rural,29,745,883,1628,Nakuru,RIFT VALLEY,22661
NAKURU NORTH,Rural,30,1219,1480,2699,Nakuru,RIFT VALLEY,22662
NAKURU NORTH,Rural,31,632,652,1284,Nakuru,RIFT VALLEY,22663
NAKURU NORTH,Rural,32,834,982,1816,Nakuru,RIFT VALLEY,22664
NAKURU NORTH,Rural,33,544,575,1119,Nakuru,RIFT VALLEY,22665
NAKURU NORTH,Rural,34,621,659,1280,Nakuru,RIFT VALLEY,22666
NAKURU NORTH,Rural,35,1187,1286,2473,Nakuru,RIFT VALLEY,22667
NAKURU NORTH,Rural,36,614,666,1280,Nakuru,RIFT VALLEY,22668
NAKURU NORTH,Rural,37,610,638,1248,Nakuru,RIFT VALLEY,22669
NAKURU NORTH,Rural,38,619,863,1482,Nakuru,RIFT VALLEY,22670
NAKURU NORTH,Rural,39,634,670,1304,Nakuru,RIFT VALLEY,22671
NAKURU NORTH,Rural,40,1007,1068,2075,Nakuru,RIFT VALLEY,22672
NAKURU NORTH,Rural,41,413,409,822,Nakuru,RIFT VALLEY,22673
NAKURU NORTH,Rural,42,547,606,1153,Nakuru,RIFT VALLEY,22674
NAKURU NORTH,Rural,43,381,508,889,Nakuru,RIFT VALLEY,22675
NAKURU NORTH,Rural,44,373,435,808,Nakuru,RIFT VALLEY,22676
NAKURU NORTH,Rural,45,786,925,1711,Nakuru,RIFT VALLEY,22677
NAKURU NORTH,Rural,46,464,493,957,Nakuru,RIFT VALLEY,22678
NAKURU NORTH,Rural,47,385,405,790,Nakuru,RIFT VALLEY,22679
NAKURU NORTH,Rural,48,400,491,891,Nakuru,RIFT VALLEY,22680
NAKURU NORTH,Rural,49,352,436,788,Nakuru,RIFT VALLEY,22681
NAKURU NORTH,Rural,50,578,714,1292,Nakuru,RIFT VALLEY,22682
NAKURU NORTH,Rural,51,267,278,545,Nakuru,RIFT VALLEY,22683
NAKURU NORTH,Rural,52,300,364,664,Nakuru,RIFT VALLEY,22684
NAKURU NORTH,Rural,53,227,255,482,Nakuru,RIFT VALLEY,22685
NAKURU NORTH,Rural,54,246,269,515,Nakuru,RIFT VALLEY,22686
NAKURU NORTH,Rural,55,413,434,847,Nakuru,RIFT VALLEY,22687
NAKURU NORTH,Rural,56,275,262,537,Nakuru,RIFT VALLEY,22688
NAKURU NORTH,Rural,57,359,363,722,Nakuru,RIFT VALLEY,22689
NAKURU NORTH,Rural,58,181,214,395,Nakuru,RIFT VALLEY,22690
NAKURU NORTH,Rural,59,258,297,555,Nakuru,RIFT VALLEY,22691
NAKURU NORTH,Rural,60,504,606,1110,Nakuru,RIFT VALLEY,22692
NAKURU NORTH,Rural,61,220,258,478,Nakuru,RIFT VALLEY,22693
NAKURU NORTH,Rural,62,246,267,513,Nakuru,RIFT VALLEY,22694
NAKURU NORTH,Rural,63,207,243,450,Nakuru,RIFT VALLEY,22695
NAKURU NORTH,Rural,64,165,267,432,Nakuru,RIFT VALLEY,22696
NAKURU NORTH,Rural,65,265,382,647,Nakuru,RIFT VALLEY,22697
NAKURU NORTH,Rural,66,202,341,543,Nakuru,RIFT VALLEY,22698
NAKURU NORTH,Rural,67,201,196,397,Nakuru,RIFT VALLEY,22699
NAKURU NORTH,Rural,68,140,147,287,Nakuru,RIFT VALLEY,22700
NAKURU NORTH,Rural,69,154,231,385,Nakuru,RIFT VALLEY,22701
NAKURU NORTH,Rural,70,298,398,696,Nakuru,RIFT VALLEY,22702
NAKURU NORTH,Rural,71,102,115,217,Nakuru,RIFT VALLEY,22703
NAKURU NORTH,Rural,72,121,122,243,Nakuru,RIFT VALLEY,22704
NAKURU NORTH,Rural,73,123,116,239,Nakuru,RIFT VALLEY,22705
NAKURU NORTH,Rural,74,114,140,254,Nakuru,RIFT VALLEY,22706
NAKURU NORTH,Rural,75,148,166,314,Nakuru,RIFT VALLEY,22707
NAKURU NORTH,Rural,76,106,107,213,Nakuru,RIFT VALLEY,22708
NAKURU NORTH,Rural,77,91,96,187,Nakuru,RIFT VALLEY,22709
NAKURU NORTH,Rural,78,73,90,163,Nakuru,RIFT VALLEY,22710
NAKURU NORTH,Rural,79,91,146,237,Nakuru,RIFT VALLEY,22711
NAKURU NORTH,Rural,80+,819,1132,1951,Nakuru,RIFT VALLEY,22712
NAKURU NORTH,Rural,Age NS,34,26,60,Nakuru,RIFT VALLEY,22713
NAIVASHA,Rural,0,2382,2215,4597,Nakuru,RIFT VALLEY,22714
NAIVASHA,Rural,1,2088,1923,4011,Nakuru,RIFT VALLEY,22715
NAIVASHA,Rural,2,2310,2235,4545,Nakuru,RIFT VALLEY,22716
NAIVASHA,Rural,3,2512,2295,4807,Nakuru,RIFT VALLEY,22717
NAIVASHA,Rural,4,2420,2380,4800,Nakuru,RIFT VALLEY,22718
NAIVASHA,Rural,5,2546,2412,4958,Nakuru,RIFT VALLEY,22719
NAIVASHA,Rural,6,2443,2305,4748,Nakuru,RIFT VALLEY,22720
NAIVASHA,Rural,7,2382,2220,4602,Nakuru,RIFT VALLEY,22721
NAIVASHA,Rural,8,2214,2182,4396,Nakuru,RIFT VALLEY,22722
NAIVASHA,Rural,9,2317,2200,4517,Nakuru,RIFT VALLEY,22723
NAIVASHA,Rural,10,2391,2315,4706,Nakuru,RIFT VALLEY,22724
NAIVASHA,Rural,11,1760,1741,3501,Nakuru,RIFT VALLEY,22725
NAIVASHA,Rural,12,2178,2120,4298,Nakuru,RIFT VALLEY,22726
NAIVASHA,Rural,13,2069,1894,3963,Nakuru,RIFT VALLEY,22727
NAIVASHA,Rural,14,1845,1694,3539,Nakuru,RIFT VALLEY,22728
NAIVASHA,Rural,15,1856,1613,3469,Nakuru,RIFT VALLEY,22729
NAIVASHA,Rural,16,1668,1538,3206,Nakuru,RIFT VALLEY,22730
NAIVASHA,Rural,17,1545,1371,2916,Nakuru,RIFT VALLEY,22731
NAIVASHA,Rural,18,1490,1322,2812,Nakuru,RIFT VALLEY,22732
NAIVASHA,Rural,19,1231,1053,2284,Nakuru,RIFT VALLEY,22733
NAIVASHA,Rural,20,1368,1458,2826,Nakuru,RIFT VALLEY,22734
NAIVASHA,Rural,21,972,1007,1979,Nakuru,RIFT VALLEY,22735
NAIVASHA,Rural,22,1067,1198,2265,Nakuru,RIFT VALLEY,22736
NAIVASHA,Rural,23,1037,1156,2193,Nakuru,RIFT VALLEY,22737
NAIVASHA,Rural,24,1047,1112,2159,Nakuru,RIFT VALLEY,22738
NAIVASHA,Rural,25,1312,1425,2737,Nakuru,RIFT VALLEY,22739
NAIVASHA,Rural,26,919,1112,2031,Nakuru,RIFT VALLEY,22740
NAIVASHA,Rural,27,970,1009,1979,Nakuru,RIFT VALLEY,22741
NAIVASHA,Rural,28,898,1061,1959,Nakuru,RIFT VALLEY,22742
NAIVASHA,Rural,29,800,874,1674,Nakuru,RIFT VALLEY,22743
NAIVASHA,Rural,30,1346,1462,2808,Nakuru,RIFT VALLEY,22744
NAIVASHA,Rural,31,713,660,1373,Nakuru,RIFT VALLEY,22745
NAIVASHA,Rural,32,975,967,1942,Nakuru,RIFT VALLEY,22746
NAIVASHA,Rural,33,590,574,1164,Nakuru,RIFT VALLEY,22747
NAIVASHA,Rural,34,685,711,1396,Nakuru,RIFT VALLEY,22748
NAIVASHA,Rural,35,1148,1234,2382,Nakuru,RIFT VALLEY,22749
NAIVASHA,Rural,36,654,671,1325,Nakuru,RIFT VALLEY,22750
NAIVASHA,Rural,37,656,640,1296,Nakuru,RIFT VALLEY,22751
NAIVASHA,Rural,38,760,794,1554,Nakuru,RIFT VALLEY,22752
NAIVASHA,Rural,39,615,580,1195,Nakuru,RIFT VALLEY,22753
NAIVASHA,Rural,40,992,1129,2121,Nakuru,RIFT VALLEY,22754
NAIVASHA,Rural,41,409,468,877,Nakuru,RIFT VALLEY,22755
NAIVASHA,Rural,42,591,571,1162,Nakuru,RIFT VALLEY,22756
NAIVASHA,Rural,43,411,455,866,Nakuru,RIFT VALLEY,22757
NAIVASHA,Rural,44,375,443,818,Nakuru,RIFT VALLEY,22758
NAIVASHA,Rural,45,760,910,1670,Nakuru,RIFT VALLEY,22759
NAIVASHA,Rural,46,496,499,995,Nakuru,RIFT VALLEY,22760
NAIVASHA,Rural,47,382,436,818,Nakuru,RIFT VALLEY,22761
NAIVASHA,Rural,48,450,486,936,Nakuru,RIFT VALLEY,22762
NAIVASHA,Rural,49,392,420,812,Nakuru,RIFT VALLEY,22763
NAIVASHA,Rural,50,627,809,1436,Nakuru,RIFT VALLEY,22764
NAIVASHA,Rural,51,307,320,627,Nakuru,RIFT VALLEY,22765
NAIVASHA,Rural,52,340,341,681,Nakuru,RIFT VALLEY,22766
NAIVASHA,Rural,53,224,213,437,Nakuru,RIFT VALLEY,22767
NAIVASHA,Rural,54,259,279,538,Nakuru,RIFT VALLEY,22768
NAIVASHA,Rural,55,423,447,870,Nakuru,RIFT VALLEY,22769
NAIVASHA,Rural,56,305,315,620,Nakuru,RIFT VALLEY,22770
NAIVASHA,Rural,57,348,394,742,Nakuru,RIFT VALLEY,22771
NAIVASHA,Rural,58,194,227,421,Nakuru,RIFT VALLEY,22772
NAIVASHA,Rural,59,263,297,560,Nakuru,RIFT VALLEY,22773
NAIVASHA,Rural,60,540,570,1110,Nakuru,RIFT VALLEY,22774
NAIVASHA,Rural,61,258,249,507,Nakuru,RIFT VALLEY,22775
NAIVASHA,Rural,62,226,213,439,Nakuru,RIFT VALLEY,22776
NAIVASHA,Rural,63,215,200,415,Nakuru,RIFT VALLEY,22777
NAIVASHA,Rural,64,197,227,424,Nakuru,RIFT VALLEY,22778
NAIVASHA,Rural,65,338,360,698,Nakuru,RIFT VALLEY,22779
NAIVASHA,Rural,66,203,338,541,Nakuru,RIFT VALLEY,22780
NAIVASHA,Rural,67,195,214,409,Nakuru,RIFT VALLEY,22781
NAIVASHA,Rural,68,143,167,310,Nakuru,RIFT VALLEY,22782
NAIVASHA,Rural,69,165,191,356,Nakuru,RIFT VALLEY,22783
NAIVASHA,Rural,70,343,353,696,Nakuru,RIFT VALLEY,22784
NAIVASHA,Rural,71,126,135,261,Nakuru,RIFT VALLEY,22785
NAIVASHA,Rural,72,151,113,264,Nakuru,RIFT VALLEY,22786
NAIVASHA,Rural,73,120,122,242,Nakuru,RIFT VALLEY,22787
NAIVASHA,Rural,74,145,143,288,Nakuru,RIFT VALLEY,22788
NAIVASHA,Rural,75,167,170,337,Nakuru,RIFT VALLEY,22789
NAIVASHA,Rural,76,100,116,216,Nakuru,RIFT VALLEY,22790
NAIVASHA,Rural,77,75,91,166,Nakuru,RIFT VALLEY,22791
NAIVASHA,Rural,78,84,87,171,Nakuru,RIFT VALLEY,22792
NAIVASHA,Rural,79,86,129,215,Nakuru,RIFT VALLEY,22793
NAIVASHA,Rural,80+,786,1020,1806,Nakuru,RIFT VALLEY,22794
NAIVASHA,Rural,Age NS,34,33,67,Nakuru,RIFT VALLEY,22795
MOLO,Rural,0,7898,7439,15337,Nakuru,RIFT VALLEY,22796
MOLO,Rural,1,6524,6172,12696,Nakuru,RIFT VALLEY,22797
MOLO,Rural,2,7776,7528,15304,Nakuru,RIFT VALLEY,22798
MOLO,Rural,3,7862,7361,15223,Nakuru,RIFT VALLEY,22799
MOLO,Rural,4,7987,7518,15505,Nakuru,RIFT VALLEY,22800
MOLO,Rural,5,8046,7504,15550,Nakuru,RIFT VALLEY,22801
MOLO,Rural,6,7512,7380,14892,Nakuru,RIFT VALLEY,22802
MOLO,Rural,7,7397,6891,14288,Nakuru,RIFT VALLEY,22803
MOLO,Rural,8,6830,6793,13623,Nakuru,RIFT VALLEY,22804
MOLO,Rural,9,7239,6939,14178,Nakuru,RIFT VALLEY,22805
MOLO,Rural,10,7192,6990,14182,Nakuru,RIFT VALLEY,22806
MOLO,Rural,11,5325,5290,10615,Nakuru,RIFT VALLEY,22807
MOLO,Rural,12,6864,6284,13148,Nakuru,RIFT VALLEY,22808
MOLO,Rural,13,5950,5727,11677,Nakuru,RIFT VALLEY,22809
MOLO,Rural,14,5385,5122,10507,Nakuru,RIFT VALLEY,22810
MOLO,Rural,15,5209,4810,10019,Nakuru,RIFT VALLEY,22811
MOLO,Rural,16,4934,4468,9402,Nakuru,RIFT VALLEY,22812
MOLO,Rural,17,5026,4370,9396,Nakuru,RIFT VALLEY,22813
MOLO,Rural,18,4650,4133,8783,Nakuru,RIFT VALLEY,22814
MOLO,Rural,19,4046,3554,7600,Nakuru,RIFT VALLEY,22815
MOLO,Rural,20,4521,5147,9668,Nakuru,RIFT VALLEY,22816
MOLO,Rural,21,3272,3385,6657,Nakuru,RIFT VALLEY,22817
MOLO,Rural,22,3810,4104,7914,Nakuru,RIFT VALLEY,22818
MOLO,Rural,23,3361,3616,6977,Nakuru,RIFT VALLEY,22819
MOLO,Rural,24,3117,3443,6560,Nakuru,RIFT VALLEY,22820
MOLO,Rural,25,4072,4596,8668,Nakuru,RIFT VALLEY,22821
MOLO,Rural,26,2795,2991,5786,Nakuru,RIFT VALLEY,22822
MOLO,Rural,27,3071,2965,6036,Nakuru,RIFT VALLEY,22823
MOLO,Rural,28,2574,2978,5552,Nakuru,RIFT VALLEY,22824
MOLO,Rural,29,2392,2509,4901,Nakuru,RIFT VALLEY,22825
MOLO,Rural,30,3867,4221,8088,Nakuru,RIFT VALLEY,22826
MOLO,Rural,31,2407,2191,4598,Nakuru,RIFT VALLEY,22827
MOLO,Rural,32,2579,2683,5262,Nakuru,RIFT VALLEY,22828
MOLO,Rural,33,1818,1829,3647,Nakuru,RIFT VALLEY,22829
MOLO,Rural,34,1959,2025,3984,Nakuru,RIFT VALLEY,22830
MOLO,Rural,35,3556,3461,7017,Nakuru,RIFT VALLEY,22831
MOLO,Rural,36,1768,1776,3544,Nakuru,RIFT VALLEY,22832
MOLO,Rural,37,1875,1891,3766,Nakuru,RIFT VALLEY,22833
MOLO,Rural,38,1761,1875,3636,Nakuru,RIFT VALLEY,22834
MOLO,Rural,39,1704,1566,3270,Nakuru,RIFT VALLEY,22835
MOLO,Rural,40,2647,2745,5392,Nakuru,RIFT VALLEY,22836
MOLO,Rural,41,1397,1280,2677,Nakuru,RIFT VALLEY,22837
MOLO,Rural,42,1408,1277,2685,Nakuru,RIFT VALLEY,22838
MOLO,Rural,43,1020,1056,2076,Nakuru,RIFT VALLEY,22839
MOLO,Rural,44,977,1011,1988,Nakuru,RIFT VALLEY,22840
MOLO,Rural,45,1855,1941,3796,Nakuru,RIFT VALLEY,22841
MOLO,Rural,46,1200,1262,2462,Nakuru,RIFT VALLEY,22842
MOLO,Rural,47,1072,1215,2287,Nakuru,RIFT VALLEY,22843
MOLO,Rural,48,1458,1697,3155,Nakuru,RIFT VALLEY,22844
MOLO,Rural,49,1112,1035,2147,Nakuru,RIFT VALLEY,22845
MOLO,Rural,50,1609,1888,3497,Nakuru,RIFT VALLEY,22846
MOLO,Rural,51,837,825,1662,Nakuru,RIFT VALLEY,22847
MOLO,Rural,52,952,877,1829,Nakuru,RIFT VALLEY,22848
MOLO,Rural,53,709,727,1436,Nakuru,RIFT VALLEY,22849
MOLO,Rural,54,698,690,1388,Nakuru,RIFT VALLEY,22850
MOLO,Rural,55,1010,1136,2146,Nakuru,RIFT VALLEY,22851
MOLO,Rural,56,767,702,1469,Nakuru,RIFT VALLEY,22852
MOLO,Rural,57,986,923,1909,Nakuru,RIFT VALLEY,22853
MOLO,Rural,58,543,528,1071,Nakuru,RIFT VALLEY,22854
MOLO,Rural,59,663,650,1313,Nakuru,RIFT VALLEY,22855
MOLO,Rural,60,1081,1254,2335,Nakuru,RIFT VALLEY,22856
MOLO,Rural,61,630,553,1183,Nakuru,RIFT VALLEY,22857
MOLO,Rural,62,569,435,1004,Nakuru,RIFT VALLEY,22858
MOLO,Rural,63,480,412,892,Nakuru,RIFT VALLEY,22859
MOLO,Rural,64,475,413,888,Nakuru,RIFT VALLEY,22860
MOLO,Rural,65,701,721,1422,Nakuru,RIFT VALLEY,22861
MOLO,Rural,66,422,540,962,Nakuru,RIFT VALLEY,22862
MOLO,Rural,67,450,369,819,Nakuru,RIFT VALLEY,22863
MOLO,Rural,68,316,344,660,Nakuru,RIFT VALLEY,22864
MOLO,Rural,69,360,439,799,Nakuru,RIFT VALLEY,22865
MOLO,Rural,70,622,797,1419,Nakuru,RIFT VALLEY,22866
MOLO,Rural,71,259,255,514,Nakuru,RIFT VALLEY,22867
MOLO,Rural,72,317,247,564,Nakuru,RIFT VALLEY,22868
MOLO,Rural,73,255,237,492,Nakuru,RIFT VALLEY,22869
MOLO,Rural,74,290,285,575,Nakuru,RIFT VALLEY,22870
MOLO,Rural,75,288,331,619,Nakuru,RIFT VALLEY,22871
MOLO,Rural,76,195,220,415,Nakuru,RIFT VALLEY,22872
MOLO,Rural,77,198,173,371,Nakuru,RIFT VALLEY,22873
MOLO,Rural,78,185,200,385,Nakuru,RIFT VALLEY,22874
MOLO,Rural,79,223,302,525,Nakuru,RIFT VALLEY,22875
MOLO,Rural,80+,1973,2424,4397,Nakuru,RIFT VALLEY,22876
MOLO,Rural,Age NS,76,65,141,Nakuru,RIFT VALLEY,22877
NAROK NORTH,Rural,0,4620,4446,9066,Narok,RIFT VALLEY,22878
NAROK NORTH,Rural,1,3680,3474,7154,Narok,RIFT VALLEY,22879
NAROK NORTH,Rural,2,4556,4296,8852,Narok,RIFT VALLEY,22880
NAROK NORTH,Rural,3,4223,4048,8271,Narok,RIFT VALLEY,22881
NAROK NORTH,Rural,4,4381,4075,8456,Narok,RIFT VALLEY,22882
NAROK NORTH,Rural,5,4278,3975,8253,Narok,RIFT VALLEY,22883
NAROK NORTH,Rural,6,4231,3859,8090,Narok,RIFT VALLEY,22884
NAROK NORTH,Rural,7,3650,3489,7139,Narok,RIFT VALLEY,22885
NAROK NORTH,Rural,8,3870,3770,7640,Narok,RIFT VALLEY,22886
NAROK NORTH,Rural,9,3333,3022,6355,Narok,RIFT VALLEY,22887
NAROK NORTH,Rural,10,4183,4041,8224,Narok,RIFT VALLEY,22888
NAROK NORTH,Rural,11,2181,2408,4589,Narok,RIFT VALLEY,22889
NAROK NORTH,Rural,12,3704,3210,6914,Narok,RIFT VALLEY,22890
NAROK NORTH,Rural,13,2632,2380,5012,Narok,RIFT VALLEY,22891
NAROK NORTH,Rural,14,2654,2343,4997,Narok,RIFT VALLEY,22892
NAROK NORTH,Rural,15,2611,2222,4833,Narok,RIFT VALLEY,22893
NAROK NORTH,Rural,16,2296,2021,4317,Narok,RIFT VALLEY,22894
NAROK NORTH,Rural,17,2068,1607,3675,Narok,RIFT VALLEY,22895
NAROK NORTH,Rural,18,2406,2298,4704,Narok,RIFT VALLEY,22896
NAROK NORTH,Rural,19,1557,1559,3116,Narok,RIFT VALLEY,22897
NAROK NORTH,Rural,20,2673,3297,5970,Narok,RIFT VALLEY,22898
NAROK NORTH,Rural,21,1364,1367,2731,Narok,RIFT VALLEY,22899
NAROK NORTH,Rural,22,1852,2122,3974,Narok,RIFT VALLEY,22900
NAROK NORTH,Rural,23,1573,1571,3144,Narok,RIFT VALLEY,22901
NAROK NORTH,Rural,24,1729,1708,3437,Narok,RIFT VALLEY,22902
NAROK NORTH,Rural,25,2498,2693,5191,Narok,RIFT VALLEY,22903
NAROK NORTH,Rural,26,1485,1319,2804,Narok,RIFT VALLEY,22904
NAROK NORTH,Rural,27,1556,1262,2818,Narok,RIFT VALLEY,22905
NAROK NORTH,Rural,28,1607,1646,3253,Narok,RIFT VALLEY,22906
NAROK NORTH,Rural,29,1057,934,1991,Narok,RIFT VALLEY,22907
NAROK NORTH,Rural,30,2314,2512,4826,Narok,RIFT VALLEY,22908
NAROK NORTH,Rural,31,910,711,1621,Narok,RIFT VALLEY,22909
NAROK NORTH,Rural,32,1302,1202,2504,Narok,RIFT VALLEY,22910
NAROK NORTH,Rural,33,739,626,1365,Narok,RIFT VALLEY,22911
NAROK NORTH,Rural,34,836,628,1464,Narok,RIFT VALLEY,22912
NAROK NORTH,Rural,35,2007,1868,3875,Narok,RIFT VALLEY,22913
NAROK NORTH,Rural,36,845,734,1579,Narok,RIFT VALLEY,22914
NAROK NORTH,Rural,37,751,591,1342,Narok,RIFT VALLEY,22915
NAROK NORTH,Rural,38,904,847,1751,Narok,RIFT VALLEY,22916
NAROK NORTH,Rural,39,610,510,1120,Narok,RIFT VALLEY,22917
NAROK NORTH,Rural,40,1691,1762,3453,Narok,RIFT VALLEY,22918
NAROK NORTH,Rural,41,416,313,729,Narok,RIFT VALLEY,22919
NAROK NORTH,Rural,42,731,627,1358,Narok,RIFT VALLEY,22920
NAROK NORTH,Rural,43,386,352,738,Narok,RIFT VALLEY,22921
NAROK NORTH,Rural,44,374,331,705,Narok,RIFT VALLEY,22922
NAROK NORTH,Rural,45,1080,1038,2118,Narok,RIFT VALLEY,22923
NAROK NORTH,Rural,46,510,435,945,Narok,RIFT VALLEY,22924
NAROK NORTH,Rural,47,411,343,754,Narok,RIFT VALLEY,22925
NAROK NORTH,Rural,48,490,438,928,Narok,RIFT VALLEY,22926
NAROK NORTH,Rural,49,349,312,661,Narok,RIFT VALLEY,22927
NAROK NORTH,Rural,50,935,928,1863,Narok,RIFT VALLEY,22928
NAROK NORTH,Rural,51,247,205,452,Narok,RIFT VALLEY,22929
NAROK NORTH,Rural,52,391,318,709,Narok,RIFT VALLEY,22930
NAROK NORTH,Rural,53,214,134,348,Narok,RIFT VALLEY,22931
NAROK NORTH,Rural,54,248,182,430,Narok,RIFT VALLEY,22932
NAROK NORTH,Rural,55,480,433,913,Narok,RIFT VALLEY,22933
NAROK NORTH,Rural,56,281,211,492,Narok,RIFT VALLEY,22934
NAROK NORTH,Rural,57,287,214,501,Narok,RIFT VALLEY,22935
NAROK NORTH,Rural,58,203,158,361,Narok,RIFT VALLEY,22936
NAROK NORTH,Rural,59,188,147,335,Narok,RIFT VALLEY,22937
NAROK NORTH,Rural,60,649,749,1398,Narok,RIFT VALLEY,22938
NAROK NORTH,Rural,61,156,109,265,Narok,RIFT VALLEY,22939
NAROK NORTH,Rural,62,172,159,331,Narok,RIFT VALLEY,22940
NAROK NORTH,Rural,63,134,109,243,Narok,RIFT VALLEY,22941
NAROK NORTH,Rural,64,178,140,318,Narok,RIFT VALLEY,22942
NAROK NORTH,Rural,65,369,340,709,Narok,RIFT VALLEY,22943
NAROK NORTH,Rural,66,138,133,271,Narok,RIFT VALLEY,22944
NAROK NORTH,Rural,67,122,99,221,Narok,RIFT VALLEY,22945
NAROK NORTH,Rural,68,141,108,249,Narok,RIFT VALLEY,22946
NAROK NORTH,Rural,69,122,116,238,Narok,RIFT VALLEY,22947
NAROK NORTH,Rural,70,481,538,1019,Narok,RIFT VALLEY,22948
NAROK NORTH,Rural,71,56,52,108,Narok,RIFT VALLEY,22949
NAROK NORTH,Rural,72,109,78,187,Narok,RIFT VALLEY,22950
NAROK NORTH,Rural,73,65,61,126,Narok,RIFT VALLEY,22951
NAROK NORTH,Rural,74,85,55,140,Narok,RIFT VALLEY,22952
NAROK NORTH,Rural,75,180,161,341,Narok,RIFT VALLEY,22953
NAROK NORTH,Rural,76,43,33,76,Narok,RIFT VALLEY,22954
NAROK NORTH,Rural,77,24,30,54,Narok,RIFT VALLEY,22955
NAROK NORTH,Rural,78,65,43,108,Narok,RIFT VALLEY,22956
NAROK NORTH,Rural,79,57,63,120,Narok,RIFT VALLEY,22957
NAROK NORTH,Rural,80+,887,978,1865,Narok,RIFT VALLEY,22958
NAROK NORTH,Rural,Age NS,95,74,169,Narok,RIFT VALLEY,22959
NAROK SOUTH,Rural,0,7370,7100,14470,Narok,RIFT VALLEY,22960
NAROK SOUTH,Rural,1,5479,5225,10704,Narok,RIFT VALLEY,22961
NAROK SOUTH,Rural,2,6841,6652,13493,Narok,RIFT VALLEY,22962
NAROK SOUTH,Rural,3,6369,6233,12602,Narok,RIFT VALLEY,22963
NAROK SOUTH,Rural,4,6648,6597,13245,Narok,RIFT VALLEY,22964
NAROK SOUTH,Rural,5,6214,6168,12382,Narok,RIFT VALLEY,22965
NAROK SOUTH,Rural,6,6290,6188,12478,Narok,RIFT VALLEY,22966
NAROK SOUTH,Rural,7,5167,5062,10229,Narok,RIFT VALLEY,22967
NAROK SOUTH,Rural,8,5920,5528,11448,Narok,RIFT VALLEY,22968
NAROK SOUTH,Rural,9,4804,4461,9265,Narok,RIFT VALLEY,22969
NAROK SOUTH,Rural,10,6091,5987,12078,Narok,RIFT VALLEY,22970
NAROK SOUTH,Rural,11,3312,3516,6828,Narok,RIFT VALLEY,22971
NAROK SOUTH,Rural,12,5423,4711,10134,Narok,RIFT VALLEY,22972
NAROK SOUTH,Rural,13,3687,3451,7138,Narok,RIFT VALLEY,22973
NAROK SOUTH,Rural,14,3945,3569,7514,Narok,RIFT VALLEY,22974
NAROK SOUTH,Rural,15,3859,3391,7250,Narok,RIFT VALLEY,22975
NAROK SOUTH,Rural,16,3462,3060,6522,Narok,RIFT VALLEY,22976
NAROK SOUTH,Rural,17,2987,2713,5700,Narok,RIFT VALLEY,22977
NAROK SOUTH,Rural,18,3635,3759,7394,Narok,RIFT VALLEY,22978
NAROK SOUTH,Rural,19,2458,2642,5100,Narok,RIFT VALLEY,22979
NAROK SOUTH,Rural,20,3655,5114,8769,Narok,RIFT VALLEY,22980
NAROK SOUTH,Rural,21,2052,2326,4378,Narok,RIFT VALLEY,22981
NAROK SOUTH,Rural,22,2611,3182,5793,Narok,RIFT VALLEY,22982
NAROK SOUTH,Rural,23,2225,2370,4595,Narok,RIFT VALLEY,22983
NAROK SOUTH,Rural,24,2497,2711,5208,Narok,RIFT VALLEY,22984
NAROK SOUTH,Rural,25,3423,3894,7317,Narok,RIFT VALLEY,22985
NAROK SOUTH,Rural,26,2020,2092,4112,Narok,RIFT VALLEY,22986
NAROK SOUTH,Rural,27,2122,2109,4231,Narok,RIFT VALLEY,22987
NAROK SOUTH,Rural,28,1958,2333,4291,Narok,RIFT VALLEY,22988
NAROK SOUTH,Rural,29,1385,1432,2817,Narok,RIFT VALLEY,22989
NAROK SOUTH,Rural,30,2968,3415,6383,Narok,RIFT VALLEY,22990
NAROK SOUTH,Rural,31,1333,1189,2522,Narok,RIFT VALLEY,22991
NAROK SOUTH,Rural,32,1716,1756,3472,Narok,RIFT VALLEY,22992
NAROK SOUTH,Rural,33,1184,1142,2326,Narok,RIFT VALLEY,22993
NAROK SOUTH,Rural,34,1216,1136,2352,Narok,RIFT VALLEY,22994
NAROK SOUTH,Rural,35,2386,2432,4818,Narok,RIFT VALLEY,22995
NAROK SOUTH,Rural,36,1235,1224,2459,Narok,RIFT VALLEY,22996
NAROK SOUTH,Rural,37,1160,1180,2340,Narok,RIFT VALLEY,22997
NAROK SOUTH,Rural,38,1190,1251,2441,Narok,RIFT VALLEY,22998
NAROK SOUTH,Rural,39,947,964,1911,Narok,RIFT VALLEY,22999
NAROK SOUTH,Rural,40,2084,2327,4411,Narok,RIFT VALLEY,23000
NAROK SOUTH,Rural,41,703,627,1330,Narok,RIFT VALLEY,23001
NAROK SOUTH,Rural,42,964,904,1868,Narok,RIFT VALLEY,23002
NAROK SOUTH,Rural,43,621,569,1190,Narok,RIFT VALLEY,23003
NAROK SOUTH,Rural,44,504,489,993,Narok,RIFT VALLEY,23004
NAROK SOUTH,Rural,45,1280,1316,2596,Narok,RIFT VALLEY,23005
NAROK SOUTH,Rural,46,643,717,1360,Narok,RIFT VALLEY,23006
NAROK SOUTH,Rural,47,622,605,1227,Narok,RIFT VALLEY,23007
NAROK SOUTH,Rural,48,958,1089,2047,Narok,RIFT VALLEY,23008
NAROK SOUTH,Rural,49,571,514,1085,Narok,RIFT VALLEY,23009
NAROK SOUTH,Rural,50,1212,1324,2536,Narok,RIFT VALLEY,23010
NAROK SOUTH,Rural,51,409,350,759,Narok,RIFT VALLEY,23011
NAROK SOUTH,Rural,52,519,423,942,Narok,RIFT VALLEY,23012
NAROK SOUTH,Rural,53,356,305,661,Narok,RIFT VALLEY,23013
NAROK SOUTH,Rural,54,394,377,771,Narok,RIFT VALLEY,23014
NAROK SOUTH,Rural,55,629,565,1194,Narok,RIFT VALLEY,23015
NAROK SOUTH,Rural,56,434,313,747,Narok,RIFT VALLEY,23016
NAROK SOUTH,Rural,57,468,338,806,Narok,RIFT VALLEY,23017
NAROK SOUTH,Rural,58,307,276,583,Narok,RIFT VALLEY,23018
NAROK SOUTH,Rural,59,281,248,529,Narok,RIFT VALLEY,23019
NAROK SOUTH,Rural,60,842,927,1769,Narok,RIFT VALLEY,23020
NAROK SOUTH,Rural,61,286,203,489,Narok,RIFT VALLEY,23021
NAROK SOUTH,Rural,62,268,215,483,Narok,RIFT VALLEY,23022
NAROK SOUTH,Rural,63,269,222,491,Narok,RIFT VALLEY,23023
NAROK SOUTH,Rural,64,266,232,498,Narok,RIFT VALLEY,23024
NAROK SOUTH,Rural,65,418,429,847,Narok,RIFT VALLEY,23025
NAROK SOUTH,Rural,66,154,146,300,Narok,RIFT VALLEY,23026
NAROK SOUTH,Rural,67,175,119,294,Narok,RIFT VALLEY,23027
NAROK SOUTH,Rural,68,199,193,392,Narok,RIFT VALLEY,23028
NAROK SOUTH,Rural,69,159,199,358,Narok,RIFT VALLEY,23029
NAROK SOUTH,Rural,70,500,607,1107,Narok,RIFT VALLEY,23030
NAROK SOUTH,Rural,71,99,74,173,Narok,RIFT VALLEY,23031
NAROK SOUTH,Rural,72,137,136,273,Narok,RIFT VALLEY,23032
NAROK SOUTH,Rural,73,102,84,186,Narok,RIFT VALLEY,23033
NAROK SOUTH,Rural,74,103,96,199,Narok,RIFT VALLEY,23034
NAROK SOUTH,Rural,75,174,196,370,Narok,RIFT VALLEY,23035
NAROK SOUTH,Rural,76,115,85,200,Narok,RIFT VALLEY,23036
NAROK SOUTH,Rural,77,63,62,125,Narok,RIFT VALLEY,23037
NAROK SOUTH,Rural,78,95,89,184,Narok,RIFT VALLEY,23038
NAROK SOUTH,Rural,79,103,125,228,Narok,RIFT VALLEY,23039
NAROK SOUTH,Rural,80+,1085,1442,2527,Narok,RIFT VALLEY,23040
NAROK SOUTH,Rural,Age NS,132,75,207,Narok,RIFT VALLEY,23041
TRANS MARA,Rural,0,5876,5709,11585,Narok,RIFT VALLEY,23042
TRANS MARA,Rural,1,4703,4463,9166,Narok,RIFT VALLEY,23043
TRANS MARA,Rural,2,5445,5382,10827,Narok,RIFT VALLEY,23044
TRANS MARA,Rural,3,5187,5106,10293,Narok,RIFT VALLEY,23045
TRANS MARA,Rural,4,5280,5199,10479,Narok,RIFT VALLEY,23046
TRANS MARA,Rural,5,4985,4878,9863,Narok,RIFT VALLEY,23047
TRANS MARA,Rural,6,4852,4690,9542,Narok,RIFT VALLEY,23048
TRANS MARA,Rural,7,4345,4060,8405,Narok,RIFT VALLEY,23049
TRANS MARA,Rural,8,4413,4276,8689,Narok,RIFT VALLEY,23050
TRANS MARA,Rural,9,4165,4056,8221,Narok,RIFT VALLEY,23051
TRANS MARA,Rural,10,4608,4288,8896,Narok,RIFT VALLEY,23052
TRANS MARA,Rural,11,2886,2974,5860,Narok,RIFT VALLEY,23053
TRANS MARA,Rural,12,4290,3946,8236,Narok,RIFT VALLEY,23054
TRANS MARA,Rural,13,3485,3457,6942,Narok,RIFT VALLEY,23055
TRANS MARA,Rural,14,3362,3160,6522,Narok,RIFT VALLEY,23056
TRANS MARA,Rural,15,3186,3065,6251,Narok,RIFT VALLEY,23057
TRANS MARA,Rural,16,3040,2862,5902,Narok,RIFT VALLEY,23058
TRANS MARA,Rural,17,2962,2590,5552,Narok,RIFT VALLEY,23059
TRANS MARA,Rural,18,3195,3143,6338,Narok,RIFT VALLEY,23060
TRANS MARA,Rural,19,2228,2460,4688,Narok,RIFT VALLEY,23061
TRANS MARA,Rural,20,2957,3937,6894,Narok,RIFT VALLEY,23062
TRANS MARA,Rural,21,2008,2134,4142,Narok,RIFT VALLEY,23063
TRANS MARA,Rural,22,2305,2748,5053,Narok,RIFT VALLEY,23064
TRANS MARA,Rural,23,1919,2093,4012,Narok,RIFT VALLEY,23065
TRANS MARA,Rural,24,1871,1968,3839,Narok,RIFT VALLEY,23066
TRANS MARA,Rural,25,2590,2797,5387,Narok,RIFT VALLEY,23067
TRANS MARA,Rural,26,1549,1558,3107,Narok,RIFT VALLEY,23068
TRANS MARA,Rural,27,1755,1726,3481,Narok,RIFT VALLEY,23069
TRANS MARA,Rural,28,1577,1572,3149,Narok,RIFT VALLEY,23070
TRANS MARA,Rural,29,1309,1161,2470,Narok,RIFT VALLEY,23071
TRANS MARA,Rural,30,2131,2147,4278,Narok,RIFT VALLEY,23072
TRANS MARA,Rural,31,1194,1104,2298,Narok,RIFT VALLEY,23073
TRANS MARA,Rural,32,1363,1443,2806,Narok,RIFT VALLEY,23074
TRANS MARA,Rural,33,959,915,1874,Narok,RIFT VALLEY,23075
TRANS MARA,Rural,34,1002,996,1998,Narok,RIFT VALLEY,23076
TRANS MARA,Rural,35,1929,1943,3872,Narok,RIFT VALLEY,23077
TRANS MARA,Rural,36,1005,1045,2050,Narok,RIFT VALLEY,23078
TRANS MARA,Rural,37,1103,1201,2304,Narok,RIFT VALLEY,23079
TRANS MARA,Rural,38,810,1027,1837,Narok,RIFT VALLEY,23080
TRANS MARA,Rural,39,765,802,1567,Narok,RIFT VALLEY,23081
TRANS MARA,Rural,40,1392,1582,2974,Narok,RIFT VALLEY,23082
TRANS MARA,Rural,41,668,626,1294,Narok,RIFT VALLEY,23083
TRANS MARA,Rural,42,686,649,1335,Narok,RIFT VALLEY,23084
TRANS MARA,Rural,43,484,470,954,Narok,RIFT VALLEY,23085
TRANS MARA,Rural,44,461,487,948,Narok,RIFT VALLEY,23086
TRANS MARA,Rural,45,953,1010,1963,Narok,RIFT VALLEY,23087
TRANS MARA,Rural,46,558,605,1163,Narok,RIFT VALLEY,23088
TRANS MARA,Rural,47,542,585,1127,Narok,RIFT VALLEY,23089
TRANS MARA,Rural,48,814,1000,1814,Narok,RIFT VALLEY,23090
TRANS MARA,Rural,49,529,529,1058,Narok,RIFT VALLEY,23091
TRANS MARA,Rural,50,826,971,1797,Narok,RIFT VALLEY,23092
TRANS MARA,Rural,51,364,354,718,Narok,RIFT VALLEY,23093
TRANS MARA,Rural,52,470,401,871,Narok,RIFT VALLEY,23094
TRANS MARA,Rural,53,319,298,617,Narok,RIFT VALLEY,23095
TRANS MARA,Rural,54,359,348,707,Narok,RIFT VALLEY,23096
TRANS MARA,Rural,55,570,549,1119,Narok,RIFT VALLEY,23097
TRANS MARA,Rural,56,289,290,579,Narok,RIFT VALLEY,23098
TRANS MARA,Rural,57,462,336,798,Narok,RIFT VALLEY,23099
TRANS MARA,Rural,58,224,243,467,Narok,RIFT VALLEY,23100
TRANS MARA,Rural,59,251,260,511,Narok,RIFT VALLEY,23101
TRANS MARA,Rural,60,482,566,1048,Narok,RIFT VALLEY,23102
TRANS MARA,Rural,61,257,198,455,Narok,RIFT VALLEY,23103
TRANS MARA,Rural,62,199,205,404,Narok,RIFT VALLEY,23104
TRANS MARA,Rural,63,155,125,280,Narok,RIFT VALLEY,23105
TRANS MARA,Rural,64,197,210,407,Narok,RIFT VALLEY,23106
TRANS MARA,Rural,65,288,328,616,Narok,RIFT VALLEY,23107
TRANS MARA,Rural,66,124,91,215,Narok,RIFT VALLEY,23108
TRANS MARA,Rural,67,192,148,340,Narok,RIFT VALLEY,23109
TRANS MARA,Rural,68,149,168,317,Narok,RIFT VALLEY,23110
TRANS MARA,Rural,69,140,162,302,Narok,RIFT VALLEY,23111
TRANS MARA,Rural,70,317,411,728,Narok,RIFT VALLEY,23112
TRANS MARA,Rural,71,99,69,168,Narok,RIFT VALLEY,23113
TRANS MARA,Rural,72,136,124,260,Narok,RIFT VALLEY,23114
TRANS MARA,Rural,73,100,75,175,Narok,RIFT VALLEY,23115
TRANS MARA,Rural,74,130,125,255,Narok,RIFT VALLEY,23116
TRANS MARA,Rural,75,157,166,323,Narok,RIFT VALLEY,23117
TRANS MARA,Rural,76,75,69,144,Narok,RIFT VALLEY,23118
TRANS MARA,Rural,77,97,74,171,Narok,RIFT VALLEY,23119
TRANS MARA,Rural,78,94,100,194,Narok,RIFT VALLEY,23120
TRANS MARA,Rural,79,109,121,230,Narok,RIFT VALLEY,23121
TRANS MARA,Rural,80+,881,1220,2101,Narok,RIFT VALLEY,23122
TRANS MARA,Rural,Age NS,130,64,194,Narok,RIFT VALLEY,23123
KAJIADO CENTRAL,Rural,0,2637,2548,5185,Kajiado,RIFT VALLEY,23124
KAJIADO CENTRAL,Rural,1,2144,2083,4227,Kajiado,RIFT VALLEY,23125
KAJIADO CENTRAL,Rural,2,2724,2467,5191,Kajiado,RIFT VALLEY,23126
KAJIADO CENTRAL,Rural,3,2594,2472,5066,Kajiado,RIFT VALLEY,23127
KAJIADO CENTRAL,Rural,4,2589,2436,5025,Kajiado,RIFT VALLEY,23128
KAJIADO CENTRAL,Rural,5,2588,2498,5086,Kajiado,RIFT VALLEY,23129
KAJIADO CENTRAL,Rural,6,2449,2333,4782,Kajiado,RIFT VALLEY,23130
KAJIADO CENTRAL,Rural,7,2312,2289,4601,Kajiado,RIFT VALLEY,23131
KAJIADO CENTRAL,Rural,8,2239,2245,4484,Kajiado,RIFT VALLEY,23132
KAJIADO CENTRAL,Rural,9,1942,1926,3868,Kajiado,RIFT VALLEY,23133
KAJIADO CENTRAL,Rural,10,2573,2444,5017,Kajiado,RIFT VALLEY,23134
KAJIADO CENTRAL,Rural,11,1529,1585,3114,Kajiado,RIFT VALLEY,23135
KAJIADO CENTRAL,Rural,12,2288,1960,4248,Kajiado,RIFT VALLEY,23136
KAJIADO CENTRAL,Rural,13,1703,1578,3281,Kajiado,RIFT VALLEY,23137
KAJIADO CENTRAL,Rural,14,1695,1512,3207,Kajiado,RIFT VALLEY,23138
KAJIADO CENTRAL,Rural,15,1747,1536,3283,Kajiado,RIFT VALLEY,23139
KAJIADO CENTRAL,Rural,16,1472,1364,2836,Kajiado,RIFT VALLEY,23140
KAJIADO CENTRAL,Rural,17,1386,1113,2499,Kajiado,RIFT VALLEY,23141
KAJIADO CENTRAL,Rural,18,1418,1440,2858,Kajiado,RIFT VALLEY,23142
KAJIADO CENTRAL,Rural,19,1027,985,2012,Kajiado,RIFT VALLEY,23143
KAJIADO CENTRAL,Rural,20,1346,1798,3144,Kajiado,RIFT VALLEY,23144
KAJIADO CENTRAL,Rural,21,698,1008,1706,Kajiado,RIFT VALLEY,23145
KAJIADO CENTRAL,Rural,22,995,1322,2317,Kajiado,RIFT VALLEY,23146
KAJIADO CENTRAL,Rural,23,798,1044,1842,Kajiado,RIFT VALLEY,23147
KAJIADO CENTRAL,Rural,24,860,1078,1938,Kajiado,RIFT VALLEY,23148
KAJIADO CENTRAL,Rural,25,1160,1510,2670,Kajiado,RIFT VALLEY,23149
KAJIADO CENTRAL,Rural,26,833,938,1771,Kajiado,RIFT VALLEY,23150
KAJIADO CENTRAL,Rural,27,858,842,1700,Kajiado,RIFT VALLEY,23151
KAJIADO CENTRAL,Rural,28,850,991,1841,Kajiado,RIFT VALLEY,23152
KAJIADO CENTRAL,Rural,29,526,580,1106,Kajiado,RIFT VALLEY,23153
KAJIADO CENTRAL,Rural,30,944,1207,2151,Kajiado,RIFT VALLEY,23154
KAJIADO CENTRAL,Rural,31,459,474,933,Kajiado,RIFT VALLEY,23155
KAJIADO CENTRAL,Rural,32,627,933,1560,Kajiado,RIFT VALLEY,23156
KAJIADO CENTRAL,Rural,33,392,420,812,Kajiado,RIFT VALLEY,23157
KAJIADO CENTRAL,Rural,34,442,416,858,Kajiado,RIFT VALLEY,23158
KAJIADO CENTRAL,Rural,35,990,1168,2158,Kajiado,RIFT VALLEY,23159
KAJIADO CENTRAL,Rural,36,449,556,1005,Kajiado,RIFT VALLEY,23160
KAJIADO CENTRAL,Rural,37,445,529,974,Kajiado,RIFT VALLEY,23161
KAJIADO CENTRAL,Rural,38,492,548,1040,Kajiado,RIFT VALLEY,23162
KAJIADO CENTRAL,Rural,39,351,349,700,Kajiado,RIFT VALLEY,23163
KAJIADO CENTRAL,Rural,40,790,902,1692,Kajiado,RIFT VALLEY,23164
KAJIADO CENTRAL,Rural,41,313,356,669,Kajiado,RIFT VALLEY,23165
KAJIADO CENTRAL,Rural,42,371,455,826,Kajiado,RIFT VALLEY,23166
KAJIADO CENTRAL,Rural,43,214,218,432,Kajiado,RIFT VALLEY,23167
KAJIADO CENTRAL,Rural,44,218,281,499,Kajiado,RIFT VALLEY,23168
KAJIADO CENTRAL,Rural,45,528,634,1162,Kajiado,RIFT VALLEY,23169
KAJIADO CENTRAL,Rural,46,251,304,555,Kajiado,RIFT VALLEY,23170
KAJIADO CENTRAL,Rural,47,203,205,408,Kajiado,RIFT VALLEY,23171
KAJIADO CENTRAL,Rural,48,278,318,596,Kajiado,RIFT VALLEY,23172
KAJIADO CENTRAL,Rural,49,220,289,509,Kajiado,RIFT VALLEY,23173
KAJIADO CENTRAL,Rural,50,467,546,1013,Kajiado,RIFT VALLEY,23174
KAJIADO CENTRAL,Rural,51,171,188,359,Kajiado,RIFT VALLEY,23175
KAJIADO CENTRAL,Rural,52,221,198,419,Kajiado,RIFT VALLEY,23176
KAJIADO CENTRAL,Rural,53,175,172,347,Kajiado,RIFT VALLEY,23177
KAJIADO CENTRAL,Rural,54,199,178,377,Kajiado,RIFT VALLEY,23178
KAJIADO CENTRAL,Rural,55,325,315,640,Kajiado,RIFT VALLEY,23179
KAJIADO CENTRAL,Rural,56,164,178,342,Kajiado,RIFT VALLEY,23180
KAJIADO CENTRAL,Rural,57,168,117,285,Kajiado,RIFT VALLEY,23181
KAJIADO CENTRAL,Rural,58,141,119,260,Kajiado,RIFT VALLEY,23182
KAJIADO CENTRAL,Rural,59,125,125,250,Kajiado,RIFT VALLEY,23183
KAJIADO CENTRAL,Rural,60,327,417,744,Kajiado,RIFT VALLEY,23184
KAJIADO CENTRAL,Rural,61,75,95,170,Kajiado,RIFT VALLEY,23185
KAJIADO CENTRAL,Rural,62,134,105,239,Kajiado,RIFT VALLEY,23186
KAJIADO CENTRAL,Rural,63,91,63,154,Kajiado,RIFT VALLEY,23187
KAJIADO CENTRAL,Rural,64,102,110,212,Kajiado,RIFT VALLEY,23188
KAJIADO CENTRAL,Rural,65,234,207,441,Kajiado,RIFT VALLEY,23189
KAJIADO CENTRAL,Rural,66,47,39,86,Kajiado,RIFT VALLEY,23190
KAJIADO CENTRAL,Rural,67,62,61,123,Kajiado,RIFT VALLEY,23191
KAJIADO CENTRAL,Rural,68,102,71,173,Kajiado,RIFT VALLEY,23192
KAJIADO CENTRAL,Rural,69,93,89,182,Kajiado,RIFT VALLEY,23193
KAJIADO CENTRAL,Rural,70,279,322,601,Kajiado,RIFT VALLEY,23194
KAJIADO CENTRAL,Rural,71,34,37,71,Kajiado,RIFT VALLEY,23195
KAJIADO CENTRAL,Rural,72,54,54,108,Kajiado,RIFT VALLEY,23196
KAJIADO CENTRAL,Rural,73,37,45,82,Kajiado,RIFT VALLEY,23197
KAJIADO CENTRAL,Rural,74,52,68,120,Kajiado,RIFT VALLEY,23198
KAJIADO CENTRAL,Rural,75,125,125,250,Kajiado,RIFT VALLEY,23199
KAJIADO CENTRAL,Rural,76,31,33,64,Kajiado,RIFT VALLEY,23200
KAJIADO CENTRAL,Rural,77,23,20,43,Kajiado,RIFT VALLEY,23201
KAJIADO CENTRAL,Rural,78,32,46,78,Kajiado,RIFT VALLEY,23202
KAJIADO CENTRAL,Rural,79,43,57,100,Kajiado,RIFT VALLEY,23203
KAJIADO CENTRAL,Rural,80+,525,661,1186,Kajiado,RIFT VALLEY,23204
KAJIADO CENTRAL,Rural,Age NS,37,25,62,Kajiado,RIFT VALLEY,23205
LOITOKITOK,Rural,0,2435,2249,4684,Kajiado,RIFT VALLEY,23206
LOITOKITOK,Rural,1,2015,1985,4000,Kajiado,RIFT VALLEY,23207
LOITOKITOK,Rural,2,2445,2388,4833,Kajiado,RIFT VALLEY,23208
LOITOKITOK,Rural,3,2473,2234,4707,Kajiado,RIFT VALLEY,23209
LOITOKITOK,Rural,4,2354,2357,4711,Kajiado,RIFT VALLEY,23210
LOITOKITOK,Rural,5,2359,2290,4649,Kajiado,RIFT VALLEY,23211
LOITOKITOK,Rural,6,2185,2136,4321,Kajiado,RIFT VALLEY,23212
LOITOKITOK,Rural,7,2120,1966,4086,Kajiado,RIFT VALLEY,23213
LOITOKITOK,Rural,8,2062,2065,4127,Kajiado,RIFT VALLEY,23214
LOITOKITOK,Rural,9,1788,1683,3471,Kajiado,RIFT VALLEY,23215
LOITOKITOK,Rural,10,2250,2229,4479,Kajiado,RIFT VALLEY,23216
LOITOKITOK,Rural,11,1309,1365,2674,Kajiado,RIFT VALLEY,23217
LOITOKITOK,Rural,12,1988,1857,3845,Kajiado,RIFT VALLEY,23218
LOITOKITOK,Rural,13,1489,1459,2948,Kajiado,RIFT VALLEY,23219
LOITOKITOK,Rural,14,1624,1418,3042,Kajiado,RIFT VALLEY,23220
LOITOKITOK,Rural,15,1541,1377,2918,Kajiado,RIFT VALLEY,23221
LOITOKITOK,Rural,16,1363,1221,2584,Kajiado,RIFT VALLEY,23222
LOITOKITOK,Rural,17,1230,1094,2324,Kajiado,RIFT VALLEY,23223
LOITOKITOK,Rural,18,1341,1298,2639,Kajiado,RIFT VALLEY,23224
LOITOKITOK,Rural,19,963,997,1960,Kajiado,RIFT VALLEY,23225
LOITOKITOK,Rural,20,1256,1753,3009,Kajiado,RIFT VALLEY,23226
LOITOKITOK,Rural,21,709,904,1613,Kajiado,RIFT VALLEY,23227
LOITOKITOK,Rural,22,883,1227,2110,Kajiado,RIFT VALLEY,23228
LOITOKITOK,Rural,23,830,944,1774,Kajiado,RIFT VALLEY,23229
LOITOKITOK,Rural,24,894,960,1854,Kajiado,RIFT VALLEY,23230
LOITOKITOK,Rural,25,1308,1330,2638,Kajiado,RIFT VALLEY,23231
LOITOKITOK,Rural,26,802,836,1638,Kajiado,RIFT VALLEY,23232
LOITOKITOK,Rural,27,839,718,1557,Kajiado,RIFT VALLEY,23233
LOITOKITOK,Rural,28,865,906,1771,Kajiado,RIFT VALLEY,23234
LOITOKITOK,Rural,29,651,631,1282,Kajiado,RIFT VALLEY,23235
LOITOKITOK,Rural,30,1213,1320,2533,Kajiado,RIFT VALLEY,23236
LOITOKITOK,Rural,31,528,518,1046,Kajiado,RIFT VALLEY,23237
LOITOKITOK,Rural,32,696,771,1467,Kajiado,RIFT VALLEY,23238
LOITOKITOK,Rural,33,406,433,839,Kajiado,RIFT VALLEY,23239
LOITOKITOK,Rural,34,499,447,946,Kajiado,RIFT VALLEY,23240
LOITOKITOK,Rural,35,905,1005,1910,Kajiado,RIFT VALLEY,23241
LOITOKITOK,Rural,36,518,627,1145,Kajiado,RIFT VALLEY,23242
LOITOKITOK,Rural,37,545,457,1002,Kajiado,RIFT VALLEY,23243
LOITOKITOK,Rural,38,582,541,1123,Kajiado,RIFT VALLEY,23244
LOITOKITOK,Rural,39,421,374,795,Kajiado,RIFT VALLEY,23245
LOITOKITOK,Rural,40,992,922,1914,Kajiado,RIFT VALLEY,23246
LOITOKITOK,Rural,41,283,319,602,Kajiado,RIFT VALLEY,23247
LOITOKITOK,Rural,42,522,429,951,Kajiado,RIFT VALLEY,23248
LOITOKITOK,Rural,43,290,285,575,Kajiado,RIFT VALLEY,23249
LOITOKITOK,Rural,44,282,307,589,Kajiado,RIFT VALLEY,23250
LOITOKITOK,Rural,45,557,583,1140,Kajiado,RIFT VALLEY,23251
LOITOKITOK,Rural,46,332,291,623,Kajiado,RIFT VALLEY,23252
LOITOKITOK,Rural,47,256,267,523,Kajiado,RIFT VALLEY,23253
LOITOKITOK,Rural,48,279,378,657,Kajiado,RIFT VALLEY,23254
LOITOKITOK,Rural,49,242,280,522,Kajiado,RIFT VALLEY,23255
LOITOKITOK,Rural,50,524,626,1150,Kajiado,RIFT VALLEY,23256
LOITOKITOK,Rural,51,170,169,339,Kajiado,RIFT VALLEY,23257
LOITOKITOK,Rural,52,263,215,478,Kajiado,RIFT VALLEY,23258
LOITOKITOK,Rural,53,153,155,308,Kajiado,RIFT VALLEY,23259
LOITOKITOK,Rural,54,182,149,331,Kajiado,RIFT VALLEY,23260
LOITOKITOK,Rural,55,310,245,555,Kajiado,RIFT VALLEY,23261
LOITOKITOK,Rural,56,204,167,371,Kajiado,RIFT VALLEY,23262
LOITOKITOK,Rural,57,184,158,342,Kajiado,RIFT VALLEY,23263
LOITOKITOK,Rural,58,145,126,271,Kajiado,RIFT VALLEY,23264
LOITOKITOK,Rural,59,127,139,266,Kajiado,RIFT VALLEY,23265
LOITOKITOK,Rural,60,369,383,752,Kajiado,RIFT VALLEY,23266
LOITOKITOK,Rural,61,100,76,176,Kajiado,RIFT VALLEY,23267
LOITOKITOK,Rural,62,101,115,216,Kajiado,RIFT VALLEY,23268
LOITOKITOK,Rural,63,72,68,140,Kajiado,RIFT VALLEY,23269
LOITOKITOK,Rural,64,113,109,222,Kajiado,RIFT VALLEY,23270
LOITOKITOK,Rural,65,185,209,394,Kajiado,RIFT VALLEY,23271
LOITOKITOK,Rural,66,68,76,144,Kajiado,RIFT VALLEY,23272
LOITOKITOK,Rural,67,98,70,168,Kajiado,RIFT VALLEY,23273
LOITOKITOK,Rural,68,82,88,170,Kajiado,RIFT VALLEY,23274
LOITOKITOK,Rural,69,73,90,163,Kajiado,RIFT VALLEY,23275
LOITOKITOK,Rural,70,265,278,543,Kajiado,RIFT VALLEY,23276
LOITOKITOK,Rural,71,25,39,64,Kajiado,RIFT VALLEY,23277
LOITOKITOK,Rural,72,73,44,117,Kajiado,RIFT VALLEY,23278
LOITOKITOK,Rural,73,48,35,83,Kajiado,RIFT VALLEY,23279
LOITOKITOK,Rural,74,43,39,82,Kajiado,RIFT VALLEY,23280
LOITOKITOK,Rural,75,85,112,197,Kajiado,RIFT VALLEY,23281
LOITOKITOK,Rural,76,36,44,80,Kajiado,RIFT VALLEY,23282
LOITOKITOK,Rural,77,32,27,59,Kajiado,RIFT VALLEY,23283
LOITOKITOK,Rural,78,54,59,113,Kajiado,RIFT VALLEY,23284
LOITOKITOK,Rural,79,43,45,88,Kajiado,RIFT VALLEY,23285
LOITOKITOK,Rural,80+,501,662,1163,Kajiado,RIFT VALLEY,23286
LOITOKITOK,Rural,Age NS,25,29,54,Kajiado,RIFT VALLEY,23287
KERICHO,Rural,0,3993,3909,7902,Kericho,RIFT VALLEY,23288
KERICHO,Rural,1,3672,3498,7170,Kericho,RIFT VALLEY,23289
KERICHO,Rural,2,4289,4132,8421,Kericho,RIFT VALLEY,23290
KERICHO,Rural,3,4107,4003,8110,Kericho,RIFT VALLEY,23291
KERICHO,Rural,4,4231,3926,8157,Kericho,RIFT VALLEY,23292
KERICHO,Rural,5,4221,3951,8172,Kericho,RIFT VALLEY,23293
KERICHO,Rural,6,3816,3654,7470,Kericho,RIFT VALLEY,23294
KERICHO,Rural,7,3503,3472,6975,Kericho,RIFT VALLEY,23295
KERICHO,Rural,8,3632,3615,7247,Kericho,RIFT VALLEY,23296
KERICHO,Rural,9,3894,3738,7632,Kericho,RIFT VALLEY,23297
KERICHO,Rural,10,3629,3642,7271,Kericho,RIFT VALLEY,23298
KERICHO,Rural,11,2790,2834,5624,Kericho,RIFT VALLEY,23299
KERICHO,Rural,12,3307,3311,6618,Kericho,RIFT VALLEY,23300
KERICHO,Rural,13,3114,3232,6346,Kericho,RIFT VALLEY,23301
KERICHO,Rural,14,2902,2887,5789,Kericho,RIFT VALLEY,23302
KERICHO,Rural,15,2846,2829,5675,Kericho,RIFT VALLEY,23303
KERICHO,Rural,16,2787,2722,5509,Kericho,RIFT VALLEY,23304
KERICHO,Rural,17,2853,2726,5579,Kericho,RIFT VALLEY,23305
KERICHO,Rural,18,2830,2653,5483,Kericho,RIFT VALLEY,23306
KERICHO,Rural,19,2395,2435,4830,Kericho,RIFT VALLEY,23307
KERICHO,Rural,20,2843,3404,6247,Kericho,RIFT VALLEY,23308
KERICHO,Rural,21,2098,2194,4292,Kericho,RIFT VALLEY,23309
KERICHO,Rural,22,2480,2762,5242,Kericho,RIFT VALLEY,23310
KERICHO,Rural,23,2208,2509,4717,Kericho,RIFT VALLEY,23311
KERICHO,Rural,24,2229,2295,4524,Kericho,RIFT VALLEY,23312
KERICHO,Rural,25,2678,2895,5573,Kericho,RIFT VALLEY,23313
KERICHO,Rural,26,1830,1829,3659,Kericho,RIFT VALLEY,23314
KERICHO,Rural,27,2067,1818,3885,Kericho,RIFT VALLEY,23315
KERICHO,Rural,28,1569,1589,3158,Kericho,RIFT VALLEY,23316
KERICHO,Rural,29,1761,1552,3313,Kericho,RIFT VALLEY,23317
KERICHO,Rural,30,2463,2442,4905,Kericho,RIFT VALLEY,23318
KERICHO,Rural,31,1744,1420,3164,Kericho,RIFT VALLEY,23319
KERICHO,Rural,32,1805,1511,3316,Kericho,RIFT VALLEY,23320
KERICHO,Rural,33,1406,1156,2562,Kericho,RIFT VALLEY,23321
KERICHO,Rural,34,1383,1132,2515,Kericho,RIFT VALLEY,23322
KERICHO,Rural,35,2402,1961,4363,Kericho,RIFT VALLEY,23323
KERICHO,Rural,36,1318,1081,2399,Kericho,RIFT VALLEY,23324
KERICHO,Rural,37,1390,1206,2596,Kericho,RIFT VALLEY,23325
KERICHO,Rural,38,969,931,1900,Kericho,RIFT VALLEY,23326
KERICHO,Rural,39,1052,982,2034,Kericho,RIFT VALLEY,23327
KERICHO,Rural,40,1534,1588,3122,Kericho,RIFT VALLEY,23328
KERICHO,Rural,41,949,825,1774,Kericho,RIFT VALLEY,23329
KERICHO,Rural,42,838,670,1508,Kericho,RIFT VALLEY,23330
KERICHO,Rural,43,673,532,1205,Kericho,RIFT VALLEY,23331
KERICHO,Rural,44,600,535,1135,Kericho,RIFT VALLEY,23332
KERICHO,Rural,45,999,982,1981,Kericho,RIFT VALLEY,23333
KERICHO,Rural,46,689,629,1318,Kericho,RIFT VALLEY,23334
KERICHO,Rural,47,798,721,1519,Kericho,RIFT VALLEY,23335
KERICHO,Rural,48,1140,1106,2246,Kericho,RIFT VALLEY,23336
KERICHO,Rural,49,769,542,1311,Kericho,RIFT VALLEY,23337
KERICHO,Rural,50,988,955,1943,Kericho,RIFT VALLEY,23338
KERICHO,Rural,51,585,482,1067,Kericho,RIFT VALLEY,23339
KERICHO,Rural,52,543,480,1023,Kericho,RIFT VALLEY,23340
KERICHO,Rural,53,526,408,934,Kericho,RIFT VALLEY,23341
KERICHO,Rural,54,417,378,795,Kericho,RIFT VALLEY,23342
KERICHO,Rural,55,698,635,1333,Kericho,RIFT VALLEY,23343
KERICHO,Rural,56,389,307,696,Kericho,RIFT VALLEY,23344
KERICHO,Rural,57,563,472,1035,Kericho,RIFT VALLEY,23345
KERICHO,Rural,58,246,258,504,Kericho,RIFT VALLEY,23346
KERICHO,Rural,59,363,370,733,Kericho,RIFT VALLEY,23347
KERICHO,Rural,60,540,629,1169,Kericho,RIFT VALLEY,23348
KERICHO,Rural,61,477,312,789,Kericho,RIFT VALLEY,23349
KERICHO,Rural,62,287,197,484,Kericho,RIFT VALLEY,23350
KERICHO,Rural,63,255,198,453,Kericho,RIFT VALLEY,23351
KERICHO,Rural,64,226,273,499,Kericho,RIFT VALLEY,23352
KERICHO,Rural,65,273,307,580,Kericho,RIFT VALLEY,23353
KERICHO,Rural,66,154,130,284,Kericho,RIFT VALLEY,23354
KERICHO,Rural,67,264,180,444,Kericho,RIFT VALLEY,23355
KERICHO,Rural,68,127,183,310,Kericho,RIFT VALLEY,23356
KERICHO,Rural,69,180,270,450,Kericho,RIFT VALLEY,23357
KERICHO,Rural,70,295,513,808,Kericho,RIFT VALLEY,23358
KERICHO,Rural,71,103,136,239,Kericho,RIFT VALLEY,23359
KERICHO,Rural,72,137,113,250,Kericho,RIFT VALLEY,23360
KERICHO,Rural,73,110,132,242,Kericho,RIFT VALLEY,23361
KERICHO,Rural,74,128,155,283,Kericho,RIFT VALLEY,23362
KERICHO,Rural,75,181,209,390,Kericho,RIFT VALLEY,23363
KERICHO,Rural,76,86,109,195,Kericho,RIFT VALLEY,23364
KERICHO,Rural,77,108,74,182,Kericho,RIFT VALLEY,23365
KERICHO,Rural,78,108,119,227,Kericho,RIFT VALLEY,23366
KERICHO,Rural,79,134,221,355,Kericho,RIFT VALLEY,23367
KERICHO,Rural,80+,1080,1457,2537,Kericho,RIFT VALLEY,23368
KERICHO,Rural,Age NS,131,111,242,Kericho,RIFT VALLEY,23369
KIPKELION,Rural,0,2026,2008,4034,Kericho,RIFT VALLEY,23370
KIPKELION,Rural,1,1920,1747,3667,Kericho,RIFT VALLEY,23371
KIPKELION,Rural,2,1948,2042,3990,Kericho,RIFT VALLEY,23372
KIPKELION,Rural,3,1937,1896,3833,Kericho,RIFT VALLEY,23373
KIPKELION,Rural,4,1912,1899,3811,Kericho,RIFT VALLEY,23374
KIPKELION,Rural,5,2010,1848,3858,Kericho,RIFT VALLEY,23375
KIPKELION,Rural,6,1920,1783,3703,Kericho,RIFT VALLEY,23376
KIPKELION,Rural,7,1719,1764,3483,Kericho,RIFT VALLEY,23377
KIPKELION,Rural,8,1812,1679,3491,Kericho,RIFT VALLEY,23378
KIPKELION,Rural,9,1819,1727,3546,Kericho,RIFT VALLEY,23379
KIPKELION,Rural,10,1848,1739,3587,Kericho,RIFT VALLEY,23380
KIPKELION,Rural,11,1387,1375,2762,Kericho,RIFT VALLEY,23381
KIPKELION,Rural,12,1707,1562,3269,Kericho,RIFT VALLEY,23382
KIPKELION,Rural,13,1529,1515,3044,Kericho,RIFT VALLEY,23383
KIPKELION,Rural,14,1452,1365,2817,Kericho,RIFT VALLEY,23384
KIPKELION,Rural,15,1377,1339,2716,Kericho,RIFT VALLEY,23385
KIPKELION,Rural,16,1352,1244,2596,Kericho,RIFT VALLEY,23386
KIPKELION,Rural,17,1359,1203,2562,Kericho,RIFT VALLEY,23387
KIPKELION,Rural,18,1186,1206,2392,Kericho,RIFT VALLEY,23388
KIPKELION,Rural,19,1074,1083,2157,Kericho,RIFT VALLEY,23389
KIPKELION,Rural,20,1278,1495,2773,Kericho,RIFT VALLEY,23390
KIPKELION,Rural,21,930,1006,1936,Kericho,RIFT VALLEY,23391
KIPKELION,Rural,22,1045,1190,2235,Kericho,RIFT VALLEY,23392
KIPKELION,Rural,23,1023,1088,2111,Kericho,RIFT VALLEY,23393
KIPKELION,Rural,24,936,920,1856,Kericho,RIFT VALLEY,23394
KIPKELION,Rural,25,1139,1166,2305,Kericho,RIFT VALLEY,23395
KIPKELION,Rural,26,795,755,1550,Kericho,RIFT VALLEY,23396
KIPKELION,Rural,27,925,771,1696,Kericho,RIFT VALLEY,23397
KIPKELION,Rural,28,617,690,1307,Kericho,RIFT VALLEY,23398
KIPKELION,Rural,29,704,626,1330,Kericho,RIFT VALLEY,23399
KIPKELION,Rural,30,955,908,1863,Kericho,RIFT VALLEY,23400
KIPKELION,Rural,31,729,592,1321,Kericho,RIFT VALLEY,23401
KIPKELION,Rural,32,711,600,1311,Kericho,RIFT VALLEY,23402
KIPKELION,Rural,33,533,545,1078,Kericho,RIFT VALLEY,23403
KIPKELION,Rural,34,550,481,1031,Kericho,RIFT VALLEY,23404
KIPKELION,Rural,35,914,827,1741,Kericho,RIFT VALLEY,23405
KIPKELION,Rural,36,517,445,962,Kericho,RIFT VALLEY,23406
KIPKELION,Rural,37,567,495,1062,Kericho,RIFT VALLEY,23407
KIPKELION,Rural,38,434,374,808,Kericho,RIFT VALLEY,23408
KIPKELION,Rural,39,441,396,837,Kericho,RIFT VALLEY,23409
KIPKELION,Rural,40,611,659,1270,Kericho,RIFT VALLEY,23410
KIPKELION,Rural,41,400,354,754,Kericho,RIFT VALLEY,23411
KIPKELION,Rural,42,369,291,660,Kericho,RIFT VALLEY,23412
KIPKELION,Rural,43,297,235,532,Kericho,RIFT VALLEY,23413
KIPKELION,Rural,44,261,248,509,Kericho,RIFT VALLEY,23414
KIPKELION,Rural,45,414,474,888,Kericho,RIFT VALLEY,23415
KIPKELION,Rural,46,310,308,618,Kericho,RIFT VALLEY,23416
KIPKELION,Rural,47,333,341,674,Kericho,RIFT VALLEY,23417
KIPKELION,Rural,48,444,516,960,Kericho,RIFT VALLEY,23418
KIPKELION,Rural,49,322,298,620,Kericho,RIFT VALLEY,23419
KIPKELION,Rural,50,392,451,843,Kericho,RIFT VALLEY,23420
KIPKELION,Rural,51,238,243,481,Kericho,RIFT VALLEY,23421
KIPKELION,Rural,52,273,243,516,Kericho,RIFT VALLEY,23422
KIPKELION,Rural,53,238,164,402,Kericho,RIFT VALLEY,23423
KIPKELION,Rural,54,181,212,393,Kericho,RIFT VALLEY,23424
KIPKELION,Rural,55,300,267,567,Kericho,RIFT VALLEY,23425
KIPKELION,Rural,56,171,159,330,Kericho,RIFT VALLEY,23426
KIPKELION,Rural,57,270,237,507,Kericho,RIFT VALLEY,23427
KIPKELION,Rural,58,120,110,230,Kericho,RIFT VALLEY,23428
KIPKELION,Rural,59,179,166,345,Kericho,RIFT VALLEY,23429
KIPKELION,Rural,60,249,297,546,Kericho,RIFT VALLEY,23430
KIPKELION,Rural,61,190,129,319,Kericho,RIFT VALLEY,23431
KIPKELION,Rural,62,132,75,207,Kericho,RIFT VALLEY,23432
KIPKELION,Rural,63,121,90,211,Kericho,RIFT VALLEY,23433
KIPKELION,Rural,64,105,122,227,Kericho,RIFT VALLEY,23434
KIPKELION,Rural,65,145,166,311,Kericho,RIFT VALLEY,23435
KIPKELION,Rural,66,80,83,163,Kericho,RIFT VALLEY,23436
KIPKELION,Rural,67,117,88,205,Kericho,RIFT VALLEY,23437
KIPKELION,Rural,68,59,73,132,Kericho,RIFT VALLEY,23438
KIPKELION,Rural,69,92,116,208,Kericho,RIFT VALLEY,23439
KIPKELION,Rural,70,126,219,345,Kericho,RIFT VALLEY,23440
KIPKELION,Rural,71,58,63,121,Kericho,RIFT VALLEY,23441
KIPKELION,Rural,72,71,49,120,Kericho,RIFT VALLEY,23442
KIPKELION,Rural,73,57,53,110,Kericho,RIFT VALLEY,23443
KIPKELION,Rural,74,75,63,138,Kericho,RIFT VALLEY,23444
KIPKELION,Rural,75,70,85,155,Kericho,RIFT VALLEY,23445
KIPKELION,Rural,76,43,36,79,Kericho,RIFT VALLEY,23446
KIPKELION,Rural,77,65,40,105,Kericho,RIFT VALLEY,23447
KIPKELION,Rural,78,32,47,79,Kericho,RIFT VALLEY,23448
KIPKELION,Rural,79,60,82,142,Kericho,RIFT VALLEY,23449
KIPKELION,Rural,80+,432,533,965,Kericho,RIFT VALLEY,23450
KIPKELION,Rural,Age NS,7,9,16,Kericho,RIFT VALLEY,23451
BURET,Rural,0,4582,4354,8936,Bomet,RIFT VALLEY,23452
BURET,Rural,1,4127,3969,8096,Bomet,RIFT VALLEY,23453
BURET,Rural,2,4691,4448,9139,Bomet,RIFT VALLEY,23454
BURET,Rural,3,4594,4561,9155,Bomet,RIFT VALLEY,23455
BURET,Rural,4,4740,4662,9402,Bomet,RIFT VALLEY,23456
BURET,Rural,5,4752,4494,9246,Bomet,RIFT VALLEY,23457
BURET,Rural,6,4625,4534,9159,Bomet,RIFT VALLEY,23458
BURET,Rural,7,4453,4188,8641,Bomet,RIFT VALLEY,23459
BURET,Rural,8,4314,4424,8738,Bomet,RIFT VALLEY,23460
BURET,Rural,9,4423,4383,8806,Bomet,RIFT VALLEY,23461
BURET,Rural,10,4261,4143,8404,Bomet,RIFT VALLEY,23462
BURET,Rural,11,3253,3302,6555,Bomet,RIFT VALLEY,23463
BURET,Rural,12,3978,3966,7944,Bomet,RIFT VALLEY,23464
BURET,Rural,13,3553,3605,7158,Bomet,RIFT VALLEY,23465
BURET,Rural,14,3378,3257,6635,Bomet,RIFT VALLEY,23466
BURET,Rural,15,3371,3343,6714,Bomet,RIFT VALLEY,23467
BURET,Rural,16,3044,3075,6119,Bomet,RIFT VALLEY,23468
BURET,Rural,17,3259,2988,6247,Bomet,RIFT VALLEY,23469
BURET,Rural,18,3254,3024,6278,Bomet,RIFT VALLEY,23470
BURET,Rural,19,2675,2777,5452,Bomet,RIFT VALLEY,23471
BURET,Rural,20,3102,3713,6815,Bomet,RIFT VALLEY,23472
BURET,Rural,21,2384,2631,5015,Bomet,RIFT VALLEY,23473
BURET,Rural,22,2611,3163,5774,Bomet,RIFT VALLEY,23474
BURET,Rural,23,2469,2984,5453,Bomet,RIFT VALLEY,23475
BURET,Rural,24,2460,2727,5187,Bomet,RIFT VALLEY,23476
BURET,Rural,25,2951,3125,6076,Bomet,RIFT VALLEY,23477
BURET,Rural,26,2148,2111,4259,Bomet,RIFT VALLEY,23478
BURET,Rural,27,2397,2199,4596,Bomet,RIFT VALLEY,23479
BURET,Rural,28,1906,1941,3847,Bomet,RIFT VALLEY,23480
BURET,Rural,29,2076,1728,3804,Bomet,RIFT VALLEY,23481
BURET,Rural,30,2753,2570,5323,Bomet,RIFT VALLEY,23482
BURET,Rural,31,2009,1516,3525,Bomet,RIFT VALLEY,23483
BURET,Rural,32,1934,1645,3579,Bomet,RIFT VALLEY,23484
BURET,Rural,33,1480,1193,2673,Bomet,RIFT VALLEY,23485
BURET,Rural,34,1511,1267,2778,Bomet,RIFT VALLEY,23486
BURET,Rural,35,2552,2185,4737,Bomet,RIFT VALLEY,23487
BURET,Rural,36,1451,1165,2616,Bomet,RIFT VALLEY,23488
BURET,Rural,37,1512,1376,2888,Bomet,RIFT VALLEY,23489
BURET,Rural,38,1073,1068,2141,Bomet,RIFT VALLEY,23490
BURET,Rural,39,1264,1060,2324,Bomet,RIFT VALLEY,23491
BURET,Rural,40,1568,1665,3233,Bomet,RIFT VALLEY,23492
BURET,Rural,41,1063,827,1890,Bomet,RIFT VALLEY,23493
BURET,Rural,42,862,673,1535,Bomet,RIFT VALLEY,23494
BURET,Rural,43,675,598,1273,Bomet,RIFT VALLEY,23495
BURET,Rural,44,669,543,1212,Bomet,RIFT VALLEY,23496
BURET,Rural,45,1002,965,1967,Bomet,RIFT VALLEY,23497
BURET,Rural,46,756,667,1423,Bomet,RIFT VALLEY,23498
BURET,Rural,47,907,792,1699,Bomet,RIFT VALLEY,23499
BURET,Rural,48,1261,1277,2538,Bomet,RIFT VALLEY,23500
BURET,Rural,49,927,655,1582,Bomet,RIFT VALLEY,23501
BURET,Rural,50,1039,983,2022,Bomet,RIFT VALLEY,23502
BURET,Rural,51,719,543,1262,Bomet,RIFT VALLEY,23503
BURET,Rural,52,677,498,1175,Bomet,RIFT VALLEY,23504
BURET,Rural,53,591,458,1049,Bomet,RIFT VALLEY,23505
BURET,Rural,54,463,398,861,Bomet,RIFT VALLEY,23506
BURET,Rural,55,724,622,1346,Bomet,RIFT VALLEY,23507
BURET,Rural,56,428,357,785,Bomet,RIFT VALLEY,23508
BURET,Rural,57,691,510,1201,Bomet,RIFT VALLEY,23509
BURET,Rural,58,310,262,572,Bomet,RIFT VALLEY,23510
BURET,Rural,59,411,334,745,Bomet,RIFT VALLEY,23511
BURET,Rural,60,606,630,1236,Bomet,RIFT VALLEY,23512
BURET,Rural,61,531,360,891,Bomet,RIFT VALLEY,23513
BURET,Rural,62,305,186,491,Bomet,RIFT VALLEY,23514
BURET,Rural,63,287,213,500,Bomet,RIFT VALLEY,23515
BURET,Rural,64,275,287,562,Bomet,RIFT VALLEY,23516
BURET,Rural,65,284,313,597,Bomet,RIFT VALLEY,23517
BURET,Rural,66,141,154,295,Bomet,RIFT VALLEY,23518
BURET,Rural,67,282,234,516,Bomet,RIFT VALLEY,23519
BURET,Rural,68,160,153,313,Bomet,RIFT VALLEY,23520
BURET,Rural,69,185,266,451,Bomet,RIFT VALLEY,23521
BURET,Rural,70,311,430,741,Bomet,RIFT VALLEY,23522
BURET,Rural,71,133,157,290,Bomet,RIFT VALLEY,23523
BURET,Rural,72,128,119,247,Bomet,RIFT VALLEY,23524
BURET,Rural,73,147,124,271,Bomet,RIFT VALLEY,23525
BURET,Rural,74,147,178,325,Bomet,RIFT VALLEY,23526
BURET,Rural,75,136,208,344,Bomet,RIFT VALLEY,23527
BURET,Rural,76,131,125,256,Bomet,RIFT VALLEY,23528
BURET,Rural,77,123,123,246,Bomet,RIFT VALLEY,23529
BURET,Rural,78,95,130,225,Bomet,RIFT VALLEY,23530
BURET,Rural,79,115,210,325,Bomet,RIFT VALLEY,23531
BURET,Rural,80+,1031,1516,2547,Bomet,RIFT VALLEY,23532
BURET,Rural,Age NS,62,46,108,Bomet,RIFT VALLEY,23533
SOTIK,Rural,0,3287,3076,6363,Bomet,RIFT VALLEY,23534
SOTIK,Rural,1,2820,2694,5514,Bomet,RIFT VALLEY,23535
SOTIK,Rural,2,3215,2947,6162,Bomet,RIFT VALLEY,23536
SOTIK,Rural,3,3133,3109,6242,Bomet,RIFT VALLEY,23537
SOTIK,Rural,4,3185,2985,6170,Bomet,RIFT VALLEY,23538
SOTIK,Rural,5,3210,3024,6234,Bomet,RIFT VALLEY,23539
SOTIK,Rural,6,2924,2872,5796,Bomet,RIFT VALLEY,23540
SOTIK,Rural,7,2867,2700,5567,Bomet,RIFT VALLEY,23541
SOTIK,Rural,8,2748,2727,5475,Bomet,RIFT VALLEY,23542
SOTIK,Rural,9,2984,2973,5957,Bomet,RIFT VALLEY,23543
SOTIK,Rural,10,2736,2701,5437,Bomet,RIFT VALLEY,23544
SOTIK,Rural,11,2162,2167,4329,Bomet,RIFT VALLEY,23545
SOTIK,Rural,12,2625,2698,5323,Bomet,RIFT VALLEY,23546
SOTIK,Rural,13,2420,2603,5023,Bomet,RIFT VALLEY,23547
SOTIK,Rural,14,2258,2291,4549,Bomet,RIFT VALLEY,23548
SOTIK,Rural,15,2345,2279,4624,Bomet,RIFT VALLEY,23549
SOTIK,Rural,16,2190,2229,4419,Bomet,RIFT VALLEY,23550
SOTIK,Rural,17,2171,2165,4336,Bomet,RIFT VALLEY,23551
SOTIK,Rural,18,2154,2022,4176,Bomet,RIFT VALLEY,23552
SOTIK,Rural,19,1847,1816,3663,Bomet,RIFT VALLEY,23553
SOTIK,Rural,20,1962,2401,4363,Bomet,RIFT VALLEY,23554
SOTIK,Rural,21,1444,1756,3200,Bomet,RIFT VALLEY,23555
SOTIK,Rural,22,1603,1996,3599,Bomet,RIFT VALLEY,23556
SOTIK,Rural,23,1418,1728,3146,Bomet,RIFT VALLEY,23557
SOTIK,Rural,24,1388,1685,3073,Bomet,RIFT VALLEY,23558
SOTIK,Rural,25,1525,2053,3578,Bomet,RIFT VALLEY,23559
SOTIK,Rural,26,1188,1198,2386,Bomet,RIFT VALLEY,23560
SOTIK,Rural,27,1359,1234,2593,Bomet,RIFT VALLEY,23561
SOTIK,Rural,28,1035,1106,2141,Bomet,RIFT VALLEY,23562
SOTIK,Rural,29,1015,1062,2077,Bomet,RIFT VALLEY,23563
SOTIK,Rural,30,1411,1559,2970,Bomet,RIFT VALLEY,23564
SOTIK,Rural,31,1044,927,1971,Bomet,RIFT VALLEY,23565
SOTIK,Rural,32,987,964,1951,Bomet,RIFT VALLEY,23566
SOTIK,Rural,33,781,727,1508,Bomet,RIFT VALLEY,23567
SOTIK,Rural,34,725,803,1528,Bomet,RIFT VALLEY,23568
SOTIK,Rural,35,1390,1286,2676,Bomet,RIFT VALLEY,23569
SOTIK,Rural,36,726,751,1477,Bomet,RIFT VALLEY,23570
SOTIK,Rural,37,803,849,1652,Bomet,RIFT VALLEY,23571
SOTIK,Rural,38,515,573,1088,Bomet,RIFT VALLEY,23572
SOTIK,Rural,39,626,657,1283,Bomet,RIFT VALLEY,23573
SOTIK,Rural,40,858,983,1841,Bomet,RIFT VALLEY,23574
SOTIK,Rural,41,584,518,1102,Bomet,RIFT VALLEY,23575
SOTIK,Rural,42,467,487,954,Bomet,RIFT VALLEY,23576
SOTIK,Rural,43,417,401,818,Bomet,RIFT VALLEY,23577
SOTIK,Rural,44,387,455,842,Bomet,RIFT VALLEY,23578
SOTIK,Rural,45,592,647,1239,Bomet,RIFT VALLEY,23579
SOTIK,Rural,46,381,463,844,Bomet,RIFT VALLEY,23580
SOTIK,Rural,47,404,487,891,Bomet,RIFT VALLEY,23581
SOTIK,Rural,48,611,867,1478,Bomet,RIFT VALLEY,23582
SOTIK,Rural,49,460,404,864,Bomet,RIFT VALLEY,23583
SOTIK,Rural,50,601,646,1247,Bomet,RIFT VALLEY,23584
SOTIK,Rural,51,396,362,758,Bomet,RIFT VALLEY,23585
SOTIK,Rural,52,361,353,714,Bomet,RIFT VALLEY,23586
SOTIK,Rural,53,333,294,627,Bomet,RIFT VALLEY,23587
SOTIK,Rural,54,252,301,553,Bomet,RIFT VALLEY,23588
SOTIK,Rural,55,406,429,835,Bomet,RIFT VALLEY,23589
SOTIK,Rural,56,241,222,463,Bomet,RIFT VALLEY,23590
SOTIK,Rural,57,371,361,732,Bomet,RIFT VALLEY,23591
SOTIK,Rural,58,171,226,397,Bomet,RIFT VALLEY,23592
SOTIK,Rural,59,222,278,500,Bomet,RIFT VALLEY,23593
SOTIK,Rural,60,353,504,857,Bomet,RIFT VALLEY,23594
SOTIK,Rural,61,260,216,476,Bomet,RIFT VALLEY,23595
SOTIK,Rural,62,174,183,357,Bomet,RIFT VALLEY,23596
SOTIK,Rural,63,176,173,349,Bomet,RIFT VALLEY,23597
SOTIK,Rural,64,172,215,387,Bomet,RIFT VALLEY,23598
SOTIK,Rural,65,198,247,445,Bomet,RIFT VALLEY,23599
SOTIK,Rural,66,93,104,197,Bomet,RIFT VALLEY,23600
SOTIK,Rural,67,150,170,320,Bomet,RIFT VALLEY,23601
SOTIK,Rural,68,112,122,234,Bomet,RIFT VALLEY,23602
SOTIK,Rural,69,127,212,339,Bomet,RIFT VALLEY,23603
SOTIK,Rural,70,224,305,529,Bomet,RIFT VALLEY,23604
SOTIK,Rural,71,86,122,208,Bomet,RIFT VALLEY,23605
SOTIK,Rural,72,118,105,223,Bomet,RIFT VALLEY,23606
SOTIK,Rural,73,98,84,182,Bomet,RIFT VALLEY,23607
SOTIK,Rural,74,109,127,236,Bomet,RIFT VALLEY,23608
SOTIK,Rural,75,122,166,288,Bomet,RIFT VALLEY,23609
SOTIK,Rural,76,78,54,132,Bomet,RIFT VALLEY,23610
SOTIK,Rural,77,82,67,149,Bomet,RIFT VALLEY,23611
SOTIK,Rural,78,70,100,170,Bomet,RIFT VALLEY,23612
SOTIK,Rural,79,92,148,240,Bomet,RIFT VALLEY,23613
SOTIK,Rural,80+,780,1123,1903,Bomet,RIFT VALLEY,23614
SOTIK,Rural,Age NS,30,33,63,Bomet,RIFT VALLEY,23615
BOMET,Rural,0,5805,5348,11153,Bomet,RIFT VALLEY,23616
BOMET,Rural,1,4820,4544,9364,Bomet,RIFT VALLEY,23617
BOMET,Rural,2,5277,5064,10341,Bomet,RIFT VALLEY,23618
BOMET,Rural,3,5156,5075,10231,Bomet,RIFT VALLEY,23619
BOMET,Rural,4,5425,5141,10566,Bomet,RIFT VALLEY,23620
BOMET,Rural,5,5404,5187,10591,Bomet,RIFT VALLEY,23621
BOMET,Rural,6,5086,4963,10049,Bomet,RIFT VALLEY,23622
BOMET,Rural,7,4740,4679,9419,Bomet,RIFT VALLEY,23623
BOMET,Rural,8,4542,4460,9002,Bomet,RIFT VALLEY,23624
BOMET,Rural,9,4992,4787,9779,Bomet,RIFT VALLEY,23625
BOMET,Rural,10,4655,4515,9170,Bomet,RIFT VALLEY,23626
BOMET,Rural,11,3853,3923,7776,Bomet,RIFT VALLEY,23627
BOMET,Rural,12,4539,4564,9103,Bomet,RIFT VALLEY,23628
BOMET,Rural,13,4352,4427,8779,Bomet,RIFT VALLEY,23629
BOMET,Rural,14,4124,4090,8214,Bomet,RIFT VALLEY,23630
BOMET,Rural,15,3772,3714,7486,Bomet,RIFT VALLEY,23631
BOMET,Rural,16,3720,3552,7272,Bomet,RIFT VALLEY,23632
BOMET,Rural,17,3615,3445,7060,Bomet,RIFT VALLEY,23633
BOMET,Rural,18,3414,3358,6772,Bomet,RIFT VALLEY,23634
BOMET,Rural,19,2964,3188,6152,Bomet,RIFT VALLEY,23635
BOMET,Rural,20,3200,4117,7317,Bomet,RIFT VALLEY,23636
BOMET,Rural,21,2476,2895,5371,Bomet,RIFT VALLEY,23637
BOMET,Rural,22,2557,3323,5880,Bomet,RIFT VALLEY,23638
BOMET,Rural,23,2387,2901,5288,Bomet,RIFT VALLEY,23639
BOMET,Rural,24,2124,2683,4807,Bomet,RIFT VALLEY,23640
BOMET,Rural,25,2619,3170,5789,Bomet,RIFT VALLEY,23641
BOMET,Rural,26,1818,2047,3865,Bomet,RIFT VALLEY,23642
BOMET,Rural,27,2003,2182,4185,Bomet,RIFT VALLEY,23643
BOMET,Rural,28,1502,1645,3147,Bomet,RIFT VALLEY,23644
BOMET,Rural,29,1636,1721,3357,Bomet,RIFT VALLEY,23645
BOMET,Rural,30,2121,2483,4604,Bomet,RIFT VALLEY,23646
BOMET,Rural,31,1660,1752,3412,Bomet,RIFT VALLEY,23647
BOMET,Rural,32,1408,1620,3028,Bomet,RIFT VALLEY,23648
BOMET,Rural,33,1316,1336,2652,Bomet,RIFT VALLEY,23649
BOMET,Rural,34,1290,1372,2662,Bomet,RIFT VALLEY,23650
BOMET,Rural,35,2014,1871,3885,Bomet,RIFT VALLEY,23651
BOMET,Rural,36,1106,1225,2331,Bomet,RIFT VALLEY,23652
BOMET,Rural,37,1313,1419,2732,Bomet,RIFT VALLEY,23653
BOMET,Rural,38,845,884,1729,Bomet,RIFT VALLEY,23654
BOMET,Rural,39,1002,1158,2160,Bomet,RIFT VALLEY,23655
BOMET,Rural,40,1319,1449,2768,Bomet,RIFT VALLEY,23656
BOMET,Rural,41,931,982,1913,Bomet,RIFT VALLEY,23657
BOMET,Rural,42,673,699,1372,Bomet,RIFT VALLEY,23658
BOMET,Rural,43,521,584,1105,Bomet,RIFT VALLEY,23659
BOMET,Rural,44,598,649,1247,Bomet,RIFT VALLEY,23660
BOMET,Rural,45,827,1032,1859,Bomet,RIFT VALLEY,23661
BOMET,Rural,46,611,745,1356,Bomet,RIFT VALLEY,23662
BOMET,Rural,47,667,790,1457,Bomet,RIFT VALLEY,23663
BOMET,Rural,48,1033,1397,2430,Bomet,RIFT VALLEY,23664
BOMET,Rural,49,651,725,1376,Bomet,RIFT VALLEY,23665
BOMET,Rural,50,805,1102,1907,Bomet,RIFT VALLEY,23666
BOMET,Rural,51,622,598,1220,Bomet,RIFT VALLEY,23667
BOMET,Rural,52,493,606,1099,Bomet,RIFT VALLEY,23668
BOMET,Rural,53,506,528,1034,Bomet,RIFT VALLEY,23669
BOMET,Rural,54,386,503,889,Bomet,RIFT VALLEY,23670
BOMET,Rural,55,645,679,1324,Bomet,RIFT VALLEY,23671
BOMET,Rural,56,433,379,812,Bomet,RIFT VALLEY,23672
BOMET,Rural,57,616,613,1229,Bomet,RIFT VALLEY,23673
BOMET,Rural,58,235,329,564,Bomet,RIFT VALLEY,23674
BOMET,Rural,59,414,506,920,Bomet,RIFT VALLEY,23675
BOMET,Rural,60,538,715,1253,Bomet,RIFT VALLEY,23676
BOMET,Rural,61,499,399,898,Bomet,RIFT VALLEY,23677
BOMET,Rural,62,285,267,552,Bomet,RIFT VALLEY,23678
BOMET,Rural,63,291,333,624,Bomet,RIFT VALLEY,23679
BOMET,Rural,64,281,413,694,Bomet,RIFT VALLEY,23680
BOMET,Rural,65,317,426,743,Bomet,RIFT VALLEY,23681
BOMET,Rural,66,190,197,387,Bomet,RIFT VALLEY,23682
BOMET,Rural,67,293,303,596,Bomet,RIFT VALLEY,23683
BOMET,Rural,68,157,206,363,Bomet,RIFT VALLEY,23684
BOMET,Rural,69,198,377,575,Bomet,RIFT VALLEY,23685
BOMET,Rural,70,369,556,925,Bomet,RIFT VALLEY,23686
BOMET,Rural,71,144,219,363,Bomet,RIFT VALLEY,23687
BOMET,Rural,72,183,176,359,Bomet,RIFT VALLEY,23688
BOMET,Rural,73,150,160,310,Bomet,RIFT VALLEY,23689
BOMET,Rural,74,183,203,386,Bomet,RIFT VALLEY,23690
BOMET,Rural,75,167,260,427,Bomet,RIFT VALLEY,23691
BOMET,Rural,76,117,135,252,Bomet,RIFT VALLEY,23692
BOMET,Rural,77,145,134,279,Bomet,RIFT VALLEY,23693
BOMET,Rural,78,152,147,299,Bomet,RIFT VALLEY,23694
BOMET,Rural,79,178,331,509,Bomet,RIFT VALLEY,23695
BOMET,Rural,80+,1376,1914,3290,Bomet,RIFT VALLEY,23696
BOMET,Rural,Age NS,74,78,152,Bomet,RIFT VALLEY,23697
KAJIADO NORTH,Rural,0,2625,2530,5155,Kajiado,RIFT VALLEY,23698
KAJIADO NORTH,Rural,1,2044,2010,4054,Kajiado,RIFT VALLEY,23699
KAJIADO NORTH,Rural,2,2491,2513,5004,Kajiado,RIFT VALLEY,23700
KAJIADO NORTH,Rural,3,2469,2455,4924,Kajiado,RIFT VALLEY,23701
KAJIADO NORTH,Rural,4,2517,2445,4962,Kajiado,RIFT VALLEY,23702
KAJIADO NORTH,Rural,5,2415,2279,4694,Kajiado,RIFT VALLEY,23703
KAJIADO NORTH,Rural,6,2310,2304,4614,Kajiado,RIFT VALLEY,23704
KAJIADO NORTH,Rural,7,2193,2122,4315,Kajiado,RIFT VALLEY,23705
KAJIADO NORTH,Rural,8,2102,2104,4206,Kajiado,RIFT VALLEY,23706
KAJIADO NORTH,Rural,9,2088,2029,4117,Kajiado,RIFT VALLEY,23707
KAJIADO NORTH,Rural,10,2457,2418,4875,Kajiado,RIFT VALLEY,23708
KAJIADO NORTH,Rural,11,1543,1642,3185,Kajiado,RIFT VALLEY,23709
KAJIADO NORTH,Rural,12,2163,1945,4108,Kajiado,RIFT VALLEY,23710
KAJIADO NORTH,Rural,13,1721,1709,3430,Kajiado,RIFT VALLEY,23711
KAJIADO NORTH,Rural,14,1723,1656,3379,Kajiado,RIFT VALLEY,23712
KAJIADO NORTH,Rural,15,1776,1569,3345,Kajiado,RIFT VALLEY,23713
KAJIADO NORTH,Rural,16,1565,1549,3114,Kajiado,RIFT VALLEY,23714
KAJIADO NORTH,Rural,17,1610,1397,3007,Kajiado,RIFT VALLEY,23715
KAJIADO NORTH,Rural,18,1758,1714,3472,Kajiado,RIFT VALLEY,23716
KAJIADO NORTH,Rural,19,1355,1376,2731,Kajiado,RIFT VALLEY,23717
KAJIADO NORTH,Rural,20,1935,2161,4096,Kajiado,RIFT VALLEY,23718
KAJIADO NORTH,Rural,21,1269,1367,2636,Kajiado,RIFT VALLEY,23719
KAJIADO NORTH,Rural,22,1465,1759,3224,Kajiado,RIFT VALLEY,23720
KAJIADO NORTH,Rural,23,1331,1463,2794,Kajiado,RIFT VALLEY,23721
KAJIADO NORTH,Rural,24,1425,1470,2895,Kajiado,RIFT VALLEY,23722
KAJIADO NORTH,Rural,25,1828,1809,3637,Kajiado,RIFT VALLEY,23723
KAJIADO NORTH,Rural,26,1272,1229,2501,Kajiado,RIFT VALLEY,23724
KAJIADO NORTH,Rural,27,1212,1139,2351,Kajiado,RIFT VALLEY,23725
KAJIADO NORTH,Rural,28,1332,1250,2582,Kajiado,RIFT VALLEY,23726
KAJIADO NORTH,Rural,29,984,900,1884,Kajiado,RIFT VALLEY,23727
KAJIADO NORTH,Rural,30,1693,1739,3432,Kajiado,RIFT VALLEY,23728
KAJIADO NORTH,Rural,31,784,660,1444,Kajiado,RIFT VALLEY,23729
KAJIADO NORTH,Rural,32,1134,1067,2201,Kajiado,RIFT VALLEY,23730
KAJIADO NORTH,Rural,33,660,552,1212,Kajiado,RIFT VALLEY,23731
KAJIADO NORTH,Rural,34,743,675,1418,Kajiado,RIFT VALLEY,23732
KAJIADO NORTH,Rural,35,1511,1358,2869,Kajiado,RIFT VALLEY,23733
KAJIADO NORTH,Rural,36,781,728,1509,Kajiado,RIFT VALLEY,23734
KAJIADO NORTH,Rural,37,755,645,1400,Kajiado,RIFT VALLEY,23735
KAJIADO NORTH,Rural,38,794,787,1581,Kajiado,RIFT VALLEY,23736
KAJIADO NORTH,Rural,39,612,575,1187,Kajiado,RIFT VALLEY,23737
KAJIADO NORTH,Rural,40,1285,1226,2511,Kajiado,RIFT VALLEY,23738
KAJIADO NORTH,Rural,41,537,460,997,Kajiado,RIFT VALLEY,23739
KAJIADO NORTH,Rural,42,667,580,1247,Kajiado,RIFT VALLEY,23740
KAJIADO NORTH,Rural,43,466,377,843,Kajiado,RIFT VALLEY,23741
KAJIADO NORTH,Rural,44,403,343,746,Kajiado,RIFT VALLEY,23742
KAJIADO NORTH,Rural,45,825,783,1608,Kajiado,RIFT VALLEY,23743
KAJIADO NORTH,Rural,46,484,398,882,Kajiado,RIFT VALLEY,23744
KAJIADO NORTH,Rural,47,405,324,729,Kajiado,RIFT VALLEY,23745
KAJIADO NORTH,Rural,48,442,412,854,Kajiado,RIFT VALLEY,23746
KAJIADO NORTH,Rural,49,372,333,705,Kajiado,RIFT VALLEY,23747
KAJIADO NORTH,Rural,50,707,685,1392,Kajiado,RIFT VALLEY,23748
KAJIADO NORTH,Rural,51,235,185,420,Kajiado,RIFT VALLEY,23749
KAJIADO NORTH,Rural,52,303,274,577,Kajiado,RIFT VALLEY,23750
KAJIADO NORTH,Rural,53,204,194,398,Kajiado,RIFT VALLEY,23751
KAJIADO NORTH,Rural,54,272,218,490,Kajiado,RIFT VALLEY,23752
KAJIADO NORTH,Rural,55,415,384,799,Kajiado,RIFT VALLEY,23753
KAJIADO NORTH,Rural,56,244,201,445,Kajiado,RIFT VALLEY,23754
KAJIADO NORTH,Rural,57,233,174,407,Kajiado,RIFT VALLEY,23755
KAJIADO NORTH,Rural,58,204,160,364,Kajiado,RIFT VALLEY,23756
KAJIADO NORTH,Rural,59,183,136,319,Kajiado,RIFT VALLEY,23757
KAJIADO NORTH,Rural,60,428,501,929,Kajiado,RIFT VALLEY,23758
KAJIADO NORTH,Rural,61,159,137,296,Kajiado,RIFT VALLEY,23759
KAJIADO NORTH,Rural,62,178,151,329,Kajiado,RIFT VALLEY,23760
KAJIADO NORTH,Rural,63,142,104,246,Kajiado,RIFT VALLEY,23761
KAJIADO NORTH,Rural,64,141,127,268,Kajiado,RIFT VALLEY,23762
KAJIADO NORTH,Rural,65,236,272,508,Kajiado,RIFT VALLEY,23763
KAJIADO NORTH,Rural,66,100,103,203,Kajiado,RIFT VALLEY,23764
KAJIADO NORTH,Rural,67,99,94,193,Kajiado,RIFT VALLEY,23765
KAJIADO NORTH,Rural,68,103,86,189,Kajiado,RIFT VALLEY,23766
KAJIADO NORTH,Rural,69,99,100,199,Kajiado,RIFT VALLEY,23767
KAJIADO NORTH,Rural,70,272,309,581,Kajiado,RIFT VALLEY,23768
KAJIADO NORTH,Rural,71,73,46,119,Kajiado,RIFT VALLEY,23769
KAJIADO NORTH,Rural,72,70,74,144,Kajiado,RIFT VALLEY,23770
KAJIADO NORTH,Rural,73,50,54,104,Kajiado,RIFT VALLEY,23771
KAJIADO NORTH,Rural,74,58,72,130,Kajiado,RIFT VALLEY,23772
KAJIADO NORTH,Rural,75,124,125,249,Kajiado,RIFT VALLEY,23773
KAJIADO NORTH,Rural,76,48,53,101,Kajiado,RIFT VALLEY,23774
KAJIADO NORTH,Rural,77,35,43,78,Kajiado,RIFT VALLEY,23775
KAJIADO NORTH,Rural,78,44,50,94,Kajiado,RIFT VALLEY,23776
KAJIADO NORTH,Rural,79,38,45,83,Kajiado,RIFT VALLEY,23777
KAJIADO NORTH,Rural,80+,521,761,1282,Kajiado,RIFT VALLEY,23778
KAJIADO NORTH,Rural,Age NS,38,36,74,Kajiado,RIFT VALLEY,23779
KAKAMEGA CENTRAL,Rural,0,3758,3941,7699,Kakamega,WESTERN,23780
KAKAMEGA CENTRAL,Rural,1,3677,3636,7313,Kakamega,WESTERN,23781
KAKAMEGA CENTRAL,Rural,2,4062,4105,8167,Kakamega,WESTERN,23782
KAKAMEGA CENTRAL,Rural,3,3868,4000,7868,Kakamega,WESTERN,23783
KAKAMEGA CENTRAL,Rural,4,3665,3665,7330,Kakamega,WESTERN,23784
KAKAMEGA CENTRAL,Rural,5,3776,3773,7549,Kakamega,WESTERN,23785
KAKAMEGA CENTRAL,Rural,6,3368,3410,6778,Kakamega,WESTERN,23786
KAKAMEGA CENTRAL,Rural,7,3055,3200,6255,Kakamega,WESTERN,23787
KAKAMEGA CENTRAL,Rural,8,3110,3180,6290,Kakamega,WESTERN,23788
KAKAMEGA CENTRAL,Rural,9,3075,3174,6249,Kakamega,WESTERN,23789
KAKAMEGA CENTRAL,Rural,10,3099,3083,6182,Kakamega,WESTERN,23790
KAKAMEGA CENTRAL,Rural,11,2525,2586,5111,Kakamega,WESTERN,23791
KAKAMEGA CENTRAL,Rural,12,2825,2767,5592,Kakamega,WESTERN,23792
KAKAMEGA CENTRAL,Rural,13,2650,2760,5410,Kakamega,WESTERN,23793
KAKAMEGA CENTRAL,Rural,14,2474,2415,4889,Kakamega,WESTERN,23794
KAKAMEGA CENTRAL,Rural,15,2495,2514,5009,Kakamega,WESTERN,23795
KAKAMEGA CENTRAL,Rural,16,2279,2326,4605,Kakamega,WESTERN,23796
KAKAMEGA CENTRAL,Rural,17,2357,2282,4639,Kakamega,WESTERN,23797
KAKAMEGA CENTRAL,Rural,18,2143,2148,4291,Kakamega,WESTERN,23798
KAKAMEGA CENTRAL,Rural,19,1883,2026,3909,Kakamega,WESTERN,23799
KAKAMEGA CENTRAL,Rural,20,2076,2374,4450,Kakamega,WESTERN,23800
KAKAMEGA CENTRAL,Rural,21,1565,1861,3426,Kakamega,WESTERN,23801
KAKAMEGA CENTRAL,Rural,22,1602,2085,3687,Kakamega,WESTERN,23802
KAKAMEGA CENTRAL,Rural,23,1533,1907,3440,Kakamega,WESTERN,23803
KAKAMEGA CENTRAL,Rural,24,1411,1716,3127,Kakamega,WESTERN,23804
KAKAMEGA CENTRAL,Rural,25,1442,1899,3341,Kakamega,WESTERN,23805
KAKAMEGA CENTRAL,Rural,26,1219,1452,2671,Kakamega,WESTERN,23806
KAKAMEGA CENTRAL,Rural,27,1244,1339,2583,Kakamega,WESTERN,23807
KAKAMEGA CENTRAL,Rural,28,1049,1274,2323,Kakamega,WESTERN,23808
KAKAMEGA CENTRAL,Rural,29,1030,1140,2170,Kakamega,WESTERN,23809
KAKAMEGA CENTRAL,Rural,30,1298,1592,2890,Kakamega,WESTERN,23810
KAKAMEGA CENTRAL,Rural,31,918,1036,1954,Kakamega,WESTERN,23811
KAKAMEGA CENTRAL,Rural,32,1059,1230,2289,Kakamega,WESTERN,23812
KAKAMEGA CENTRAL,Rural,33,922,1000,1922,Kakamega,WESTERN,23813
KAKAMEGA CENTRAL,Rural,34,913,972,1885,Kakamega,WESTERN,23814
KAKAMEGA CENTRAL,Rural,35,1012,1264,2276,Kakamega,WESTERN,23815
KAKAMEGA CENTRAL,Rural,36,735,929,1664,Kakamega,WESTERN,23816
KAKAMEGA CENTRAL,Rural,37,792,782,1574,Kakamega,WESTERN,23817
KAKAMEGA CENTRAL,Rural,38,725,771,1496,Kakamega,WESTERN,23818
KAKAMEGA CENTRAL,Rural,39,719,753,1472,Kakamega,WESTERN,23819
KAKAMEGA CENTRAL,Rural,40,872,1119,1991,Kakamega,WESTERN,23820
KAKAMEGA CENTRAL,Rural,41,603,680,1283,Kakamega,WESTERN,23821
KAKAMEGA CENTRAL,Rural,42,520,733,1253,Kakamega,WESTERN,23822
KAKAMEGA CENTRAL,Rural,43,566,638,1204,Kakamega,WESTERN,23823
KAKAMEGA CENTRAL,Rural,44,499,623,1122,Kakamega,WESTERN,23824
KAKAMEGA CENTRAL,Rural,45,722,868,1590,Kakamega,WESTERN,23825
KAKAMEGA CENTRAL,Rural,46,556,657,1213,Kakamega,WESTERN,23826
KAKAMEGA CENTRAL,Rural,47,537,649,1186,Kakamega,WESTERN,23827
KAKAMEGA CENTRAL,Rural,48,490,564,1054,Kakamega,WESTERN,23828
KAKAMEGA CENTRAL,Rural,49,484,619,1103,Kakamega,WESTERN,23829
KAKAMEGA CENTRAL,Rural,50,610,805,1415,Kakamega,WESTERN,23830
KAKAMEGA CENTRAL,Rural,51,468,480,948,Kakamega,WESTERN,23831
KAKAMEGA CENTRAL,Rural,52,468,494,962,Kakamega,WESTERN,23832
KAKAMEGA CENTRAL,Rural,53,441,498,939,Kakamega,WESTERN,23833
KAKAMEGA CENTRAL,Rural,54,406,482,888,Kakamega,WESTERN,23834
KAKAMEGA CENTRAL,Rural,55,515,535,1050,Kakamega,WESTERN,23835
KAKAMEGA CENTRAL,Rural,56,393,443,836,Kakamega,WESTERN,23836
KAKAMEGA CENTRAL,Rural,57,356,421,777,Kakamega,WESTERN,23837
KAKAMEGA CENTRAL,Rural,58,255,272,527,Kakamega,WESTERN,23838
KAKAMEGA CENTRAL,Rural,59,344,380,724,Kakamega,WESTERN,23839
KAKAMEGA CENTRAL,Rural,60,398,493,891,Kakamega,WESTERN,23840
KAKAMEGA CENTRAL,Rural,61,284,286,570,Kakamega,WESTERN,23841
KAKAMEGA CENTRAL,Rural,62,250,262,512,Kakamega,WESTERN,23842
KAKAMEGA CENTRAL,Rural,63,280,252,532,Kakamega,WESTERN,23843
KAKAMEGA CENTRAL,Rural,64,228,257,485,Kakamega,WESTERN,23844
KAKAMEGA CENTRAL,Rural,65,266,322,588,Kakamega,WESTERN,23845
KAKAMEGA CENTRAL,Rural,66,216,290,506,Kakamega,WESTERN,23846
KAKAMEGA CENTRAL,Rural,67,216,240,456,Kakamega,WESTERN,23847
KAKAMEGA CENTRAL,Rural,68,161,182,343,Kakamega,WESTERN,23848
KAKAMEGA CENTRAL,Rural,69,170,171,341,Kakamega,WESTERN,23849
KAKAMEGA CENTRAL,Rural,70,195,290,485,Kakamega,WESTERN,23850
KAKAMEGA CENTRAL,Rural,71,143,149,292,Kakamega,WESTERN,23851
KAKAMEGA CENTRAL,Rural,72,141,145,286,Kakamega,WESTERN,23852
KAKAMEGA CENTRAL,Rural,73,173,177,350,Kakamega,WESTERN,23853
KAKAMEGA CENTRAL,Rural,74,123,130,253,Kakamega,WESTERN,23854
KAKAMEGA CENTRAL,Rural,75,119,144,263,Kakamega,WESTERN,23855
KAKAMEGA CENTRAL,Rural,76,110,145,255,Kakamega,WESTERN,23856
KAKAMEGA CENTRAL,Rural,77,121,136,257,Kakamega,WESTERN,23857
KAKAMEGA CENTRAL,Rural,78,80,116,196,Kakamega,WESTERN,23858
KAKAMEGA CENTRAL,Rural,79,86,115,201,Kakamega,WESTERN,23859
KAKAMEGA CENTRAL,Rural,80+,669,791,1460,Kakamega,WESTERN,23860
KAKAMEGA CENTRAL,Rural,Age NS,81,70,151,Kakamega,WESTERN,23861
KAKAMEGA SOUTH,Rural,0,1686,1679,3365,Kakamega,WESTERN,23862
KAKAMEGA SOUTH,Rural,1,1526,1566,3092,Kakamega,WESTERN,23863
KAKAMEGA SOUTH,Rural,2,1735,1770,3505,Kakamega,WESTERN,23864
KAKAMEGA SOUTH,Rural,3,1669,1756,3425,Kakamega,WESTERN,23865
KAKAMEGA SOUTH,Rural,4,1728,1614,3342,Kakamega,WESTERN,23866
KAKAMEGA SOUTH,Rural,5,1655,1636,3291,Kakamega,WESTERN,23867
KAKAMEGA SOUTH,Rural,6,1490,1664,3154,Kakamega,WESTERN,23868
KAKAMEGA SOUTH,Rural,7,1585,1568,3153,Kakamega,WESTERN,23869
KAKAMEGA SOUTH,Rural,8,1464,1489,2953,Kakamega,WESTERN,23870
KAKAMEGA SOUTH,Rural,9,1621,1601,3222,Kakamega,WESTERN,23871
KAKAMEGA SOUTH,Rural,10,1600,1635,3235,Kakamega,WESTERN,23872
KAKAMEGA SOUTH,Rural,11,1268,1302,2570,Kakamega,WESTERN,23873
KAKAMEGA SOUTH,Rural,12,1467,1549,3016,Kakamega,WESTERN,23874
KAKAMEGA SOUTH,Rural,13,1474,1532,3006,Kakamega,WESTERN,23875
KAKAMEGA SOUTH,Rural,14,1321,1337,2658,Kakamega,WESTERN,23876
KAKAMEGA SOUTH,Rural,15,1466,1394,2860,Kakamega,WESTERN,23877
KAKAMEGA SOUTH,Rural,16,1192,1261,2453,Kakamega,WESTERN,23878
KAKAMEGA SOUTH,Rural,17,1308,1334,2642,Kakamega,WESTERN,23879
KAKAMEGA SOUTH,Rural,18,1227,1175,2402,Kakamega,WESTERN,23880
KAKAMEGA SOUTH,Rural,19,1027,998,2025,Kakamega,WESTERN,23881
KAKAMEGA SOUTH,Rural,20,1034,1143,2177,Kakamega,WESTERN,23882
KAKAMEGA SOUTH,Rural,21,716,876,1592,Kakamega,WESTERN,23883
KAKAMEGA SOUTH,Rural,22,739,936,1675,Kakamega,WESTERN,23884
KAKAMEGA SOUTH,Rural,23,655,832,1487,Kakamega,WESTERN,23885
KAKAMEGA SOUTH,Rural,24,619,810,1429,Kakamega,WESTERN,23886
KAKAMEGA SOUTH,Rural,25,616,875,1491,Kakamega,WESTERN,23887
KAKAMEGA SOUTH,Rural,26,502,667,1169,Kakamega,WESTERN,23888
KAKAMEGA SOUTH,Rural,27,559,680,1239,Kakamega,WESTERN,23889
KAKAMEGA SOUTH,Rural,28,424,612,1036,Kakamega,WESTERN,23890
KAKAMEGA SOUTH,Rural,29,488,611,1099,Kakamega,WESTERN,23891
KAKAMEGA SOUTH,Rural,30,592,872,1464,Kakamega,WESTERN,23892
KAKAMEGA SOUTH,Rural,31,403,463,866,Kakamega,WESTERN,23893
KAKAMEGA SOUTH,Rural,32,452,619,1071,Kakamega,WESTERN,23894
KAKAMEGA SOUTH,Rural,33,392,492,884,Kakamega,WESTERN,23895
KAKAMEGA SOUTH,Rural,34,407,483,890,Kakamega,WESTERN,23896
KAKAMEGA SOUTH,Rural,35,505,740,1245,Kakamega,WESTERN,23897
KAKAMEGA SOUTH,Rural,36,342,441,783,Kakamega,WESTERN,23898
KAKAMEGA SOUTH,Rural,37,357,446,803,Kakamega,WESTERN,23899
KAKAMEGA SOUTH,Rural,38,337,440,777,Kakamega,WESTERN,23900
KAKAMEGA SOUTH,Rural,39,335,456,791,Kakamega,WESTERN,23901
KAKAMEGA SOUTH,Rural,40,444,740,1184,Kakamega,WESTERN,23902
KAKAMEGA SOUTH,Rural,41,265,394,659,Kakamega,WESTERN,23903
KAKAMEGA SOUTH,Rural,42,317,413,730,Kakamega,WESTERN,23904
KAKAMEGA SOUTH,Rural,43,274,417,691,Kakamega,WESTERN,23905
KAKAMEGA SOUTH,Rural,44,239,314,553,Kakamega,WESTERN,23906
KAKAMEGA SOUTH,Rural,45,376,560,936,Kakamega,WESTERN,23907
KAKAMEGA SOUTH,Rural,46,302,414,716,Kakamega,WESTERN,23908
KAKAMEGA SOUTH,Rural,47,272,469,741,Kakamega,WESTERN,23909
KAKAMEGA SOUTH,Rural,48,238,375,613,Kakamega,WESTERN,23910
KAKAMEGA SOUTH,Rural,49,320,388,708,Kakamega,WESTERN,23911
KAKAMEGA SOUTH,Rural,50,383,552,935,Kakamega,WESTERN,23912
KAKAMEGA SOUTH,Rural,51,263,330,593,Kakamega,WESTERN,23913
KAKAMEGA SOUTH,Rural,52,287,336,623,Kakamega,WESTERN,23914
KAKAMEGA SOUTH,Rural,53,272,305,577,Kakamega,WESTERN,23915
KAKAMEGA SOUTH,Rural,54,291,288,579,Kakamega,WESTERN,23916
KAKAMEGA SOUTH,Rural,55,331,386,717,Kakamega,WESTERN,23917
KAKAMEGA SOUTH,Rural,56,253,313,566,Kakamega,WESTERN,23918
KAKAMEGA SOUTH,Rural,57,311,349,660,Kakamega,WESTERN,23919
KAKAMEGA SOUTH,Rural,58,174,186,360,Kakamega,WESTERN,23920
KAKAMEGA SOUTH,Rural,59,237,251,488,Kakamega,WESTERN,23921
KAKAMEGA SOUTH,Rural,60,260,361,621,Kakamega,WESTERN,23922
KAKAMEGA SOUTH,Rural,61,218,201,419,Kakamega,WESTERN,23923
KAKAMEGA SOUTH,Rural,62,179,176,355,Kakamega,WESTERN,23924
KAKAMEGA SOUTH,Rural,63,166,193,359,Kakamega,WESTERN,23925
KAKAMEGA SOUTH,Rural,64,168,218,386,Kakamega,WESTERN,23926
KAKAMEGA SOUTH,Rural,65,160,226,386,Kakamega,WESTERN,23927
KAKAMEGA SOUTH,Rural,66,197,319,516,Kakamega,WESTERN,23928
KAKAMEGA SOUTH,Rural,67,155,169,324,Kakamega,WESTERN,23929
KAKAMEGA SOUTH,Rural,68,91,107,198,Kakamega,WESTERN,23930
KAKAMEGA SOUTH,Rural,69,124,178,302,Kakamega,WESTERN,23931
KAKAMEGA SOUTH,Rural,70,193,285,478,Kakamega,WESTERN,23932
KAKAMEGA SOUTH,Rural,71,120,135,255,Kakamega,WESTERN,23933
KAKAMEGA SOUTH,Rural,72,132,121,253,Kakamega,WESTERN,23934
KAKAMEGA SOUTH,Rural,73,145,123,268,Kakamega,WESTERN,23935
KAKAMEGA SOUTH,Rural,74,79,97,176,Kakamega,WESTERN,23936
KAKAMEGA SOUTH,Rural,75,114,121,235,Kakamega,WESTERN,23937
KAKAMEGA SOUTH,Rural,76,98,110,208,Kakamega,WESTERN,23938
KAKAMEGA SOUTH,Rural,77,114,126,240,Kakamega,WESTERN,23939
KAKAMEGA SOUTH,Rural,78,65,78,143,Kakamega,WESTERN,23940
KAKAMEGA SOUTH,Rural,79,93,109,202,Kakamega,WESTERN,23941
KAKAMEGA SOUTH,Rural,80+,522,785,1307,Kakamega,WESTERN,23942
KAKAMEGA SOUTH,Rural,Age NS,35,37,72,Kakamega,WESTERN,23943
KAKAMEGA NORTH,Rural,0,3853,3746,7599,Kakamega,WESTERN,23944
KAKAMEGA NORTH,Rural,1,3589,3472,7061,Kakamega,WESTERN,23945
KAKAMEGA NORTH,Rural,2,3961,3948,7909,Kakamega,WESTERN,23946
KAKAMEGA NORTH,Rural,3,3935,3774,7709,Kakamega,WESTERN,23947
KAKAMEGA NORTH,Rural,4,3501,3539,7040,Kakamega,WESTERN,23948
KAKAMEGA NORTH,Rural,5,3629,3646,7275,Kakamega,WESTERN,23949
KAKAMEGA NORTH,Rural,6,3292,3294,6586,Kakamega,WESTERN,23950
KAKAMEGA NORTH,Rural,7,3120,3177,6297,Kakamega,WESTERN,23951
KAKAMEGA NORTH,Rural,8,3100,3146,6246,Kakamega,WESTERN,23952
KAKAMEGA NORTH,Rural,9,2987,2997,5984,Kakamega,WESTERN,23953
KAKAMEGA NORTH,Rural,10,3072,2973,6045,Kakamega,WESTERN,23954
KAKAMEGA NORTH,Rural,11,2478,2554,5032,Kakamega,WESTERN,23955
KAKAMEGA NORTH,Rural,12,2704,2686,5390,Kakamega,WESTERN,23956
KAKAMEGA NORTH,Rural,13,2532,2638,5170,Kakamega,WESTERN,23957
KAKAMEGA NORTH,Rural,14,2354,2426,4780,Kakamega,WESTERN,23958
KAKAMEGA NORTH,Rural,15,2368,2373,4741,Kakamega,WESTERN,23959
KAKAMEGA NORTH,Rural,16,2232,2328,4560,Kakamega,WESTERN,23960
KAKAMEGA NORTH,Rural,17,2213,2280,4493,Kakamega,WESTERN,23961
KAKAMEGA NORTH,Rural,18,2112,2032,4144,Kakamega,WESTERN,23962
KAKAMEGA NORTH,Rural,19,1961,2083,4044,Kakamega,WESTERN,23963
KAKAMEGA NORTH,Rural,20,1954,2300,4254,Kakamega,WESTERN,23964
KAKAMEGA NORTH,Rural,21,1618,1973,3591,Kakamega,WESTERN,23965
KAKAMEGA NORTH,Rural,22,1671,2072,3743,Kakamega,WESTERN,23966
KAKAMEGA NORTH,Rural,23,1580,1822,3402,Kakamega,WESTERN,23967
KAKAMEGA NORTH,Rural,24,1491,1703,3194,Kakamega,WESTERN,23968
KAKAMEGA NORTH,Rural,25,1492,1847,3339,Kakamega,WESTERN,23969
KAKAMEGA NORTH,Rural,26,1192,1469,2661,Kakamega,WESTERN,23970
KAKAMEGA NORTH,Rural,27,1241,1449,2690,Kakamega,WESTERN,23971
KAKAMEGA NORTH,Rural,28,985,1260,2245,Kakamega,WESTERN,23972
KAKAMEGA NORTH,Rural,29,1128,1241,2369,Kakamega,WESTERN,23973
KAKAMEGA NORTH,Rural,30,1227,1503,2730,Kakamega,WESTERN,23974
KAKAMEGA NORTH,Rural,31,991,1081,2072,Kakamega,WESTERN,23975
KAKAMEGA NORTH,Rural,32,1143,1216,2359,Kakamega,WESTERN,23976
KAKAMEGA NORTH,Rural,33,1014,1086,2100,Kakamega,WESTERN,23977
KAKAMEGA NORTH,Rural,34,1002,1068,2070,Kakamega,WESTERN,23978
KAKAMEGA NORTH,Rural,35,1048,1255,2303,Kakamega,WESTERN,23979
KAKAMEGA NORTH,Rural,36,929,870,1799,Kakamega,WESTERN,23980
KAKAMEGA NORTH,Rural,37,846,844,1690,Kakamega,WESTERN,23981
KAKAMEGA NORTH,Rural,38,724,713,1437,Kakamega,WESTERN,23982
KAKAMEGA NORTH,Rural,39,706,722,1428,Kakamega,WESTERN,23983
KAKAMEGA NORTH,Rural,40,835,981,1816,Kakamega,WESTERN,23984
KAKAMEGA NORTH,Rural,41,592,673,1265,Kakamega,WESTERN,23985
KAKAMEGA NORTH,Rural,42,578,656,1234,Kakamega,WESTERN,23986
KAKAMEGA NORTH,Rural,43,559,619,1178,Kakamega,WESTERN,23987
KAKAMEGA NORTH,Rural,44,517,597,1114,Kakamega,WESTERN,23988
KAKAMEGA NORTH,Rural,45,723,763,1486,Kakamega,WESTERN,23989
KAKAMEGA NORTH,Rural,46,557,641,1198,Kakamega,WESTERN,23990
KAKAMEGA NORTH,Rural,47,559,727,1286,Kakamega,WESTERN,23991
KAKAMEGA NORTH,Rural,48,498,496,994,Kakamega,WESTERN,23992
KAKAMEGA NORTH,Rural,49,641,658,1299,Kakamega,WESTERN,23993
KAKAMEGA NORTH,Rural,50,549,662,1211,Kakamega,WESTERN,23994
KAKAMEGA NORTH,Rural,51,472,574,1046,Kakamega,WESTERN,23995
KAKAMEGA NORTH,Rural,52,441,485,926,Kakamega,WESTERN,23996
KAKAMEGA NORTH,Rural,53,441,509,950,Kakamega,WESTERN,23997
KAKAMEGA NORTH,Rural,54,411,454,865,Kakamega,WESTERN,23998
KAKAMEGA NORTH,Rural,55,457,515,972,Kakamega,WESTERN,23999
KAKAMEGA NORTH,Rural,56,388,406,794,Kakamega,WESTERN,24000
KAKAMEGA NORTH,Rural,57,403,472,875,Kakamega,WESTERN,24001
KAKAMEGA NORTH,Rural,58,249,253,502,Kakamega,WESTERN,24002
KAKAMEGA NORTH,Rural,59,341,337,678,Kakamega,WESTERN,24003
KAKAMEGA NORTH,Rural,60,360,346,706,Kakamega,WESTERN,24004
KAKAMEGA NORTH,Rural,61,339,328,667,Kakamega,WESTERN,24005
KAKAMEGA NORTH,Rural,62,282,217,499,Kakamega,WESTERN,24006
KAKAMEGA NORTH,Rural,63,224,243,467,Kakamega,WESTERN,24007
KAKAMEGA NORTH,Rural,64,226,237,463,Kakamega,WESTERN,24008
KAKAMEGA NORTH,Rural,65,216,287,503,Kakamega,WESTERN,24009
KAKAMEGA NORTH,Rural,66,234,335,569,Kakamega,WESTERN,24010
KAKAMEGA NORTH,Rural,67,181,224,405,Kakamega,WESTERN,24011
KAKAMEGA NORTH,Rural,68,132,144,276,Kakamega,WESTERN,24012
KAKAMEGA NORTH,Rural,69,131,191,322,Kakamega,WESTERN,24013
KAKAMEGA NORTH,Rural,70,192,217,409,Kakamega,WESTERN,24014
KAKAMEGA NORTH,Rural,71,114,143,257,Kakamega,WESTERN,24015
KAKAMEGA NORTH,Rural,72,152,145,297,Kakamega,WESTERN,24016
KAKAMEGA NORTH,Rural,73,152,170,322,Kakamega,WESTERN,24017
KAKAMEGA NORTH,Rural,74,115,117,232,Kakamega,WESTERN,24018
KAKAMEGA NORTH,Rural,75,110,162,272,Kakamega,WESTERN,24019
KAKAMEGA NORTH,Rural,76,81,128,209,Kakamega,WESTERN,24020
KAKAMEGA NORTH,Rural,77,127,171,298,Kakamega,WESTERN,24021
KAKAMEGA NORTH,Rural,78,75,93,168,Kakamega,WESTERN,24022
KAKAMEGA NORTH,Rural,79,84,102,186,Kakamega,WESTERN,24023
KAKAMEGA NORTH,Rural,80+,604,810,1414,Kakamega,WESTERN,24024
KAKAMEGA NORTH,Rural,Age NS,34,31,65,Kakamega,WESTERN,24025
KAKAMEGA EAST,Rural,0,2627,2646,5273,Kakamega,WESTERN,24026
KAKAMEGA EAST,Rural,1,2322,2394,4716,Kakamega,WESTERN,24027
KAKAMEGA EAST,Rural,2,2688,2735,5423,Kakamega,WESTERN,24028
KAKAMEGA EAST,Rural,3,2532,2687,5219,Kakamega,WESTERN,24029
KAKAMEGA EAST,Rural,4,2524,2462,4986,Kakamega,WESTERN,24030
KAKAMEGA EAST,Rural,5,2583,2532,5115,Kakamega,WESTERN,24031
KAKAMEGA EAST,Rural,6,2383,2394,4777,Kakamega,WESTERN,24032
KAKAMEGA EAST,Rural,7,2359,2350,4709,Kakamega,WESTERN,24033
KAKAMEGA EAST,Rural,8,2109,2292,4401,Kakamega,WESTERN,24034
KAKAMEGA EAST,Rural,9,2365,2418,4783,Kakamega,WESTERN,24035
KAKAMEGA EAST,Rural,10,2407,2424,4831,Kakamega,WESTERN,24036
KAKAMEGA EAST,Rural,11,1890,1906,3796,Kakamega,WESTERN,24037
KAKAMEGA EAST,Rural,12,2302,2169,4471,Kakamega,WESTERN,24038
KAKAMEGA EAST,Rural,13,2117,2121,4238,Kakamega,WESTERN,24039
KAKAMEGA EAST,Rural,14,1925,1809,3734,Kakamega,WESTERN,24040
KAKAMEGA EAST,Rural,15,1981,1865,3846,Kakamega,WESTERN,24041
KAKAMEGA EAST,Rural,16,1777,1761,3538,Kakamega,WESTERN,24042
KAKAMEGA EAST,Rural,17,2146,1903,4049,Kakamega,WESTERN,24043
KAKAMEGA EAST,Rural,18,2028,1641,3669,Kakamega,WESTERN,24044
KAKAMEGA EAST,Rural,19,1558,1461,3019,Kakamega,WESTERN,24045
KAKAMEGA EAST,Rural,20,1526,1815,3341,Kakamega,WESTERN,24046
KAKAMEGA EAST,Rural,21,1165,1312,2477,Kakamega,WESTERN,24047
KAKAMEGA EAST,Rural,22,1196,1553,2749,Kakamega,WESTERN,24048
KAKAMEGA EAST,Rural,23,1099,1397,2496,Kakamega,WESTERN,24049
KAKAMEGA EAST,Rural,24,1033,1297,2330,Kakamega,WESTERN,24050
KAKAMEGA EAST,Rural,25,1142,1350,2492,Kakamega,WESTERN,24051
KAKAMEGA EAST,Rural,26,866,1075,1941,Kakamega,WESTERN,24052
KAKAMEGA EAST,Rural,27,964,1078,2042,Kakamega,WESTERN,24053
KAKAMEGA EAST,Rural,28,804,989,1793,Kakamega,WESTERN,24054
KAKAMEGA EAST,Rural,29,752,890,1642,Kakamega,WESTERN,24055
KAKAMEGA EAST,Rural,30,966,1341,2307,Kakamega,WESTERN,24056
KAKAMEGA EAST,Rural,31,699,784,1483,Kakamega,WESTERN,24057
KAKAMEGA EAST,Rural,32,790,931,1721,Kakamega,WESTERN,24058
KAKAMEGA EAST,Rural,33,709,776,1485,Kakamega,WESTERN,24059
KAKAMEGA EAST,Rural,34,677,714,1391,Kakamega,WESTERN,24060
KAKAMEGA EAST,Rural,35,833,1012,1845,Kakamega,WESTERN,24061
KAKAMEGA EAST,Rural,36,641,674,1315,Kakamega,WESTERN,24062
KAKAMEGA EAST,Rural,37,552,674,1226,Kakamega,WESTERN,24063
KAKAMEGA EAST,Rural,38,567,745,1312,Kakamega,WESTERN,24064
KAKAMEGA EAST,Rural,39,536,638,1174,Kakamega,WESTERN,24065
KAKAMEGA EAST,Rural,40,743,1053,1796,Kakamega,WESTERN,24066
KAKAMEGA EAST,Rural,41,490,533,1023,Kakamega,WESTERN,24067
KAKAMEGA EAST,Rural,42,501,598,1099,Kakamega,WESTERN,24068
KAKAMEGA EAST,Rural,43,440,583,1023,Kakamega,WESTERN,24069
KAKAMEGA EAST,Rural,44,369,521,890,Kakamega,WESTERN,24070
KAKAMEGA EAST,Rural,45,630,793,1423,Kakamega,WESTERN,24071
KAKAMEGA EAST,Rural,46,498,544,1042,Kakamega,WESTERN,24072
KAKAMEGA EAST,Rural,47,452,585,1037,Kakamega,WESTERN,24073
KAKAMEGA EAST,Rural,48,419,474,893,Kakamega,WESTERN,24074
KAKAMEGA EAST,Rural,49,451,530,981,Kakamega,WESTERN,24075
KAKAMEGA EAST,Rural,50,537,822,1359,Kakamega,WESTERN,24076
KAKAMEGA EAST,Rural,51,392,430,822,Kakamega,WESTERN,24077
KAKAMEGA EAST,Rural,52,431,484,915,Kakamega,WESTERN,24078
KAKAMEGA EAST,Rural,53,346,438,784,Kakamega,WESTERN,24079
KAKAMEGA EAST,Rural,54,351,454,805,Kakamega,WESTERN,24080
KAKAMEGA EAST,Rural,55,416,507,923,Kakamega,WESTERN,24081
KAKAMEGA EAST,Rural,56,342,437,779,Kakamega,WESTERN,24082
KAKAMEGA EAST,Rural,57,393,441,834,Kakamega,WESTERN,24083
KAKAMEGA EAST,Rural,58,267,243,510,Kakamega,WESTERN,24084
KAKAMEGA EAST,Rural,59,306,360,666,Kakamega,WESTERN,24085
KAKAMEGA EAST,Rural,60,408,459,867,Kakamega,WESTERN,24086
KAKAMEGA EAST,Rural,61,312,298,610,Kakamega,WESTERN,24087
KAKAMEGA EAST,Rural,62,273,223,496,Kakamega,WESTERN,24088
KAKAMEGA EAST,Rural,63,235,256,491,Kakamega,WESTERN,24089
KAKAMEGA EAST,Rural,64,242,272,514,Kakamega,WESTERN,24090
KAKAMEGA EAST,Rural,65,203,306,509,Kakamega,WESTERN,24091
KAKAMEGA EAST,Rural,66,245,381,626,Kakamega,WESTERN,24092
KAKAMEGA EAST,Rural,67,215,243,458,Kakamega,WESTERN,24093
KAKAMEGA EAST,Rural,68,151,166,317,Kakamega,WESTERN,24094
KAKAMEGA EAST,Rural,69,161,195,356,Kakamega,WESTERN,24095
KAKAMEGA EAST,Rural,70,238,318,556,Kakamega,WESTERN,24096
KAKAMEGA EAST,Rural,71,144,144,288,Kakamega,WESTERN,24097
KAKAMEGA EAST,Rural,72,158,179,337,Kakamega,WESTERN,24098
KAKAMEGA EAST,Rural,73,160,181,341,Kakamega,WESTERN,24099
KAKAMEGA EAST,Rural,74,132,135,267,Kakamega,WESTERN,24100
KAKAMEGA EAST,Rural,75,136,167,303,Kakamega,WESTERN,24101
KAKAMEGA EAST,Rural,76,124,137,261,Kakamega,WESTERN,24102
KAKAMEGA EAST,Rural,77,149,135,284,Kakamega,WESTERN,24103
KAKAMEGA EAST,Rural,78,90,117,207,Kakamega,WESTERN,24104
KAKAMEGA EAST,Rural,79,84,114,198,Kakamega,WESTERN,24105
KAKAMEGA EAST,Rural,80+,842,1126,1968,Kakamega,WESTERN,24106
KAKAMEGA EAST,Rural,Age NS,83,79,162,Kakamega,WESTERN,24107
LUGARI,Rural,0,5000,4846,9846,Kakamega,WESTERN,24108
LUGARI,Rural,1,4340,4226,8566,Kakamega,WESTERN,24109
LUGARI,Rural,2,4743,4830,9573,Kakamega,WESTERN,24110
LUGARI,Rural,3,4681,4803,9484,Kakamega,WESTERN,24111
LUGARI,Rural,4,4598,4652,9250,Kakamega,WESTERN,24112
LUGARI,Rural,5,4762,4712,9474,Kakamega,WESTERN,24113
LUGARI,Rural,6,4443,4496,8939,Kakamega,WESTERN,24114
LUGARI,Rural,7,4439,4445,8884,Kakamega,WESTERN,24115
LUGARI,Rural,8,4117,4210,8327,Kakamega,WESTERN,24116
LUGARI,Rural,9,4567,4495,9062,Kakamega,WESTERN,24117
LUGARI,Rural,10,4409,4388,8797,Kakamega,WESTERN,24118
LUGARI,Rural,11,3394,3547,6941,Kakamega,WESTERN,24119
LUGARI,Rural,12,4180,4091,8271,Kakamega,WESTERN,24120
LUGARI,Rural,13,3881,3843,7724,Kakamega,WESTERN,24121
LUGARI,Rural,14,3494,3351,6845,Kakamega,WESTERN,24122
LUGARI,Rural,15,3367,3339,6706,Kakamega,WESTERN,24123
LUGARI,Rural,16,3130,3134,6264,Kakamega,WESTERN,24124
LUGARI,Rural,17,3322,3063,6385,Kakamega,WESTERN,24125
LUGARI,Rural,18,3130,2755,5885,Kakamega,WESTERN,24126
LUGARI,Rural,19,2730,2629,5359,Kakamega,WESTERN,24127
LUGARI,Rural,20,2638,3084,5722,Kakamega,WESTERN,24128
LUGARI,Rural,21,2063,2280,4343,Kakamega,WESTERN,24129
LUGARI,Rural,22,2307,2681,4988,Kakamega,WESTERN,24130
LUGARI,Rural,23,1998,2404,4402,Kakamega,WESTERN,24131
LUGARI,Rural,24,1799,2142,3941,Kakamega,WESTERN,24132
LUGARI,Rural,25,2011,2454,4465,Kakamega,WESTERN,24133
LUGARI,Rural,26,1545,1857,3402,Kakamega,WESTERN,24134
LUGARI,Rural,27,1660,1901,3561,Kakamega,WESTERN,24135
LUGARI,Rural,28,1345,1722,3067,Kakamega,WESTERN,24136
LUGARI,Rural,29,1314,1569,2883,Kakamega,WESTERN,24137
LUGARI,Rural,30,1783,2320,4103,Kakamega,WESTERN,24138
LUGARI,Rural,31,1216,1317,2533,Kakamega,WESTERN,24139
LUGARI,Rural,32,1378,1823,3201,Kakamega,WESTERN,24140
LUGARI,Rural,33,1122,1324,2446,Kakamega,WESTERN,24141
LUGARI,Rural,34,1125,1312,2437,Kakamega,WESTERN,24142
LUGARI,Rural,35,1632,2017,3649,Kakamega,WESTERN,24143
LUGARI,Rural,36,964,1272,2236,Kakamega,WESTERN,24144
LUGARI,Rural,37,1067,1228,2295,Kakamega,WESTERN,24145
LUGARI,Rural,38,1040,1243,2283,Kakamega,WESTERN,24146
LUGARI,Rural,39,953,1071,2024,Kakamega,WESTERN,24147
LUGARI,Rural,40,1322,1657,2979,Kakamega,WESTERN,24148
LUGARI,Rural,41,807,851,1658,Kakamega,WESTERN,24149
LUGARI,Rural,42,904,1061,1965,Kakamega,WESTERN,24150
LUGARI,Rural,43,714,850,1564,Kakamega,WESTERN,24151
LUGARI,Rural,44,668,782,1450,Kakamega,WESTERN,24152
LUGARI,Rural,45,1067,1205,2272,Kakamega,WESTERN,24153
LUGARI,Rural,46,764,889,1653,Kakamega,WESTERN,24154
LUGARI,Rural,47,787,928,1715,Kakamega,WESTERN,24155
LUGARI,Rural,48,712,835,1547,Kakamega,WESTERN,24156
LUGARI,Rural,49,759,831,1590,Kakamega,WESTERN,24157
LUGARI,Rural,50,864,1067,1931,Kakamega,WESTERN,24158
LUGARI,Rural,51,595,654,1249,Kakamega,WESTERN,24159
LUGARI,Rural,52,625,695,1320,Kakamega,WESTERN,24160
LUGARI,Rural,53,588,672,1260,Kakamega,WESTERN,24161
LUGARI,Rural,54,522,568,1090,Kakamega,WESTERN,24162
LUGARI,Rural,55,688,782,1470,Kakamega,WESTERN,24163
LUGARI,Rural,56,519,503,1022,Kakamega,WESTERN,24164
LUGARI,Rural,57,602,606,1208,Kakamega,WESTERN,24165
LUGARI,Rural,58,363,343,706,Kakamega,WESTERN,24166
LUGARI,Rural,59,469,465,934,Kakamega,WESTERN,24167
LUGARI,Rural,60,505,559,1064,Kakamega,WESTERN,24168
LUGARI,Rural,61,347,378,725,Kakamega,WESTERN,24169
LUGARI,Rural,62,316,328,644,Kakamega,WESTERN,24170
LUGARI,Rural,63,335,300,635,Kakamega,WESTERN,24171
LUGARI,Rural,64,274,339,613,Kakamega,WESTERN,24172
LUGARI,Rural,65,301,365,666,Kakamega,WESTERN,24173
LUGARI,Rural,66,249,398,647,Kakamega,WESTERN,24174
LUGARI,Rural,67,292,331,623,Kakamega,WESTERN,24175
LUGARI,Rural,68,182,206,388,Kakamega,WESTERN,24176
LUGARI,Rural,69,179,228,407,Kakamega,WESTERN,24177
LUGARI,Rural,70,299,387,686,Kakamega,WESTERN,24178
LUGARI,Rural,71,188,202,390,Kakamega,WESTERN,24179
LUGARI,Rural,72,184,206,390,Kakamega,WESTERN,24180
LUGARI,Rural,73,218,239,457,Kakamega,WESTERN,24181
LUGARI,Rural,74,158,172,330,Kakamega,WESTERN,24182
LUGARI,Rural,75,192,210,402,Kakamega,WESTERN,24183
LUGARI,Rural,76,113,154,267,Kakamega,WESTERN,24184
LUGARI,Rural,77,166,212,378,Kakamega,WESTERN,24185
LUGARI,Rural,78,99,121,220,Kakamega,WESTERN,24186
LUGARI,Rural,79,118,189,307,Kakamega,WESTERN,24187
LUGARI,Rural,80+,1040,1142,2182,Kakamega,WESTERN,24188
LUGARI,Rural,Age NS,74,59,133,Kakamega,WESTERN,24189
VIHIGA,Rural,0,1461,1460,2921,Vihiga,WESTERN,24190
VIHIGA,Rural,1,1376,1471,2847,Vihiga,WESTERN,24191
VIHIGA,Rural,2,1578,1487,3065,Vihiga,WESTERN,24192
VIHIGA,Rural,3,1502,1483,2985,Vihiga,WESTERN,24193
VIHIGA,Rural,4,1583,1457,3040,Vihiga,WESTERN,24194
VIHIGA,Rural,5,1607,1472,3079,Vihiga,WESTERN,24195
VIHIGA,Rural,6,1515,1442,2957,Vihiga,WESTERN,24196
VIHIGA,Rural,7,1585,1390,2975,Vihiga,WESTERN,24197
VIHIGA,Rural,8,1431,1373,2804,Vihiga,WESTERN,24198
VIHIGA,Rural,9,1587,1439,3026,Vihiga,WESTERN,24199
VIHIGA,Rural,10,1577,1451,3028,Vihiga,WESTERN,24200
VIHIGA,Rural,11,1277,1266,2543,Vihiga,WESTERN,24201
VIHIGA,Rural,12,1445,1455,2900,Vihiga,WESTERN,24202
VIHIGA,Rural,13,1460,1442,2902,Vihiga,WESTERN,24203
VIHIGA,Rural,14,1237,1236,2473,Vihiga,WESTERN,24204
VIHIGA,Rural,15,1220,1287,2507,Vihiga,WESTERN,24205
VIHIGA,Rural,16,1181,1263,2444,Vihiga,WESTERN,24206
VIHIGA,Rural,17,1084,1315,2399,Vihiga,WESTERN,24207
VIHIGA,Rural,18,1063,1123,2186,Vihiga,WESTERN,24208
VIHIGA,Rural,19,904,913,1817,Vihiga,WESTERN,24209
VIHIGA,Rural,20,785,945,1730,Vihiga,WESTERN,24210
VIHIGA,Rural,21,596,724,1320,Vihiga,WESTERN,24211
VIHIGA,Rural,22,566,771,1337,Vihiga,WESTERN,24212
VIHIGA,Rural,23,502,772,1274,Vihiga,WESTERN,24213
VIHIGA,Rural,24,482,670,1152,Vihiga,WESTERN,24214
VIHIGA,Rural,25,499,772,1271,Vihiga,WESTERN,24215
VIHIGA,Rural,26,426,645,1071,Vihiga,WESTERN,24216
VIHIGA,Rural,27,419,569,988,Vihiga,WESTERN,24217
VIHIGA,Rural,28,400,530,930,Vihiga,WESTERN,24218
VIHIGA,Rural,29,376,581,957,Vihiga,WESTERN,24219
VIHIGA,Rural,30,462,699,1161,Vihiga,WESTERN,24220
VIHIGA,Rural,31,372,491,863,Vihiga,WESTERN,24221
VIHIGA,Rural,32,369,603,972,Vihiga,WESTERN,24222
VIHIGA,Rural,33,323,445,768,Vihiga,WESTERN,24223
VIHIGA,Rural,34,349,489,838,Vihiga,WESTERN,24224
VIHIGA,Rural,35,399,574,973,Vihiga,WESTERN,24225
VIHIGA,Rural,36,321,399,720,Vihiga,WESTERN,24226
VIHIGA,Rural,37,276,447,723,Vihiga,WESTERN,24227
VIHIGA,Rural,38,302,398,700,Vihiga,WESTERN,24228
VIHIGA,Rural,39,269,395,664,Vihiga,WESTERN,24229
VIHIGA,Rural,40,362,591,953,Vihiga,WESTERN,24230
VIHIGA,Rural,41,260,352,612,Vihiga,WESTERN,24231
VIHIGA,Rural,42,276,395,671,Vihiga,WESTERN,24232
VIHIGA,Rural,43,229,328,557,Vihiga,WESTERN,24233
VIHIGA,Rural,44,278,346,624,Vihiga,WESTERN,24234
VIHIGA,Rural,45,258,490,748,Vihiga,WESTERN,24235
VIHIGA,Rural,46,262,373,635,Vihiga,WESTERN,24236
VIHIGA,Rural,47,244,363,607,Vihiga,WESTERN,24237
VIHIGA,Rural,48,246,359,605,Vihiga,WESTERN,24238
VIHIGA,Rural,49,270,368,638,Vihiga,WESTERN,24239
VIHIGA,Rural,50,304,502,806,Vihiga,WESTERN,24240
VIHIGA,Rural,51,229,322,551,Vihiga,WESTERN,24241
VIHIGA,Rural,52,263,367,630,Vihiga,WESTERN,24242
VIHIGA,Rural,53,260,306,566,Vihiga,WESTERN,24243
VIHIGA,Rural,54,279,321,600,Vihiga,WESTERN,24244
VIHIGA,Rural,55,299,383,682,Vihiga,WESTERN,24245
VIHIGA,Rural,56,266,346,612,Vihiga,WESTERN,24246
VIHIGA,Rural,57,275,309,584,Vihiga,WESTERN,24247
VIHIGA,Rural,58,206,254,460,Vihiga,WESTERN,24248
VIHIGA,Rural,59,242,265,507,Vihiga,WESTERN,24249
VIHIGA,Rural,60,307,356,663,Vihiga,WESTERN,24250
VIHIGA,Rural,61,210,206,416,Vihiga,WESTERN,24251
VIHIGA,Rural,62,217,236,453,Vihiga,WESTERN,24252
VIHIGA,Rural,63,213,216,429,Vihiga,WESTERN,24253
VIHIGA,Rural,64,196,211,407,Vihiga,WESTERN,24254
VIHIGA,Rural,65,167,251,418,Vihiga,WESTERN,24255
VIHIGA,Rural,66,195,264,459,Vihiga,WESTERN,24256
VIHIGA,Rural,67,181,172,353,Vihiga,WESTERN,24257
VIHIGA,Rural,68,122,143,265,Vihiga,WESTERN,24258
VIHIGA,Rural,69,148,205,353,Vihiga,WESTERN,24259
VIHIGA,Rural,70,205,247,452,Vihiga,WESTERN,24260
VIHIGA,Rural,71,140,168,308,Vihiga,WESTERN,24261
VIHIGA,Rural,72,133,165,298,Vihiga,WESTERN,24262
VIHIGA,Rural,73,140,155,295,Vihiga,WESTERN,24263
VIHIGA,Rural,74,109,127,236,Vihiga,WESTERN,24264
VIHIGA,Rural,75,127,134,261,Vihiga,WESTERN,24265
VIHIGA,Rural,76,111,143,254,Vihiga,WESTERN,24266
VIHIGA,Rural,77,129,132,261,Vihiga,WESTERN,24267
VIHIGA,Rural,78,105,102,207,Vihiga,WESTERN,24268
VIHIGA,Rural,79,93,109,202,Vihiga,WESTERN,24269
VIHIGA,Rural,80+,645,880,1525,Vihiga,WESTERN,24270
VIHIGA,Rural,Age NS,33,29,62,Vihiga,WESTERN,24271
EMUHAYA,Rural,0,2217,2132,4349,Vihiga,WESTERN,24272
EMUHAYA,Rural,1,2062,2066,4128,Vihiga,WESTERN,24273
EMUHAYA,Rural,2,2255,2244,4499,Vihiga,WESTERN,24274
EMUHAYA,Rural,3,2160,2269,4429,Vihiga,WESTERN,24275
EMUHAYA,Rural,4,2179,2099,4278,Vihiga,WESTERN,24276
EMUHAYA,Rural,5,2071,2066,4137,Vihiga,WESTERN,24277
EMUHAYA,Rural,6,2056,2070,4126,Vihiga,WESTERN,24278
EMUHAYA,Rural,7,2039,2062,4101,Vihiga,WESTERN,24279
EMUHAYA,Rural,8,1818,1920,3738,Vihiga,WESTERN,24280
EMUHAYA,Rural,9,2026,2139,4165,Vihiga,WESTERN,24281
EMUHAYA,Rural,10,2073,2221,4294,Vihiga,WESTERN,24282
EMUHAYA,Rural,11,1620,1785,3405,Vihiga,WESTERN,24283
EMUHAYA,Rural,12,2037,2102,4139,Vihiga,WESTERN,24284
EMUHAYA,Rural,13,1940,2032,3972,Vihiga,WESTERN,24285
EMUHAYA,Rural,14,1799,1718,3517,Vihiga,WESTERN,24286
EMUHAYA,Rural,15,1727,1722,3449,Vihiga,WESTERN,24287
EMUHAYA,Rural,16,1570,1687,3257,Vihiga,WESTERN,24288
EMUHAYA,Rural,17,1538,1572,3110,Vihiga,WESTERN,24289
EMUHAYA,Rural,18,1378,1379,2757,Vihiga,WESTERN,24290
EMUHAYA,Rural,19,1110,1185,2295,Vihiga,WESTERN,24291
EMUHAYA,Rural,20,1106,1435,2541,Vihiga,WESTERN,24292
EMUHAYA,Rural,21,788,1042,1830,Vihiga,WESTERN,24293
EMUHAYA,Rural,22,844,1147,1991,Vihiga,WESTERN,24294
EMUHAYA,Rural,23,684,1092,1776,Vihiga,WESTERN,24295
EMUHAYA,Rural,24,616,979,1595,Vihiga,WESTERN,24296
EMUHAYA,Rural,25,775,1079,1854,Vihiga,WESTERN,24297
EMUHAYA,Rural,26,615,846,1461,Vihiga,WESTERN,24298
EMUHAYA,Rural,27,630,830,1460,Vihiga,WESTERN,24299
EMUHAYA,Rural,28,500,790,1290,Vihiga,WESTERN,24300
EMUHAYA,Rural,29,522,701,1223,Vihiga,WESTERN,24301
EMUHAYA,Rural,30,719,1121,1840,Vihiga,WESTERN,24302
EMUHAYA,Rural,31,470,632,1102,Vihiga,WESTERN,24303
EMUHAYA,Rural,32,528,771,1299,Vihiga,WESTERN,24304
EMUHAYA,Rural,33,471,537,1008,Vihiga,WESTERN,24305
EMUHAYA,Rural,34,481,647,1128,Vihiga,WESTERN,24306
EMUHAYA,Rural,35,716,933,1649,Vihiga,WESTERN,24307
EMUHAYA,Rural,36,472,607,1079,Vihiga,WESTERN,24308
EMUHAYA,Rural,37,473,603,1076,Vihiga,WESTERN,24309
EMUHAYA,Rural,38,395,582,977,Vihiga,WESTERN,24310
EMUHAYA,Rural,39,410,503,913,Vihiga,WESTERN,24311
EMUHAYA,Rural,40,668,971,1639,Vihiga,WESTERN,24312
EMUHAYA,Rural,41,384,483,867,Vihiga,WESTERN,24313
EMUHAYA,Rural,42,429,515,944,Vihiga,WESTERN,24314
EMUHAYA,Rural,43,339,484,823,Vihiga,WESTERN,24315
EMUHAYA,Rural,44,381,407,788,Vihiga,WESTERN,24316
EMUHAYA,Rural,45,499,768,1267,Vihiga,WESTERN,24317
EMUHAYA,Rural,46,355,521,876,Vihiga,WESTERN,24318
EMUHAYA,Rural,47,421,565,986,Vihiga,WESTERN,24319
EMUHAYA,Rural,48,342,467,809,Vihiga,WESTERN,24320
EMUHAYA,Rural,49,411,534,945,Vihiga,WESTERN,24321
EMUHAYA,Rural,50,512,875,1387,Vihiga,WESTERN,24322
EMUHAYA,Rural,51,354,416,770,Vihiga,WESTERN,24323
EMUHAYA,Rural,52,365,455,820,Vihiga,WESTERN,24324
EMUHAYA,Rural,53,359,415,774,Vihiga,WESTERN,24325
EMUHAYA,Rural,54,390,420,810,Vihiga,WESTERN,24326
EMUHAYA,Rural,55,476,562,1038,Vihiga,WESTERN,24327
EMUHAYA,Rural,56,397,424,821,Vihiga,WESTERN,24328
EMUHAYA,Rural,57,475,506,981,Vihiga,WESTERN,24329
EMUHAYA,Rural,58,233,292,525,Vihiga,WESTERN,24330
EMUHAYA,Rural,59,325,381,706,Vihiga,WESTERN,24331
EMUHAYA,Rural,60,504,645,1149,Vihiga,WESTERN,24332
EMUHAYA,Rural,61,325,338,663,Vihiga,WESTERN,24333
EMUHAYA,Rural,62,276,264,540,Vihiga,WESTERN,24334
EMUHAYA,Rural,63,231,243,474,Vihiga,WESTERN,24335
EMUHAYA,Rural,64,224,279,503,Vihiga,WESTERN,24336
EMUHAYA,Rural,65,281,360,641,Vihiga,WESTERN,24337
EMUHAYA,Rural,66,281,386,667,Vihiga,WESTERN,24338
EMUHAYA,Rural,67,260,302,562,Vihiga,WESTERN,24339
EMUHAYA,Rural,68,137,180,317,Vihiga,WESTERN,24340
EMUHAYA,Rural,69,206,240,446,Vihiga,WESTERN,24341
EMUHAYA,Rural,70,342,529,871,Vihiga,WESTERN,24342
EMUHAYA,Rural,71,156,200,356,Vihiga,WESTERN,24343
EMUHAYA,Rural,72,221,193,414,Vihiga,WESTERN,24344
EMUHAYA,Rural,73,186,229,415,Vihiga,WESTERN,24345
EMUHAYA,Rural,74,176,191,367,Vihiga,WESTERN,24346
EMUHAYA,Rural,75,209,233,442,Vihiga,WESTERN,24347
EMUHAYA,Rural,76,162,160,322,Vihiga,WESTERN,24348
EMUHAYA,Rural,77,168,183,351,Vihiga,WESTERN,24349
EMUHAYA,Rural,78,137,122,259,Vihiga,WESTERN,24350
EMUHAYA,Rural,79,96,138,234,Vihiga,WESTERN,24351
EMUHAYA,Rural,80+,807,1086,1893,Vihiga,WESTERN,24352
EMUHAYA,Rural,Age NS,12,12,24,Vihiga,WESTERN,24353
HAMISI,Rural,0,2457,2336,4793,Vihiga,WESTERN,24354
HAMISI,Rural,1,2143,2144,4287,Vihiga,WESTERN,24355
HAMISI,Rural,2,2356,2439,4795,Vihiga,WESTERN,24356
HAMISI,Rural,3,2335,2443,4778,Vihiga,WESTERN,24357
HAMISI,Rural,4,2400,2412,4812,Vihiga,WESTERN,24358
HAMISI,Rural,5,2346,2343,4689,Vihiga,WESTERN,24359
HAMISI,Rural,6,2276,2277,4553,Vihiga,WESTERN,24360
HAMISI,Rural,7,2234,2161,4395,Vihiga,WESTERN,24361
HAMISI,Rural,8,2101,2281,4382,Vihiga,WESTERN,24362
HAMISI,Rural,9,2369,2331,4700,Vihiga,WESTERN,24363
HAMISI,Rural,10,2252,2435,4687,Vihiga,WESTERN,24364
HAMISI,Rural,11,1744,1899,3643,Vihiga,WESTERN,24365
HAMISI,Rural,12,2126,2168,4294,Vihiga,WESTERN,24366
HAMISI,Rural,13,2097,2168,4265,Vihiga,WESTERN,24367
HAMISI,Rural,14,1932,1836,3768,Vihiga,WESTERN,24368
HAMISI,Rural,15,1835,1802,3637,Vihiga,WESTERN,24369
HAMISI,Rural,16,1701,1878,3579,Vihiga,WESTERN,24370
HAMISI,Rural,17,2007,1737,3744,Vihiga,WESTERN,24371
HAMISI,Rural,18,1867,1618,3485,Vihiga,WESTERN,24372
HAMISI,Rural,19,1467,1332,2799,Vihiga,WESTERN,24373
HAMISI,Rural,20,1335,1419,2754,Vihiga,WESTERN,24374
HAMISI,Rural,21,962,1131,2093,Vihiga,WESTERN,24375
HAMISI,Rural,22,981,1309,2290,Vihiga,WESTERN,24376
HAMISI,Rural,23,806,1210,2016,Vihiga,WESTERN,24377
HAMISI,Rural,24,763,1018,1781,Vihiga,WESTERN,24378
HAMISI,Rural,25,823,1168,1991,Vihiga,WESTERN,24379
HAMISI,Rural,26,688,980,1668,Vihiga,WESTERN,24380
HAMISI,Rural,27,780,919,1699,Vihiga,WESTERN,24381
HAMISI,Rural,28,610,844,1454,Vihiga,WESTERN,24382
HAMISI,Rural,29,650,852,1502,Vihiga,WESTERN,24383
HAMISI,Rural,30,794,1200,1994,Vihiga,WESTERN,24384
HAMISI,Rural,31,593,718,1311,Vihiga,WESTERN,24385
HAMISI,Rural,32,684,922,1606,Vihiga,WESTERN,24386
HAMISI,Rural,33,570,690,1260,Vihiga,WESTERN,24387
HAMISI,Rural,34,633,688,1321,Vihiga,WESTERN,24388
HAMISI,Rural,35,737,911,1648,Vihiga,WESTERN,24389
HAMISI,Rural,36,543,658,1201,Vihiga,WESTERN,24390
HAMISI,Rural,37,537,680,1217,Vihiga,WESTERN,24391
HAMISI,Rural,38,509,695,1204,Vihiga,WESTERN,24392
HAMISI,Rural,39,476,618,1094,Vihiga,WESTERN,24393
HAMISI,Rural,40,630,916,1546,Vihiga,WESTERN,24394
HAMISI,Rural,41,408,472,880,Vihiga,WESTERN,24395
HAMISI,Rural,42,472,539,1011,Vihiga,WESTERN,24396
HAMISI,Rural,43,378,530,908,Vihiga,WESTERN,24397
HAMISI,Rural,44,379,480,859,Vihiga,WESTERN,24398
HAMISI,Rural,45,570,743,1313,Vihiga,WESTERN,24399
HAMISI,Rural,46,372,494,866,Vihiga,WESTERN,24400
HAMISI,Rural,47,419,525,944,Vihiga,WESTERN,24401
HAMISI,Rural,48,367,493,860,Vihiga,WESTERN,24402
HAMISI,Rural,49,490,535,1025,Vihiga,WESTERN,24403
HAMISI,Rural,50,480,759,1239,Vihiga,WESTERN,24404
HAMISI,Rural,51,376,436,812,Vihiga,WESTERN,24405
HAMISI,Rural,52,368,482,850,Vihiga,WESTERN,24406
HAMISI,Rural,53,387,463,850,Vihiga,WESTERN,24407
HAMISI,Rural,54,379,464,843,Vihiga,WESTERN,24408
HAMISI,Rural,55,462,548,1010,Vihiga,WESTERN,24409
HAMISI,Rural,56,340,423,763,Vihiga,WESTERN,24410
HAMISI,Rural,57,407,519,926,Vihiga,WESTERN,24411
HAMISI,Rural,58,289,302,591,Vihiga,WESTERN,24412
HAMISI,Rural,59,367,375,742,Vihiga,WESTERN,24413
HAMISI,Rural,60,420,504,924,Vihiga,WESTERN,24414
HAMISI,Rural,61,295,336,631,Vihiga,WESTERN,24415
HAMISI,Rural,62,295,330,625,Vihiga,WESTERN,24416
HAMISI,Rural,63,274,287,561,Vihiga,WESTERN,24417
HAMISI,Rural,64,292,307,599,Vihiga,WESTERN,24418
HAMISI,Rural,65,253,318,571,Vihiga,WESTERN,24419
HAMISI,Rural,66,286,387,673,Vihiga,WESTERN,24420
HAMISI,Rural,67,264,309,573,Vihiga,WESTERN,24421
HAMISI,Rural,68,203,218,421,Vihiga,WESTERN,24422
HAMISI,Rural,69,206,264,470,Vihiga,WESTERN,24423
HAMISI,Rural,70,301,394,695,Vihiga,WESTERN,24424
HAMISI,Rural,71,201,247,448,Vihiga,WESTERN,24425
HAMISI,Rural,72,211,210,421,Vihiga,WESTERN,24426
HAMISI,Rural,73,202,258,460,Vihiga,WESTERN,24427
HAMISI,Rural,74,143,205,348,Vihiga,WESTERN,24428
HAMISI,Rural,75,181,195,376,Vihiga,WESTERN,24429
HAMISI,Rural,76,156,179,335,Vihiga,WESTERN,24430
HAMISI,Rural,77,191,182,373,Vihiga,WESTERN,24431
HAMISI,Rural,78,150,131,281,Vihiga,WESTERN,24432
HAMISI,Rural,79,163,170,333,Vihiga,WESTERN,24433
HAMISI,Rural,80+,892,1175,2067,Vihiga,WESTERN,24434
HAMISI,Rural,Age NS,31,16,47,Vihiga,WESTERN,24435
MUMIAS,Rural,0,4636,4687,9323,Kakamega,WESTERN,24436
MUMIAS,Rural,1,4437,4287,8724,Kakamega,WESTERN,24437
MUMIAS,Rural,2,4822,4852,9674,Kakamega,WESTERN,24438
MUMIAS,Rural,3,4546,4613,9159,Kakamega,WESTERN,24439
MUMIAS,Rural,4,4394,4488,8882,Kakamega,WESTERN,24440
MUMIAS,Rural,5,4413,4531,8944,Kakamega,WESTERN,24441
MUMIAS,Rural,6,3988,4035,8023,Kakamega,WESTERN,24442
MUMIAS,Rural,7,3860,3841,7701,Kakamega,WESTERN,24443
MUMIAS,Rural,8,3591,3683,7274,Kakamega,WESTERN,24444
MUMIAS,Rural,9,3794,3696,7490,Kakamega,WESTERN,24445
MUMIAS,Rural,10,3827,3691,7518,Kakamega,WESTERN,24446
MUMIAS,Rural,11,3013,3096,6109,Kakamega,WESTERN,24447
MUMIAS,Rural,12,3562,3449,7011,Kakamega,WESTERN,24448
MUMIAS,Rural,13,3251,3323,6574,Kakamega,WESTERN,24449
MUMIAS,Rural,14,3100,3030,6130,Kakamega,WESTERN,24450
MUMIAS,Rural,15,3079,2853,5932,Kakamega,WESTERN,24451
MUMIAS,Rural,16,2604,2719,5323,Kakamega,WESTERN,24452
MUMIAS,Rural,17,2829,2802,5631,Kakamega,WESTERN,24453
MUMIAS,Rural,18,2511,2576,5087,Kakamega,WESTERN,24454
MUMIAS,Rural,19,2174,2400,4574,Kakamega,WESTERN,24455
MUMIAS,Rural,20,2281,2963,5244,Kakamega,WESTERN,24456
MUMIAS,Rural,21,1856,2110,3966,Kakamega,WESTERN,24457
MUMIAS,Rural,22,1816,2389,4205,Kakamega,WESTERN,24458
MUMIAS,Rural,23,1714,2206,3920,Kakamega,WESTERN,24459
MUMIAS,Rural,24,1587,1976,3563,Kakamega,WESTERN,24460
MUMIAS,Rural,25,1653,2343,3996,Kakamega,WESTERN,24461
MUMIAS,Rural,26,1284,1699,2983,Kakamega,WESTERN,24462
MUMIAS,Rural,27,1449,1666,3115,Kakamega,WESTERN,24463
MUMIAS,Rural,28,1149,1421,2570,Kakamega,WESTERN,24464
MUMIAS,Rural,29,1282,1369,2651,Kakamega,WESTERN,24465
MUMIAS,Rural,30,1423,1999,3422,Kakamega,WESTERN,24466
MUMIAS,Rural,31,1088,1205,2293,Kakamega,WESTERN,24467
MUMIAS,Rural,32,1133,1431,2564,Kakamega,WESTERN,24468
MUMIAS,Rural,33,968,1190,2158,Kakamega,WESTERN,24469
MUMIAS,Rural,34,1003,1102,2105,Kakamega,WESTERN,24470
MUMIAS,Rural,35,1280,1531,2811,Kakamega,WESTERN,24471
MUMIAS,Rural,36,869,1018,1887,Kakamega,WESTERN,24472
MUMIAS,Rural,37,936,1034,1970,Kakamega,WESTERN,24473
MUMIAS,Rural,38,632,849,1481,Kakamega,WESTERN,24474
MUMIAS,Rural,39,780,858,1638,Kakamega,WESTERN,24475
MUMIAS,Rural,40,1032,1513,2545,Kakamega,WESTERN,24476
MUMIAS,Rural,41,724,888,1612,Kakamega,WESTERN,24477
MUMIAS,Rural,42,616,730,1346,Kakamega,WESTERN,24478
MUMIAS,Rural,43,601,729,1330,Kakamega,WESTERN,24479
MUMIAS,Rural,44,524,628,1152,Kakamega,WESTERN,24480
MUMIAS,Rural,45,800,1050,1850,Kakamega,WESTERN,24481
MUMIAS,Rural,46,665,726,1391,Kakamega,WESTERN,24482
MUMIAS,Rural,47,651,904,1555,Kakamega,WESTERN,24483
MUMIAS,Rural,48,501,569,1070,Kakamega,WESTERN,24484
MUMIAS,Rural,49,611,680,1291,Kakamega,WESTERN,24485
MUMIAS,Rural,50,633,921,1554,Kakamega,WESTERN,24486
MUMIAS,Rural,51,524,640,1164,Kakamega,WESTERN,24487
MUMIAS,Rural,52,444,524,968,Kakamega,WESTERN,24488
MUMIAS,Rural,53,463,585,1048,Kakamega,WESTERN,24489
MUMIAS,Rural,54,415,538,953,Kakamega,WESTERN,24490
MUMIAS,Rural,55,526,604,1130,Kakamega,WESTERN,24491
MUMIAS,Rural,56,445,510,955,Kakamega,WESTERN,24492
MUMIAS,Rural,57,527,637,1164,Kakamega,WESTERN,24493
MUMIAS,Rural,58,232,274,506,Kakamega,WESTERN,24494
MUMIAS,Rural,59,389,480,869,Kakamega,WESTERN,24495
MUMIAS,Rural,60,460,624,1084,Kakamega,WESTERN,24496
MUMIAS,Rural,61,288,380,668,Kakamega,WESTERN,24497
MUMIAS,Rural,62,288,306,594,Kakamega,WESTERN,24498
MUMIAS,Rural,63,298,313,611,Kakamega,WESTERN,24499
MUMIAS,Rural,64,267,310,577,Kakamega,WESTERN,24500
MUMIAS,Rural,65,283,343,626,Kakamega,WESTERN,24501
MUMIAS,Rural,66,211,275,486,Kakamega,WESTERN,24502
MUMIAS,Rural,67,273,333,606,Kakamega,WESTERN,24503
MUMIAS,Rural,68,145,170,315,Kakamega,WESTERN,24504
MUMIAS,Rural,69,189,305,494,Kakamega,WESTERN,24505
MUMIAS,Rural,70,276,370,646,Kakamega,WESTERN,24506
MUMIAS,Rural,71,188,230,418,Kakamega,WESTERN,24507
MUMIAS,Rural,72,179,184,363,Kakamega,WESTERN,24508
MUMIAS,Rural,73,220,227,447,Kakamega,WESTERN,24509
MUMIAS,Rural,74,121,143,264,Kakamega,WESTERN,24510
MUMIAS,Rural,75,213,223,436,Kakamega,WESTERN,24511
MUMIAS,Rural,76,131,165,296,Kakamega,WESTERN,24512
MUMIAS,Rural,77,173,270,443,Kakamega,WESTERN,24513
MUMIAS,Rural,78,104,111,215,Kakamega,WESTERN,24514
MUMIAS,Rural,79,123,215,338,Kakamega,WESTERN,24515
MUMIAS,Rural,80+,873,1030,1903,Kakamega,WESTERN,24516
MUMIAS,Rural,Age NS,88,76,164,Kakamega,WESTERN,24517
BUTERE,Rural,0,4002,4022,8024,Kakamega,WESTERN,24518
BUTERE,Rural,1,3817,3892,7709,Kakamega,WESTERN,24519
BUTERE,Rural,2,3978,4184,8162,Kakamega,WESTERN,24520
BUTERE,Rural,3,3944,4012,7956,Kakamega,WESTERN,24521
BUTERE,Rural,4,3891,3783,7674,Kakamega,WESTERN,24522
BUTERE,Rural,5,4008,3925,7933,Kakamega,WESTERN,24523
BUTERE,Rural,6,3622,3546,7168,Kakamega,WESTERN,24524
BUTERE,Rural,7,3594,3518,7112,Kakamega,WESTERN,24525
BUTERE,Rural,8,3390,3322,6712,Kakamega,WESTERN,24526
BUTERE,Rural,9,3476,3668,7144,Kakamega,WESTERN,24527
BUTERE,Rural,10,3546,3644,7190,Kakamega,WESTERN,24528
BUTERE,Rural,11,2871,2920,5791,Kakamega,WESTERN,24529
BUTERE,Rural,12,3573,3356,6929,Kakamega,WESTERN,24530
BUTERE,Rural,13,3198,3175,6373,Kakamega,WESTERN,24531
BUTERE,Rural,14,2928,2805,5733,Kakamega,WESTERN,24532
BUTERE,Rural,15,2828,2710,5538,Kakamega,WESTERN,24533
BUTERE,Rural,16,2581,2507,5088,Kakamega,WESTERN,24534
BUTERE,Rural,17,2738,2564,5302,Kakamega,WESTERN,24535
BUTERE,Rural,18,2370,2284,4654,Kakamega,WESTERN,24536
BUTERE,Rural,19,1896,2020,3916,Kakamega,WESTERN,24537
BUTERE,Rural,20,2050,2493,4543,Kakamega,WESTERN,24538
BUTERE,Rural,21,1486,1883,3369,Kakamega,WESTERN,24539
BUTERE,Rural,22,1573,2087,3660,Kakamega,WESTERN,24540
BUTERE,Rural,23,1391,1979,3370,Kakamega,WESTERN,24541
BUTERE,Rural,24,1245,1744,2989,Kakamega,WESTERN,24542
BUTERE,Rural,25,1371,2051,3422,Kakamega,WESTERN,24543
BUTERE,Rural,26,1137,1508,2645,Kakamega,WESTERN,24544
BUTERE,Rural,27,1155,1555,2710,Kakamega,WESTERN,24545
BUTERE,Rural,28,942,1290,2232,Kakamega,WESTERN,24546
BUTERE,Rural,29,985,1266,2251,Kakamega,WESTERN,24547
BUTERE,Rural,30,1266,1912,3178,Kakamega,WESTERN,24548
BUTERE,Rural,31,947,1152,2099,Kakamega,WESTERN,24549
BUTERE,Rural,32,955,1339,2294,Kakamega,WESTERN,24550
BUTERE,Rural,33,852,1033,1885,Kakamega,WESTERN,24551
BUTERE,Rural,34,876,1047,1923,Kakamega,WESTERN,24552
BUTERE,Rural,35,1171,1526,2697,Kakamega,WESTERN,24553
BUTERE,Rural,36,832,964,1796,Kakamega,WESTERN,24554
BUTERE,Rural,37,864,974,1838,Kakamega,WESTERN,24555
BUTERE,Rural,38,760,1010,1770,Kakamega,WESTERN,24556
BUTERE,Rural,39,703,875,1578,Kakamega,WESTERN,24557
BUTERE,Rural,40,1102,1594,2696,Kakamega,WESTERN,24558
BUTERE,Rural,41,738,829,1567,Kakamega,WESTERN,24559
BUTERE,Rural,42,648,843,1491,Kakamega,WESTERN,24560
BUTERE,Rural,43,583,799,1382,Kakamega,WESTERN,24561
BUTERE,Rural,44,546,627,1173,Kakamega,WESTERN,24562
BUTERE,Rural,45,852,1235,2087,Kakamega,WESTERN,24563
BUTERE,Rural,46,688,816,1504,Kakamega,WESTERN,24564
BUTERE,Rural,47,708,892,1600,Kakamega,WESTERN,24565
BUTERE,Rural,48,535,641,1176,Kakamega,WESTERN,24566
BUTERE,Rural,49,657,737,1394,Kakamega,WESTERN,24567
BUTERE,Rural,50,780,1152,1932,Kakamega,WESTERN,24568
BUTERE,Rural,51,601,676,1277,Kakamega,WESTERN,24569
BUTERE,Rural,52,631,671,1302,Kakamega,WESTERN,24570
BUTERE,Rural,53,531,673,1204,Kakamega,WESTERN,24571
BUTERE,Rural,54,526,652,1178,Kakamega,WESTERN,24572
BUTERE,Rural,55,668,767,1435,Kakamega,WESTERN,24573
BUTERE,Rural,56,573,668,1241,Kakamega,WESTERN,24574
BUTERE,Rural,57,638,807,1445,Kakamega,WESTERN,24575
BUTERE,Rural,58,363,347,710,Kakamega,WESTERN,24576
BUTERE,Rural,59,503,585,1088,Kakamega,WESTERN,24577
BUTERE,Rural,60,671,942,1613,Kakamega,WESTERN,24578
BUTERE,Rural,61,404,457,861,Kakamega,WESTERN,24579
BUTERE,Rural,62,425,407,832,Kakamega,WESTERN,24580
BUTERE,Rural,63,377,367,744,Kakamega,WESTERN,24581
BUTERE,Rural,64,341,367,708,Kakamega,WESTERN,24582
BUTERE,Rural,65,375,495,870,Kakamega,WESTERN,24583
BUTERE,Rural,66,321,555,876,Kakamega,WESTERN,24584
BUTERE,Rural,67,374,388,762,Kakamega,WESTERN,24585
BUTERE,Rural,68,196,231,427,Kakamega,WESTERN,24586
BUTERE,Rural,69,227,394,621,Kakamega,WESTERN,24587
BUTERE,Rural,70,397,574,971,Kakamega,WESTERN,24588
BUTERE,Rural,71,252,265,517,Kakamega,WESTERN,24589
BUTERE,Rural,72,295,306,601,Kakamega,WESTERN,24590
BUTERE,Rural,73,292,253,545,Kakamega,WESTERN,24591
BUTERE,Rural,74,231,245,476,Kakamega,WESTERN,24592
BUTERE,Rural,75,273,337,610,Kakamega,WESTERN,24593
BUTERE,Rural,76,164,204,368,Kakamega,WESTERN,24594
BUTERE,Rural,77,261,362,623,Kakamega,WESTERN,24595
BUTERE,Rural,78,170,148,318,Kakamega,WESTERN,24596
BUTERE,Rural,79,171,252,423,Kakamega,WESTERN,24597
BUTERE,Rural,80+,1127,1376,2503,Kakamega,WESTERN,24598
BUTERE,Rural,Age NS,57,70,127,Kakamega,WESTERN,24599
BUNGOMA SOUTH,Rural,0,5780,5850,11630,Bungoma,WESTERN,24600
BUNGOMA SOUTH,Rural,1,5436,5553,10989,Bungoma,WESTERN,24601
BUNGOMA SOUTH,Rural,2,5956,6034,11990,Bungoma,WESTERN,24602
BUNGOMA SOUTH,Rural,3,5985,6149,12134,Bungoma,WESTERN,24603
BUNGOMA SOUTH,Rural,4,5653,5582,11235,Bungoma,WESTERN,24604
BUNGOMA SOUTH,Rural,5,5762,5860,11622,Bungoma,WESTERN,24605
BUNGOMA SOUTH,Rural,6,5366,5461,10827,Bungoma,WESTERN,24606
BUNGOMA SOUTH,Rural,7,4960,5257,10217,Bungoma,WESTERN,24607
BUNGOMA SOUTH,Rural,8,4668,5083,9751,Bungoma,WESTERN,24608
BUNGOMA SOUTH,Rural,9,4984,5052,10036,Bungoma,WESTERN,24609
BUNGOMA SOUTH,Rural,10,4879,5023,9902,Bungoma,WESTERN,24610
BUNGOMA SOUTH,Rural,11,4186,4256,8442,Bungoma,WESTERN,24611
BUNGOMA SOUTH,Rural,12,4479,4626,9105,Bungoma,WESTERN,24612
BUNGOMA SOUTH,Rural,13,4420,4420,8840,Bungoma,WESTERN,24613
BUNGOMA SOUTH,Rural,14,4065,4013,8078,Bungoma,WESTERN,24614
BUNGOMA SOUTH,Rural,15,3977,3933,7910,Bungoma,WESTERN,24615
BUNGOMA SOUTH,Rural,16,3611,3452,7063,Bungoma,WESTERN,24616
BUNGOMA SOUTH,Rural,17,3892,3737,7629,Bungoma,WESTERN,24617
BUNGOMA SOUTH,Rural,18,3461,3278,6739,Bungoma,WESTERN,24618
BUNGOMA SOUTH,Rural,19,3158,3268,6426,Bungoma,WESTERN,24619
BUNGOMA SOUTH,Rural,20,2908,3495,6403,Bungoma,WESTERN,24620
BUNGOMA SOUTH,Rural,21,2705,2935,5640,Bungoma,WESTERN,24621
BUNGOMA SOUTH,Rural,22,2535,3177,5712,Bungoma,WESTERN,24622
BUNGOMA SOUTH,Rural,23,2434,2936,5370,Bungoma,WESTERN,24623
BUNGOMA SOUTH,Rural,24,2091,2550,4641,Bungoma,WESTERN,24624
BUNGOMA SOUTH,Rural,25,2363,2808,5171,Bungoma,WESTERN,24625
BUNGOMA SOUTH,Rural,26,1817,2134,3951,Bungoma,WESTERN,24626
BUNGOMA SOUTH,Rural,27,2017,2297,4314,Bungoma,WESTERN,24627
BUNGOMA SOUTH,Rural,28,1508,1885,3393,Bungoma,WESTERN,24628
BUNGOMA SOUTH,Rural,29,1720,1887,3607,Bungoma,WESTERN,24629
BUNGOMA SOUTH,Rural,30,1860,2279,4139,Bungoma,WESTERN,24630
BUNGOMA SOUTH,Rural,31,1559,1796,3355,Bungoma,WESTERN,24631
BUNGOMA SOUTH,Rural,32,1627,1852,3479,Bungoma,WESTERN,24632
BUNGOMA SOUTH,Rural,33,1438,1601,3039,Bungoma,WESTERN,24633
BUNGOMA SOUTH,Rural,34,1298,1435,2733,Bungoma,WESTERN,24634
BUNGOMA SOUTH,Rural,35,1792,1947,3739,Bungoma,WESTERN,24635
BUNGOMA SOUTH,Rural,36,1187,1285,2472,Bungoma,WESTERN,24636
BUNGOMA SOUTH,Rural,37,1327,1324,2651,Bungoma,WESTERN,24637
BUNGOMA SOUTH,Rural,38,929,1136,2065,Bungoma,WESTERN,24638
BUNGOMA SOUTH,Rural,39,1045,1091,2136,Bungoma,WESTERN,24639
BUNGOMA SOUTH,Rural,40,1223,1475,2698,Bungoma,WESTERN,24640
BUNGOMA SOUTH,Rural,41,1033,995,2028,Bungoma,WESTERN,24641
BUNGOMA SOUTH,Rural,42,828,989,1817,Bungoma,WESTERN,24642
BUNGOMA SOUTH,Rural,43,817,953,1770,Bungoma,WESTERN,24643
BUNGOMA SOUTH,Rural,44,714,757,1471,Bungoma,WESTERN,24644
BUNGOMA SOUTH,Rural,45,1028,1218,2246,Bungoma,WESTERN,24645
BUNGOMA SOUTH,Rural,46,787,860,1647,Bungoma,WESTERN,24646
BUNGOMA SOUTH,Rural,47,927,1027,1954,Bungoma,WESTERN,24647
BUNGOMA SOUTH,Rural,48,662,712,1374,Bungoma,WESTERN,24648
BUNGOMA SOUTH,Rural,49,931,1005,1936,Bungoma,WESTERN,24649
BUNGOMA SOUTH,Rural,50,803,902,1705,Bungoma,WESTERN,24650
BUNGOMA SOUTH,Rural,51,661,803,1464,Bungoma,WESTERN,24651
BUNGOMA SOUTH,Rural,52,615,703,1318,Bungoma,WESTERN,24652
BUNGOMA SOUTH,Rural,53,675,795,1470,Bungoma,WESTERN,24653
BUNGOMA SOUTH,Rural,54,537,598,1135,Bungoma,WESTERN,24654
BUNGOMA SOUTH,Rural,55,704,846,1550,Bungoma,WESTERN,24655
BUNGOMA SOUTH,Rural,56,461,579,1040,Bungoma,WESTERN,24656
BUNGOMA SOUTH,Rural,57,611,744,1355,Bungoma,WESTERN,24657
BUNGOMA SOUTH,Rural,58,282,354,636,Bungoma,WESTERN,24658
BUNGOMA SOUTH,Rural,59,517,518,1035,Bungoma,WESTERN,24659
BUNGOMA SOUTH,Rural,60,399,495,894,Bungoma,WESTERN,24660
BUNGOMA SOUTH,Rural,61,423,560,983,Bungoma,WESTERN,24661
BUNGOMA SOUTH,Rural,62,319,407,726,Bungoma,WESTERN,24662
BUNGOMA SOUTH,Rural,63,381,460,841,Bungoma,WESTERN,24663
BUNGOMA SOUTH,Rural,64,301,378,679,Bungoma,WESTERN,24664
BUNGOMA SOUTH,Rural,65,362,407,769,Bungoma,WESTERN,24665
BUNGOMA SOUTH,Rural,66,271,242,513,Bungoma,WESTERN,24666
BUNGOMA SOUTH,Rural,67,364,477,841,Bungoma,WESTERN,24667
BUNGOMA SOUTH,Rural,68,259,216,475,Bungoma,WESTERN,24668
BUNGOMA SOUTH,Rural,69,211,214,425,Bungoma,WESTERN,24669
BUNGOMA SOUTH,Rural,70,340,394,734,Bungoma,WESTERN,24670
BUNGOMA SOUTH,Rural,71,178,200,378,Bungoma,WESTERN,24671
BUNGOMA SOUTH,Rural,72,207,247,454,Bungoma,WESTERN,24672
BUNGOMA SOUTH,Rural,73,292,269,561,Bungoma,WESTERN,24673
BUNGOMA SOUTH,Rural,74,157,145,302,Bungoma,WESTERN,24674
BUNGOMA SOUTH,Rural,75,243,209,452,Bungoma,WESTERN,24675
BUNGOMA SOUTH,Rural,76,115,150,265,Bungoma,WESTERN,24676
BUNGOMA SOUTH,Rural,77,208,255,463,Bungoma,WESTERN,24677
BUNGOMA SOUTH,Rural,78,100,97,197,Bungoma,WESTERN,24678
BUNGOMA SOUTH,Rural,79,167,203,370,Bungoma,WESTERN,24679
BUNGOMA SOUTH,Rural,80+,1090,1288,2378,Bungoma,WESTERN,24680
BUNGOMA SOUTH,Rural,Age NS,116,105,221,Bungoma,WESTERN,24681
BUNGOMA NORTH,Rural,0,4221,4094,8315,Bungoma,WESTERN,24682
BUNGOMA NORTH,Rural,1,3868,3818,7686,Bungoma,WESTERN,24683
BUNGOMA NORTH,Rural,2,4119,4077,8196,Bungoma,WESTERN,24684
BUNGOMA NORTH,Rural,3,4062,4132,8194,Bungoma,WESTERN,24685
BUNGOMA NORTH,Rural,4,3954,3962,7916,Bungoma,WESTERN,24686
BUNGOMA NORTH,Rural,5,3895,3979,7874,Bungoma,WESTERN,24687
BUNGOMA NORTH,Rural,6,3720,3752,7472,Bungoma,WESTERN,24688
BUNGOMA NORTH,Rural,7,3650,3618,7268,Bungoma,WESTERN,24689
BUNGOMA NORTH,Rural,8,3619,3706,7325,Bungoma,WESTERN,24690
BUNGOMA NORTH,Rural,9,3669,3642,7311,Bungoma,WESTERN,24691
BUNGOMA NORTH,Rural,10,3705,3595,7300,Bungoma,WESTERN,24692
BUNGOMA NORTH,Rural,11,3035,2928,5963,Bungoma,WESTERN,24693
BUNGOMA NORTH,Rural,12,3429,3465,6894,Bungoma,WESTERN,24694
BUNGOMA NORTH,Rural,13,3187,3265,6452,Bungoma,WESTERN,24695
BUNGOMA NORTH,Rural,14,2934,3006,5940,Bungoma,WESTERN,24696
BUNGOMA NORTH,Rural,15,2882,2951,5833,Bungoma,WESTERN,24697
BUNGOMA NORTH,Rural,16,2830,2614,5444,Bungoma,WESTERN,24698
BUNGOMA NORTH,Rural,17,2933,2614,5547,Bungoma,WESTERN,24699
BUNGOMA NORTH,Rural,18,2715,2442,5157,Bungoma,WESTERN,24700
BUNGOMA NORTH,Rural,19,2398,2286,4684,Bungoma,WESTERN,24701
BUNGOMA NORTH,Rural,20,2238,2287,4525,Bungoma,WESTERN,24702
BUNGOMA NORTH,Rural,21,1863,1894,3757,Bungoma,WESTERN,24703
BUNGOMA NORTH,Rural,22,1748,2020,3768,Bungoma,WESTERN,24704
BUNGOMA NORTH,Rural,23,1598,1794,3392,Bungoma,WESTERN,24705
BUNGOMA EAST,Rural,38,557,592,1149,Bungoma,WESTERN,24706
BUNGOMA NORTH,Rural,24,1422,1577,2999,Bungoma,WESTERN,24707
BUNGOMA NORTH,Rural,25,1443,1835,3278,Bungoma,WESTERN,24708
BUNGOMA NORTH,Rural,26,1191,1532,2723,Bungoma,WESTERN,24709
BUNGOMA NORTH,Rural,27,1166,1463,2629,Bungoma,WESTERN,24710
BUNGOMA NORTH,Rural,28,1011,1286,2297,Bungoma,WESTERN,24711
BUNGOMA NORTH,Rural,29,1069,1311,2380,Bungoma,WESTERN,24712
BUNGOMA NORTH,Rural,30,1194,1614,2808,Bungoma,WESTERN,24713
BUNGOMA NORTH,Rural,31,940,1089,2029,Bungoma,WESTERN,24714
BUNGOMA NORTH,Rural,32,1112,1407,2519,Bungoma,WESTERN,24715
BUNGOMA NORTH,Rural,33,946,1174,2120,Bungoma,WESTERN,24716
BUNGOMA NORTH,Rural,34,872,1149,2021,Bungoma,WESTERN,24717
BUNGOMA NORTH,Rural,35,1098,1373,2471,Bungoma,WESTERN,24718
BUNGOMA NORTH,Rural,36,827,1033,1860,Bungoma,WESTERN,24719
BUNGOMA NORTH,Rural,37,829,974,1803,Bungoma,WESTERN,24720
BUNGOMA NORTH,Rural,38,791,934,1725,Bungoma,WESTERN,24721
BUNGOMA NORTH,Rural,39,777,932,1709,Bungoma,WESTERN,24722
BUNGOMA NORTH,Rural,40,1003,1255,2258,Bungoma,WESTERN,24723
BUNGOMA NORTH,Rural,41,709,771,1480,Bungoma,WESTERN,24724
BUNGOMA NORTH,Rural,42,711,818,1529,Bungoma,WESTERN,24725
BUNGOMA NORTH,Rural,43,612,762,1374,Bungoma,WESTERN,24726
BUNGOMA NORTH,Rural,44,591,687,1278,Bungoma,WESTERN,24727
BUNGOMA NORTH,Rural,45,779,969,1748,Bungoma,WESTERN,24728
BUNGOMA NORTH,Rural,46,610,684,1294,Bungoma,WESTERN,24729
BUNGOMA NORTH,Rural,47,572,731,1303,Bungoma,WESTERN,24730
BUNGOMA NORTH,Rural,48,603,654,1257,Bungoma,WESTERN,24731
BUNGOMA NORTH,Rural,49,650,702,1352,Bungoma,WESTERN,24732
BUNGOMA NORTH,Rural,50,674,690,1364,Bungoma,WESTERN,24733
BUNGOMA NORTH,Rural,51,543,506,1049,Bungoma,WESTERN,24734
BUNGOMA NORTH,Rural,52,466,549,1015,Bungoma,WESTERN,24735
BUNGOMA NORTH,Rural,53,440,486,926,Bungoma,WESTERN,24736
BUNGOMA NORTH,Rural,54,463,439,902,Bungoma,WESTERN,24737
BUNGOMA NORTH,Rural,55,491,490,981,Bungoma,WESTERN,24738
BUNGOMA NORTH,Rural,56,366,387,753,Bungoma,WESTERN,24739
BUNGOMA NORTH,Rural,57,399,393,792,Bungoma,WESTERN,24740
BUNGOMA NORTH,Rural,58,253,293,546,Bungoma,WESTERN,24741
BUNGOMA NORTH,Rural,59,339,288,627,Bungoma,WESTERN,24742
BUNGOMA NORTH,Rural,60,329,365,694,Bungoma,WESTERN,24743
BUNGOMA NORTH,Rural,61,244,307,551,Bungoma,WESTERN,24744
BUNGOMA NORTH,Rural,62,216,228,444,Bungoma,WESTERN,24745
BUNGOMA NORTH,Rural,63,220,272,492,Bungoma,WESTERN,24746
BUNGOMA NORTH,Rural,64,197,245,442,Bungoma,WESTERN,24747
BUNGOMA NORTH,Rural,65,226,267,493,Bungoma,WESTERN,24748
BUNGOMA NORTH,Rural,66,143,265,408,Bungoma,WESTERN,24749
BUNGOMA NORTH,Rural,67,212,281,493,Bungoma,WESTERN,24750
BUNGOMA NORTH,Rural,68,150,179,329,Bungoma,WESTERN,24751
BUNGOMA NORTH,Rural,69,135,169,304,Bungoma,WESTERN,24752
BUNGOMA NORTH,Rural,70,203,270,473,Bungoma,WESTERN,24753
BUNGOMA NORTH,Rural,71,118,137,255,Bungoma,WESTERN,24754
BUNGOMA NORTH,Rural,72,147,167,314,Bungoma,WESTERN,24755
BUNGOMA NORTH,Rural,73,168,213,381,Bungoma,WESTERN,24756
BUNGOMA NORTH,Rural,74,98,129,227,Bungoma,WESTERN,24757
BUNGOMA NORTH,Rural,75,159,158,317,Bungoma,WESTERN,24758
BUNGOMA NORTH,Rural,76,128,135,263,Bungoma,WESTERN,24759
BUNGOMA NORTH,Rural,77,152,186,338,Bungoma,WESTERN,24760
BUNGOMA NORTH,Rural,78,98,105,203,Bungoma,WESTERN,24761
BUNGOMA NORTH,Rural,79,104,119,223,Bungoma,WESTERN,24762
BUNGOMA NORTH,Rural,80+,712,765,1477,Bungoma,WESTERN,24763
BUNGOMA NORTH,Rural,Age NS,24,16,40,Bungoma,WESTERN,24764
BUNGOMA EAST,Rural,0,3148,3099,6247,Bungoma,WESTERN,24765
BUNGOMA EAST,Rural,1,2951,2960,5911,Bungoma,WESTERN,24766
BUNGOMA EAST,Rural,2,3330,3206,6536,Bungoma,WESTERN,24767
BUNGOMA EAST,Rural,3,3258,3185,6443,Bungoma,WESTERN,24768
BUNGOMA EAST,Rural,4,3096,3005,6101,Bungoma,WESTERN,24769
BUNGOMA EAST,Rural,5,3248,3078,6326,Bungoma,WESTERN,24770
BUNGOMA EAST,Rural,6,2878,2904,5782,Bungoma,WESTERN,24771
BUNGOMA EAST,Rural,7,2826,2807,5633,Bungoma,WESTERN,24772
BUNGOMA EAST,Rural,8,2663,2533,5196,Bungoma,WESTERN,24773
BUNGOMA EAST,Rural,9,2687,2732,5419,Bungoma,WESTERN,24774
BUNGOMA EAST,Rural,10,2567,2532,5099,Bungoma,WESTERN,24775
BUNGOMA EAST,Rural,11,2173,2202,4375,Bungoma,WESTERN,24776
BUNGOMA EAST,Rural,12,2402,2337,4739,Bungoma,WESTERN,24777
BUNGOMA EAST,Rural,13,2436,2310,4746,Bungoma,WESTERN,24778
BUNGOMA EAST,Rural,14,2066,2072,4138,Bungoma,WESTERN,24779
BUNGOMA EAST,Rural,15,2001,2124,4125,Bungoma,WESTERN,24780
BUNGOMA EAST,Rural,16,1902,2079,3981,Bungoma,WESTERN,24781
BUNGOMA EAST,Rural,17,1991,2270,4261,Bungoma,WESTERN,24782
BUNGOMA EAST,Rural,18,1727,1857,3584,Bungoma,WESTERN,24783
BUNGOMA EAST,Rural,19,1647,1710,3357,Bungoma,WESTERN,24784
BUNGOMA EAST,Rural,20,1591,1738,3329,Bungoma,WESTERN,24785
BUNGOMA EAST,Rural,21,1427,1572,2999,Bungoma,WESTERN,24786
BUNGOMA EAST,Rural,22,1425,1550,2975,Bungoma,WESTERN,24787
BUNGOMA EAST,Rural,23,1253,1413,2666,Bungoma,WESTERN,24788
BUNGOMA EAST,Rural,24,1040,1308,2348,Bungoma,WESTERN,24789
BUNGOMA EAST,Rural,25,1221,1464,2685,Bungoma,WESTERN,24790
BUNGOMA EAST,Rural,26,983,1159,2142,Bungoma,WESTERN,24791
BUNGOMA EAST,Rural,27,1007,1156,2163,Bungoma,WESTERN,24792
BUNGOMA EAST,Rural,28,790,1023,1813,Bungoma,WESTERN,24793
BUNGOMA EAST,Rural,29,900,1039,1939,Bungoma,WESTERN,24794
BUNGOMA EAST,Rural,30,882,1178,2060,Bungoma,WESTERN,24795
BUNGOMA EAST,Rural,31,838,909,1747,Bungoma,WESTERN,24796
BUNGOMA EAST,Rural,32,870,955,1825,Bungoma,WESTERN,24797
BUNGOMA EAST,Rural,33,760,845,1605,Bungoma,WESTERN,24798
BUNGOMA EAST,Rural,34,657,759,1416,Bungoma,WESTERN,24799
BUNGOMA EAST,Rural,35,939,1058,1997,Bungoma,WESTERN,24800
BUNGOMA EAST,Rural,36,685,778,1463,Bungoma,WESTERN,24801
BUNGOMA EAST,Rural,37,641,691,1332,Bungoma,WESTERN,24802
BUNGOMA EAST,Rural,39,561,586,1147,Bungoma,WESTERN,24803
BUNGOMA EAST,Rural,40,674,755,1429,Bungoma,WESTERN,24804
BUNGOMA EAST,Rural,41,566,549,1115,Bungoma,WESTERN,24805
BUNGOMA EAST,Rural,42,477,561,1038,Bungoma,WESTERN,24806
BUNGOMA EAST,Rural,43,404,514,918,Bungoma,WESTERN,24807
BUNGOMA EAST,Rural,44,392,467,859,Bungoma,WESTERN,24808
BUNGOMA EAST,Rural,45,540,621,1161,Bungoma,WESTERN,24809
BUNGOMA EAST,Rural,46,452,482,934,Bungoma,WESTERN,24810
BUNGOMA EAST,Rural,47,483,517,1000,Bungoma,WESTERN,24811
BUNGOMA EAST,Rural,48,375,403,778,Bungoma,WESTERN,24812
BUNGOMA EAST,Rural,49,541,538,1079,Bungoma,WESTERN,24813
BUNGOMA EAST,Rural,50,417,472,889,Bungoma,WESTERN,24814
BUNGOMA EAST,Rural,51,372,452,824,Bungoma,WESTERN,24815
BUNGOMA EAST,Rural,52,351,380,731,Bungoma,WESTERN,24816
BUNGOMA EAST,Rural,53,347,419,766,Bungoma,WESTERN,24817
BUNGOMA EAST,Rural,54,331,365,696,Bungoma,WESTERN,24818
BUNGOMA EAST,Rural,55,341,438,779,Bungoma,WESTERN,24819
BUNGOMA EAST,Rural,56,292,308,600,Bungoma,WESTERN,24820
BUNGOMA EAST,Rural,57,324,375,699,Bungoma,WESTERN,24821
BUNGOMA EAST,Rural,58,197,229,426,Bungoma,WESTERN,24822
BUNGOMA EAST,Rural,59,261,309,570,Bungoma,WESTERN,24823
BUNGOMA EAST,Rural,60,228,289,517,Bungoma,WESTERN,24824
BUNGOMA EAST,Rural,61,242,259,501,Bungoma,WESTERN,24825
BUNGOMA EAST,Rural,62,203,230,433,Bungoma,WESTERN,24826
BUNGOMA EAST,Rural,63,245,247,492,Bungoma,WESTERN,24827
BUNGOMA EAST,Rural,64,200,183,383,Bungoma,WESTERN,24828
BUNGOMA EAST,Rural,65,191,204,395,Bungoma,WESTERN,24829
BUNGOMA EAST,Rural,66,163,164,327,Bungoma,WESTERN,24830
BUNGOMA EAST,Rural,67,199,268,467,Bungoma,WESTERN,24831
BUNGOMA EAST,Rural,68,120,118,238,Bungoma,WESTERN,24832
BUNGOMA EAST,Rural,69,128,153,281,Bungoma,WESTERN,24833
BUNGOMA EAST,Rural,70,199,230,429,Bungoma,WESTERN,24834
BUNGOMA EAST,Rural,71,122,127,249,Bungoma,WESTERN,24835
BUNGOMA EAST,Rural,72,105,130,235,Bungoma,WESTERN,24836
BUNGOMA EAST,Rural,73,168,195,363,Bungoma,WESTERN,24837
BUNGOMA EAST,Rural,74,96,79,175,Bungoma,WESTERN,24838
BUNGOMA EAST,Rural,75,128,136,264,Bungoma,WESTERN,24839
BUNGOMA EAST,Rural,76,66,106,172,Bungoma,WESTERN,24840
BUNGOMA EAST,Rural,77,108,163,271,Bungoma,WESTERN,24841
BUNGOMA EAST,Rural,78,92,74,166,Bungoma,WESTERN,24842
BUNGOMA EAST,Rural,79,108,122,230,Bungoma,WESTERN,24843
BUNGOMA EAST,Rural,80+,567,769,1336,Bungoma,WESTERN,24844
BUNGOMA EAST,Rural,Age NS,22,27,49,Bungoma,WESTERN,24845
BUNGOMA WEST,Rural,0,3939,3869,7808,Bungoma,WESTERN,24846
BUNGOMA WEST,Rural,1,3579,3535,7114,Bungoma,WESTERN,24847
BUNGOMA WEST,Rural,2,3915,4030,7945,Bungoma,WESTERN,24848
BUNGOMA WEST,Rural,3,3840,3833,7673,Bungoma,WESTERN,24849
BUNGOMA WEST,Rural,4,3659,3688,7347,Bungoma,WESTERN,24850
BUNGOMA WEST,Rural,5,3857,3804,7661,Bungoma,WESTERN,24851
BUNGOMA WEST,Rural,6,3481,3689,7170,Bungoma,WESTERN,24852
BUNGOMA WEST,Rural,7,3466,3368,6834,Bungoma,WESTERN,24853
BUNGOMA WEST,Rural,8,3129,3177,6306,Bungoma,WESTERN,24854
BUNGOMA WEST,Rural,9,3366,3299,6665,Bungoma,WESTERN,24855
BUNGOMA WEST,Rural,10,3343,3197,6540,Bungoma,WESTERN,24856
BUNGOMA WEST,Rural,11,2714,2727,5441,Bungoma,WESTERN,24857
BUNGOMA WEST,Rural,12,2905,2937,5842,Bungoma,WESTERN,24858
BUNGOMA WEST,Rural,13,2913,2780,5693,Bungoma,WESTERN,24859
BUNGOMA WEST,Rural,14,2586,2443,5029,Bungoma,WESTERN,24860
BUNGOMA WEST,Rural,15,2542,2555,5097,Bungoma,WESTERN,24861
BUNGOMA WEST,Rural,16,2308,2439,4747,Bungoma,WESTERN,24862
BUNGOMA WEST,Rural,17,2617,2604,5221,Bungoma,WESTERN,24863
BUNGOMA WEST,Rural,18,2219,2254,4473,Bungoma,WESTERN,24864
BUNGOMA WEST,Rural,19,2186,2123,4309,Bungoma,WESTERN,24865
BUNGOMA WEST,Rural,20,1962,2335,4297,Bungoma,WESTERN,24866
BUNGOMA WEST,Rural,21,1856,1943,3799,Bungoma,WESTERN,24867
BUNGOMA WEST,Rural,22,1807,2032,3839,Bungoma,WESTERN,24868
BUNGOMA WEST,Rural,23,1681,1762,3443,Bungoma,WESTERN,24869
BUNGOMA WEST,Rural,24,1457,1615,3072,Bungoma,WESTERN,24870
BUNGOMA WEST,Rural,25,1560,1847,3407,Bungoma,WESTERN,24871
BUNGOMA WEST,Rural,26,1210,1397,2607,Bungoma,WESTERN,24872
BUNGOMA WEST,Rural,27,1324,1423,2747,Bungoma,WESTERN,24873
BUNGOMA WEST,Rural,28,976,1172,2148,Bungoma,WESTERN,24874
BUNGOMA WEST,Rural,29,1132,1197,2329,Bungoma,WESTERN,24875
BUNGOMA WEST,Rural,30,1204,1425,2629,Bungoma,WESTERN,24876
BUNGOMA WEST,Rural,31,1050,1156,2206,Bungoma,WESTERN,24877
BUNGOMA WEST,Rural,32,1035,1221,2256,Bungoma,WESTERN,24878
BUNGOMA WEST,Rural,33,1069,1131,2200,Bungoma,WESTERN,24879
BUNGOMA WEST,Rural,34,888,970,1858,Bungoma,WESTERN,24880
BUNGOMA WEST,Rural,35,1229,1244,2473,Bungoma,WESTERN,24881
BUNGOMA WEST,Rural,36,795,904,1699,Bungoma,WESTERN,24882
BUNGOMA WEST,Rural,37,904,901,1805,Bungoma,WESTERN,24883
BUNGOMA WEST,Rural,38,672,729,1401,Bungoma,WESTERN,24884
BUNGOMA WEST,Rural,39,726,744,1470,Bungoma,WESTERN,24885
BUNGOMA WEST,Rural,40,846,991,1837,Bungoma,WESTERN,24886
BUNGOMA WEST,Rural,41,668,702,1370,Bungoma,WESTERN,24887
BUNGOMA WEST,Rural,42,612,713,1325,Bungoma,WESTERN,24888
BUNGOMA WEST,Rural,43,602,650,1252,Bungoma,WESTERN,24889
BUNGOMA WEST,Rural,44,509,577,1086,Bungoma,WESTERN,24890
BUNGOMA WEST,Rural,45,724,853,1577,Bungoma,WESTERN,24891
BUNGOMA WEST,Rural,46,532,609,1141,Bungoma,WESTERN,24892
BUNGOMA WEST,Rural,47,581,763,1344,Bungoma,WESTERN,24893
BUNGOMA WEST,Rural,48,489,555,1044,Bungoma,WESTERN,24894
BUNGOMA WEST,Rural,49,677,700,1377,Bungoma,WESTERN,24895
BUNGOMA WEST,Rural,50,528,664,1192,Bungoma,WESTERN,24896
BUNGOMA WEST,Rural,51,504,597,1101,Bungoma,WESTERN,24897
BUNGOMA WEST,Rural,52,416,441,857,Bungoma,WESTERN,24898
BUNGOMA WEST,Rural,53,473,556,1029,Bungoma,WESTERN,24899
BUNGOMA WEST,Rural,54,387,445,832,Bungoma,WESTERN,24900
BUNGOMA WEST,Rural,55,454,558,1012,Bungoma,WESTERN,24901
BUNGOMA WEST,Rural,56,333,431,764,Bungoma,WESTERN,24902
BUNGOMA WEST,Rural,57,408,489,897,Bungoma,WESTERN,24903
BUNGOMA WEST,Rural,58,243,261,504,Bungoma,WESTERN,24904
BUNGOMA WEST,Rural,59,357,424,781,Bungoma,WESTERN,24905
BUNGOMA WEST,Rural,60,328,357,685,Bungoma,WESTERN,24906
BUNGOMA WEST,Rural,61,320,378,698,Bungoma,WESTERN,24907
BUNGOMA WEST,Rural,62,233,268,501,Bungoma,WESTERN,24908
BUNGOMA WEST,Rural,63,306,329,635,Bungoma,WESTERN,24909
BUNGOMA WEST,Rural,64,259,282,541,Bungoma,WESTERN,24910
BUNGOMA WEST,Rural,65,268,289,557,Bungoma,WESTERN,24911
BUNGOMA WEST,Rural,66,181,217,398,Bungoma,WESTERN,24912
BUNGOMA WEST,Rural,67,260,372,632,Bungoma,WESTERN,24913
BUNGOMA WEST,Rural,68,148,160,308,Bungoma,WESTERN,24914
BUNGOMA WEST,Rural,69,169,201,370,Bungoma,WESTERN,24915
BUNGOMA WEST,Rural,70,230,305,535,Bungoma,WESTERN,24916
BUNGOMA WEST,Rural,71,161,165,326,Bungoma,WESTERN,24917
BUNGOMA WEST,Rural,72,132,198,330,Bungoma,WESTERN,24918
BUNGOMA WEST,Rural,73,164,249,413,Bungoma,WESTERN,24919
BUNGOMA WEST,Rural,74,124,136,260,Bungoma,WESTERN,24920
BUNGOMA WEST,Rural,75,170,197,367,Bungoma,WESTERN,24921
BUNGOMA WEST,Rural,76,84,134,218,Bungoma,WESTERN,24922
BUNGOMA WEST,Rural,77,168,208,376,Bungoma,WESTERN,24923
BUNGOMA WEST,Rural,78,83,74,157,Bungoma,WESTERN,24924
BUNGOMA WEST,Rural,79,124,167,291,Bungoma,WESTERN,24925
BUNGOMA WEST,Rural,80+,737,966,1703,Bungoma,WESTERN,24926
BUNGOMA WEST,Rural,Age NS,36,27,63,Bungoma,WESTERN,24927
MT. ELGON,Rural,0,3126,3030,6156,Bungoma,WESTERN,24928
MT. ELGON,Rural,1,2834,2729,5563,Bungoma,WESTERN,24929
MT. ELGON,Rural,2,3240,3206,6446,Bungoma,WESTERN,24930
MT. ELGON,Rural,3,3315,3247,6562,Bungoma,WESTERN,24931
MT. ELGON,Rural,4,3120,2922,6042,Bungoma,WESTERN,24932
MT. ELGON,Rural,5,3158,2962,6120,Bungoma,WESTERN,24933
MT. ELGON,Rural,6,3031,2874,5905,Bungoma,WESTERN,24934
MT. ELGON,Rural,7,2752,2729,5481,Bungoma,WESTERN,24935
MT. ELGON,Rural,8,2643,2657,5300,Bungoma,WESTERN,24936
MT. ELGON,Rural,9,2850,2636,5486,Bungoma,WESTERN,24937
MT. ELGON,Rural,10,2646,2565,5211,Bungoma,WESTERN,24938
MT. ELGON,Rural,11,2052,2087,4139,Bungoma,WESTERN,24939
MT. ELGON,Rural,12,2417,2202,4619,Bungoma,WESTERN,24940
MT. ELGON,Rural,13,2147,2186,4333,Bungoma,WESTERN,24941
MT. ELGON,Rural,14,2011,1888,3899,Bungoma,WESTERN,24942
MT. ELGON,Rural,15,2044,1857,3901,Bungoma,WESTERN,24943
MT. ELGON,Rural,16,1804,1656,3460,Bungoma,WESTERN,24944
MT. ELGON,Rural,17,2155,1938,4093,Bungoma,WESTERN,24945
MT. ELGON,Rural,18,1755,1679,3434,Bungoma,WESTERN,24946
MT. ELGON,Rural,19,1839,1742,3581,Bungoma,WESTERN,24947
MT. ELGON,Rural,20,1677,1818,3495,Bungoma,WESTERN,24948
MT. ELGON,Rural,21,1369,1515,2884,Bungoma,WESTERN,24949
MT. ELGON,Rural,22,1552,1647,3199,Bungoma,WESTERN,24950
MT. ELGON,Rural,23,1339,1506,2845,Bungoma,WESTERN,24951
MT. ELGON,Rural,24,1306,1255,2561,Bungoma,WESTERN,24952
MT. ELGON,Rural,25,1483,1398,2881,Bungoma,WESTERN,24953
MT. ELGON,Rural,26,1052,1034,2086,Bungoma,WESTERN,24954
MT. ELGON,Rural,27,1096,1059,2155,Bungoma,WESTERN,24955
MT. ELGON,Rural,28,778,814,1592,Bungoma,WESTERN,24956
MT. ELGON,Rural,29,892,810,1702,Bungoma,WESTERN,24957
MT. ELGON,Rural,30,957,1033,1990,Bungoma,WESTERN,24958
MT. ELGON,Rural,31,841,825,1666,Bungoma,WESTERN,24959
MT. ELGON,Rural,32,852,891,1743,Bungoma,WESTERN,24960
MT. ELGON,Rural,33,684,715,1399,Bungoma,WESTERN,24961
MT. ELGON,Rural,34,592,605,1197,Bungoma,WESTERN,24962
MT. ELGON,Rural,35,965,900,1865,Bungoma,WESTERN,24963
MT. ELGON,Rural,36,700,622,1322,Bungoma,WESTERN,24964
MT. ELGON,Rural,37,645,691,1336,Bungoma,WESTERN,24965
MT. ELGON,Rural,38,482,462,944,Bungoma,WESTERN,24966
MT. ELGON,Rural,39,503,485,988,Bungoma,WESTERN,24967
MT. ELGON,Rural,40,592,704,1296,Bungoma,WESTERN,24968
MT. ELGON,Rural,41,451,467,918,Bungoma,WESTERN,24969
MT. ELGON,Rural,42,420,484,904,Bungoma,WESTERN,24970
MT. ELGON,Rural,43,406,491,897,Bungoma,WESTERN,24971
MT. ELGON,Rural,44,387,428,815,Bungoma,WESTERN,24972
MT. ELGON,Rural,45,511,642,1153,Bungoma,WESTERN,24973
MT. ELGON,Rural,46,451,523,974,Bungoma,WESTERN,24974
MT. ELGON,Rural,47,442,499,941,Bungoma,WESTERN,24975
MT. ELGON,Rural,48,344,396,740,Bungoma,WESTERN,24976
MT. ELGON,Rural,49,545,512,1057,Bungoma,WESTERN,24977
MT. ELGON,Rural,50,414,442,856,Bungoma,WESTERN,24978
MT. ELGON,Rural,51,329,378,707,Bungoma,WESTERN,24979
MT. ELGON,Rural,52,314,335,649,Bungoma,WESTERN,24980
MT. ELGON,Rural,53,300,360,660,Bungoma,WESTERN,24981
MT. ELGON,Rural,54,271,333,604,Bungoma,WESTERN,24982
MT. ELGON,Rural,55,334,430,764,Bungoma,WESTERN,24983
MT. ELGON,Rural,56,210,260,470,Bungoma,WESTERN,24984
MT. ELGON,Rural,57,307,335,642,Bungoma,WESTERN,24985
MT. ELGON,Rural,58,137,171,308,Bungoma,WESTERN,24986
MT. ELGON,Rural,59,252,239,491,Bungoma,WESTERN,24987
MT. ELGON,Rural,60,224,243,467,Bungoma,WESTERN,24988
MT. ELGON,Rural,61,190,264,454,Bungoma,WESTERN,24989
MT. ELGON,Rural,62,148,161,309,Bungoma,WESTERN,24990
MT. ELGON,Rural,63,201,199,400,Bungoma,WESTERN,24991
MT. ELGON,Rural,64,156,166,322,Bungoma,WESTERN,24992
MT. ELGON,Rural,65,189,221,410,Bungoma,WESTERN,24993
MT. ELGON,Rural,66,104,142,246,Bungoma,WESTERN,24994
MT. ELGON,Rural,67,199,255,454,Bungoma,WESTERN,24995
MT. ELGON,Rural,68,80,103,183,Bungoma,WESTERN,24996
MT. ELGON,Rural,69,125,147,272,Bungoma,WESTERN,24997
MT. ELGON,Rural,70,124,157,281,Bungoma,WESTERN,24998
MT. ELGON,Rural,71,105,104,209,Bungoma,WESTERN,24999
MT. ELGON,Rural,72,101,108,209,Bungoma,WESTERN,25000
MT. ELGON,Rural,73,130,156,286,Bungoma,WESTERN,25001
MT. ELGON,Rural,74,81,79,160,Bungoma,WESTERN,25002
MT. ELGON,Rural,75,77,103,180,Bungoma,WESTERN,25003
MT. ELGON,Rural,76,50,93,143,Bungoma,WESTERN,25004
MT. ELGON,Rural,77,94,108,202,Bungoma,WESTERN,25005
MT. ELGON,Rural,78,49,62,111,Bungoma,WESTERN,25006
MT. ELGON,Rural,79,75,117,192,Bungoma,WESTERN,25007
MT. ELGON,Rural,80+,575,747,1322,Bungoma,WESTERN,25008
MT. ELGON,Rural,Age NS,34,27,61,Bungoma,WESTERN,25009
BUSIA,Rural,0,5273,5201,10474,Busia,WESTERN,25010
BUSIA,Rural,1,4661,4634,9295,Busia,WESTERN,25011
BUSIA,Rural,2,5355,5287,10642,Busia,WESTERN,25012
BUSIA,Rural,3,5153,5319,10472,Busia,WESTERN,25013
BUSIA,Rural,4,4993,4918,9911,Busia,WESTERN,25014
BUSIA,Rural,5,5167,5154,10321,Busia,WESTERN,25015
BUSIA,Rural,6,4728,4731,9459,Busia,WESTERN,25016
BUSIA,Rural,7,4414,4565,8979,Busia,WESTERN,25017
BUSIA,Rural,8,4255,4421,8676,Busia,WESTERN,25018
BUSIA,Rural,9,4420,4440,8860,Busia,WESTERN,25019
BUSIA,Rural,10,4900,4815,9715,Busia,WESTERN,25020
BUSIA,Rural,11,3597,3707,7304,Busia,WESTERN,25021
BUSIA,Rural,12,4620,4565,9185,Busia,WESTERN,25022
BUSIA,Rural,13,4102,4087,8189,Busia,WESTERN,25023
BUSIA,Rural,14,3851,3723,7574,Busia,WESTERN,25024
BUSIA,Rural,15,3790,3696,7486,Busia,WESTERN,25025
BUSIA,Rural,16,3551,3391,6942,Busia,WESTERN,25026
BUSIA,Rural,17,3721,3321,7042,Busia,WESTERN,25027
BUSIA,Rural,18,3362,3139,6501,Busia,WESTERN,25028
BUSIA,Rural,19,2595,2776,5371,Busia,WESTERN,25029
BUSIA,Rural,20,2824,3436,6260,Busia,WESTERN,25030
BUSIA,Rural,21,1873,2273,4146,Busia,WESTERN,25031
BUSIA,Rural,22,2048,2703,4751,Busia,WESTERN,25032
BUSIA,Rural,23,1753,2340,4093,Busia,WESTERN,25033
BUSIA,Rural,24,1609,2217,3826,Busia,WESTERN,25034
BUSIA,Rural,25,1844,2507,4351,Busia,WESTERN,25035
BUSIA,Rural,26,1357,1883,3240,Busia,WESTERN,25036
BUSIA,Rural,27,1490,1868,3358,Busia,WESTERN,25037
BUSIA,Rural,28,1259,1760,3019,Busia,WESTERN,25038
BUSIA,Rural,29,1167,1512,2679,Busia,WESTERN,25039
BUSIA,Rural,30,1701,2418,4119,Busia,WESTERN,25040
BUSIA,Rural,31,1070,1340,2410,Busia,WESTERN,25041
BUSIA,Rural,32,1298,1729,3027,Busia,WESTERN,25042
BUSIA,Rural,33,956,1204,2160,Busia,WESTERN,25043
BUSIA,Rural,34,1028,1268,2296,Busia,WESTERN,25044
BUSIA,Rural,35,1457,2022,3479,Busia,WESTERN,25045
BUSIA,Rural,36,867,1080,1947,Busia,WESTERN,25046
BUSIA,Rural,37,916,1108,2024,Busia,WESTERN,25047
BUSIA,Rural,38,803,1141,1944,Busia,WESTERN,25048
BUSIA,Rural,39,773,1070,1843,Busia,WESTERN,25049
BUSIA,Rural,40,1243,1917,3160,Busia,WESTERN,25050
BUSIA,Rural,41,757,907,1664,Busia,WESTERN,25051
BUSIA,Rural,42,694,929,1623,Busia,WESTERN,25052
BUSIA,Rural,43,609,857,1466,Busia,WESTERN,25053
BUSIA,Rural,44,644,787,1431,Busia,WESTERN,25054
BUSIA,Rural,45,971,1318,2289,Busia,WESTERN,25055
BUSIA,Rural,46,653,899,1552,Busia,WESTERN,25056
BUSIA,Rural,47,713,955,1668,Busia,WESTERN,25057
BUSIA,Rural,48,592,776,1368,Busia,WESTERN,25058
BUSIA,Rural,49,658,830,1488,Busia,WESTERN,25059
BUSIA,Rural,50,922,1391,2313,Busia,WESTERN,25060
BUSIA,Rural,51,560,667,1227,Busia,WESTERN,25061
BUSIA,Rural,52,561,667,1228,Busia,WESTERN,25062
BUSIA,Rural,53,486,623,1109,Busia,WESTERN,25063
BUSIA,Rural,54,467,644,1111,Busia,WESTERN,25064
BUSIA,Rural,55,631,775,1406,Busia,WESTERN,25065
BUSIA,Rural,56,468,573,1041,Busia,WESTERN,25066
BUSIA,Rural,57,608,683,1291,Busia,WESTERN,25067
BUSIA,Rural,58,327,370,697,Busia,WESTERN,25068
BUSIA,Rural,59,413,574,987,Busia,WESTERN,25069
BUSIA,Rural,60,672,939,1611,Busia,WESTERN,25070
BUSIA,Rural,61,397,485,882,Busia,WESTERN,25071
BUSIA,Rural,62,328,361,689,Busia,WESTERN,25072
BUSIA,Rural,63,324,354,678,Busia,WESTERN,25073
BUSIA,Rural,64,322,454,776,Busia,WESTERN,25074
BUSIA,Rural,65,399,507,906,Busia,WESTERN,25075
BUSIA,Rural,66,223,253,476,Busia,WESTERN,25076
BUSIA,Rural,67,347,461,808,Busia,WESTERN,25077
BUSIA,Rural,68,215,248,463,Busia,WESTERN,25078
BUSIA,Rural,69,273,401,674,Busia,WESTERN,25079
BUSIA,Rural,70,399,597,996,Busia,WESTERN,25080
BUSIA,Rural,71,244,248,492,Busia,WESTERN,25081
BUSIA,Rural,72,242,289,531,Busia,WESTERN,25082
BUSIA,Rural,73,265,249,514,Busia,WESTERN,25083
BUSIA,Rural,74,198,236,434,Busia,WESTERN,25084
BUSIA,Rural,75,224,295,519,Busia,WESTERN,25085
BUSIA,Rural,76,231,253,484,Busia,WESTERN,25086
BUSIA,Rural,77,242,268,510,Busia,WESTERN,25087
BUSIA,Rural,78,157,189,346,Busia,WESTERN,25088
BUSIA,Rural,79,188,275,463,Busia,WESTERN,25089
BUSIA,Rural,80+,1164,1462,2626,Busia,WESTERN,25090
BUSIA,Rural,Age NS,73,74,147,Busia,WESTERN,25091
TESO NORTH,Rural,0,1315,1288,2603,Busia,WESTERN,25092
TESO NORTH,Rural,1,1196,1207,2403,Busia,WESTERN,25093
TESO NORTH,Rural,2,1340,1318,2658,Busia,WESTERN,25094
TESO NORTH,Rural,3,1291,1265,2556,Busia,WESTERN,25095
TESO NORTH,Rural,4,1323,1272,2595,Busia,WESTERN,25096
TESO NORTH,Rural,5,1166,1214,2380,Busia,WESTERN,25097
TESO NORTH,Rural,6,1212,1164,2376,Busia,WESTERN,25098
TESO NORTH,Rural,7,1147,1197,2344,Busia,WESTERN,25099
TESO NORTH,Rural,8,1109,1187,2296,Busia,WESTERN,25100
TESO NORTH,Rural,9,1165,1181,2346,Busia,WESTERN,25101
TESO NORTH,Rural,10,1155,1263,2418,Busia,WESTERN,25102
TESO NORTH,Rural,11,989,1004,1993,Busia,WESTERN,25103
TESO NORTH,Rural,12,1062,1141,2203,Busia,WESTERN,25104
TESO NORTH,Rural,13,1046,1122,2168,Busia,WESTERN,25105
TESO NORTH,Rural,14,970,1017,1987,Busia,WESTERN,25106
TESO NORTH,Rural,15,1017,996,2013,Busia,WESTERN,25107
TESO NORTH,Rural,16,857,900,1757,Busia,WESTERN,25108
TESO NORTH,Rural,17,950,890,1840,Busia,WESTERN,25109
TESO NORTH,Rural,18,871,797,1668,Busia,WESTERN,25110
TESO NORTH,Rural,19,816,735,1551,Busia,WESTERN,25111
TESO NORTH,Rural,20,730,834,1564,Busia,WESTERN,25112
TESO NORTH,Rural,21,646,703,1349,Busia,WESTERN,25113
TESO NORTH,Rural,22,663,767,1430,Busia,WESTERN,25114
TESO NORTH,Rural,23,601,653,1254,Busia,WESTERN,25115
TESO NORTH,Rural,24,533,539,1072,Busia,WESTERN,25116
TESO NORTH,Rural,25,532,661,1193,Busia,WESTERN,25117
TESO NORTH,Rural,26,419,461,880,Busia,WESTERN,25118
TESO NORTH,Rural,27,423,483,906,Busia,WESTERN,25119
TESO NORTH,Rural,28,344,357,701,Busia,WESTERN,25120
TESO NORTH,Rural,29,392,362,754,Busia,WESTERN,25121
TESO NORTH,Rural,30,397,458,855,Busia,WESTERN,25122
TESO NORTH,Rural,31,344,415,759,Busia,WESTERN,25123
TESO NORTH,Rural,32,344,406,750,Busia,WESTERN,25124
TESO NORTH,Rural,33,343,356,699,Busia,WESTERN,25125
TESO NORTH,Rural,34,317,309,626,Busia,WESTERN,25126
TESO NORTH,Rural,35,412,429,841,Busia,WESTERN,25127
TESO NORTH,Rural,36,252,265,517,Busia,WESTERN,25128
TESO NORTH,Rural,37,258,300,558,Busia,WESTERN,25129
TESO NORTH,Rural,38,194,211,405,Busia,WESTERN,25130
TESO NORTH,Rural,39,245,229,474,Busia,WESTERN,25131
TESO NORTH,Rural,40,284,371,655,Busia,WESTERN,25132
TESO NORTH,Rural,41,183,214,397,Busia,WESTERN,25133
TESO NORTH,Rural,42,169,214,383,Busia,WESTERN,25134
TESO NORTH,Rural,43,157,216,373,Busia,WESTERN,25135
TESO NORTH,Rural,44,150,212,362,Busia,WESTERN,25136
TESO NORTH,Rural,45,219,279,498,Busia,WESTERN,25137
TESO NORTH,Rural,46,172,234,406,Busia,WESTERN,25138
TESO NORTH,Rural,47,176,298,474,Busia,WESTERN,25139
TESO NORTH,Rural,48,162,202,364,Busia,WESTERN,25140
TESO NORTH,Rural,49,233,229,462,Busia,WESTERN,25141
TESO NORTH,Rural,50,212,232,444,Busia,WESTERN,25142
TESO NORTH,Rural,51,177,196,373,Busia,WESTERN,25143
TESO NORTH,Rural,52,150,170,320,Busia,WESTERN,25144
TESO NORTH,Rural,53,168,188,356,Busia,WESTERN,25145
TESO NORTH,Rural,54,121,173,294,Busia,WESTERN,25146
TESO NORTH,Rural,55,137,204,341,Busia,WESTERN,25147
TESO NORTH,Rural,56,106,136,242,Busia,WESTERN,25148
TESO NORTH,Rural,57,123,180,303,Busia,WESTERN,25149
TESO NORTH,Rural,58,68,73,141,Busia,WESTERN,25150
TESO NORTH,Rural,59,157,138,295,Busia,WESTERN,25151
TESO NORTH,Rural,60,138,139,277,Busia,WESTERN,25152
TESO NORTH,Rural,61,106,160,266,Busia,WESTERN,25153
TESO NORTH,Rural,62,74,83,157,Busia,WESTERN,25154
TESO NORTH,Rural,63,91,97,188,Busia,WESTERN,25155
TESO NORTH,Rural,64,94,126,220,Busia,WESTERN,25156
TESO NORTH,Rural,65,78,108,186,Busia,WESTERN,25157
TESO NORTH,Rural,66,56,49,105,Busia,WESTERN,25158
TESO NORTH,Rural,67,128,110,238,Busia,WESTERN,25159
TESO NORTH,Rural,68,38,46,84,Busia,WESTERN,25160
TESO NORTH,Rural,69,64,84,148,Busia,WESTERN,25161
TESO NORTH,Rural,70,85,81,166,Busia,WESTERN,25162
TESO NORTH,Rural,71,64,74,138,Busia,WESTERN,25163
TESO NORTH,Rural,72,52,40,92,Busia,WESTERN,25164
TESO NORTH,Rural,73,65,75,140,Busia,WESTERN,25165
TESO NORTH,Rural,74,45,50,95,Busia,WESTERN,25166
TESO NORTH,Rural,75,32,49,81,Busia,WESTERN,25167
TESO NORTH,Rural,76,58,48,106,Busia,WESTERN,25168
TESO NORTH,Rural,77,87,65,152,Busia,WESTERN,25169
TESO NORTH,Rural,78,31,40,71,Busia,WESTERN,25170
TESO NORTH,Rural,79,40,67,107,Busia,WESTERN,25171
TESO NORTH,Rural,80+,257,292,549,Busia,WESTERN,25172
TESO NORTH,Rural,Age NS,10,17,27,Busia,WESTERN,25173
SAMIA,Rural,0,1609,1628,3237,Busia,WESTERN,25174
SAMIA,Rural,1,1475,1537,3012,Busia,WESTERN,25175
SAMIA,Rural,2,1620,1688,3308,Busia,WESTERN,25176
SAMIA,Rural,3,1619,1623,3242,Busia,WESTERN,25177
SAMIA,Rural,4,1611,1641,3252,Busia,WESTERN,25178
SAMIA,Rural,5,1634,1639,3273,Busia,WESTERN,25179
SAMIA,Rural,6,1522,1524,3046,Busia,WESTERN,25180
SAMIA,Rural,7,1503,1418,2921,Busia,WESTERN,25181
SAMIA,Rural,8,1276,1329,2605,Busia,WESTERN,25182
SAMIA,Rural,9,1463,1469,2932,Busia,WESTERN,25183
SAMIA,Rural,10,1526,1577,3103,Busia,WESTERN,25184
SAMIA,Rural,11,1152,1185,2337,Busia,WESTERN,25185
SAMIA,Rural,12,1480,1479,2959,Busia,WESTERN,25186
SAMIA,Rural,13,1403,1343,2746,Busia,WESTERN,25187
SAMIA,Rural,14,1349,1230,2579,Busia,WESTERN,25188
SAMIA,Rural,15,1300,1292,2592,Busia,WESTERN,25189
SAMIA,Rural,16,1175,1081,2256,Busia,WESTERN,25190
SAMIA,Rural,17,1256,1057,2313,Busia,WESTERN,25191
SAMIA,Rural,18,1033,1070,2103,Busia,WESTERN,25192
SAMIA,Rural,19,818,874,1692,Busia,WESTERN,25193
SAMIA,Rural,20,938,1172,2110,Busia,WESTERN,25194
SAMIA,Rural,21,634,745,1379,Busia,WESTERN,25195
SAMIA,Rural,22,723,982,1705,Busia,WESTERN,25196
SAMIA,Rural,23,636,793,1429,Busia,WESTERN,25197
SAMIA,Rural,24,591,754,1345,Busia,WESTERN,25198
SAMIA,Rural,25,627,829,1456,Busia,WESTERN,25199
SAMIA,Rural,26,497,608,1105,Busia,WESTERN,25200
SAMIA,Rural,27,529,599,1128,Busia,WESTERN,25201
SAMIA,Rural,28,405,542,947,Busia,WESTERN,25202
SAMIA,Rural,29,402,438,840,Busia,WESTERN,25203
SAMIA,Rural,30,505,802,1307,Busia,WESTERN,25204
SAMIA,Rural,31,385,422,807,Busia,WESTERN,25205
SAMIA,Rural,32,435,558,993,Busia,WESTERN,25206
SAMIA,Rural,33,326,345,671,Busia,WESTERN,25207
SAMIA,Rural,34,347,373,720,Busia,WESTERN,25208
SAMIA,Rural,35,471,609,1080,Busia,WESTERN,25209
SAMIA,Rural,36,322,394,716,Busia,WESTERN,25210
SAMIA,Rural,37,312,366,678,Busia,WESTERN,25211
SAMIA,Rural,38,258,375,633,Busia,WESTERN,25212
SAMIA,Rural,39,227,309,536,Busia,WESTERN,25213
SAMIA,Rural,40,398,675,1073,Busia,WESTERN,25214
SAMIA,Rural,41,271,269,540,Busia,WESTERN,25215
SAMIA,Rural,42,246,321,567,Busia,WESTERN,25216
SAMIA,Rural,43,193,254,447,Busia,WESTERN,25217
SAMIA,Rural,44,209,222,431,Busia,WESTERN,25218
SAMIA,Rural,45,317,475,792,Busia,WESTERN,25219
SAMIA,Rural,46,216,264,480,Busia,WESTERN,25220
SAMIA,Rural,47,263,381,644,Busia,WESTERN,25221
SAMIA,Rural,48,199,311,510,Busia,WESTERN,25222
SAMIA,Rural,49,250,292,542,Busia,WESTERN,25223
SAMIA,Rural,50,310,494,804,Busia,WESTERN,25224
SAMIA,Rural,51,187,241,428,Busia,WESTERN,25225
SAMIA,Rural,52,201,256,457,Busia,WESTERN,25226
SAMIA,Rural,53,153,218,371,Busia,WESTERN,25227
SAMIA,Rural,54,192,235,427,Busia,WESTERN,25228
SAMIA,Rural,55,207,283,490,Busia,WESTERN,25229
SAMIA,Rural,56,160,226,386,Busia,WESTERN,25230
SAMIA,Rural,57,206,258,464,Busia,WESTERN,25231
SAMIA,Rural,58,112,120,232,Busia,WESTERN,25232
SAMIA,Rural,59,147,201,348,Busia,WESTERN,25233
SAMIA,Rural,60,211,380,591,Busia,WESTERN,25234
SAMIA,Rural,61,137,173,310,Busia,WESTERN,25235
SAMIA,Rural,62,119,134,253,Busia,WESTERN,25236
SAMIA,Rural,63,110,121,231,Busia,WESTERN,25237
SAMIA,Rural,64,128,184,312,Busia,WESTERN,25238
SAMIA,Rural,65,132,185,317,Busia,WESTERN,25239
SAMIA,Rural,66,73,94,167,Busia,WESTERN,25240
SAMIA,Rural,67,138,161,299,Busia,WESTERN,25241
SAMIA,Rural,68,65,83,148,Busia,WESTERN,25242
SAMIA,Rural,69,83,149,232,Busia,WESTERN,25243
SAMIA,Rural,70,129,289,418,Busia,WESTERN,25244
SAMIA,Rural,71,92,121,213,Busia,WESTERN,25245
SAMIA,Rural,72,80,95,175,Busia,WESTERN,25246
SAMIA,Rural,73,68,82,150,Busia,WESTERN,25247
SAMIA,Rural,74,65,109,174,Busia,WESTERN,25248
SAMIA,Rural,75,87,118,205,Busia,WESTERN,25249
SAMIA,Rural,76,75,101,176,Busia,WESTERN,25250
SAMIA,Rural,77,65,95,160,Busia,WESTERN,25251
SAMIA,Rural,78,52,78,130,Busia,WESTERN,25252
SAMIA,Rural,79,68,138,206,Busia,WESTERN,25253
SAMIA,Rural,80+,441,631,1072,Busia,WESTERN,25254
SAMIA,Rural,Age NS,18,17,35,Busia,WESTERN,25255
BUNYALA,Rural,0,1060,1146,2206,Busia,WESTERN,25256
BUNYALA,Rural,1,1052,1073,2125,Busia,WESTERN,25257
BUNYALA,Rural,2,1080,1125,2205,Busia,WESTERN,25258
BUNYALA,Rural,3,1141,1059,2200,Busia,WESTERN,25259
BUNYALA,Rural,4,1113,1008,2121,Busia,WESTERN,25260
BUNYALA,Rural,5,1052,1052,2104,Busia,WESTERN,25261
BUNYALA,Rural,6,952,951,1903,Busia,WESTERN,25262
BUNYALA,Rural,7,934,945,1879,Busia,WESTERN,25263
BUNYALA,Rural,8,811,871,1682,Busia,WESTERN,25264
BUNYALA,Rural,9,818,841,1659,Busia,WESTERN,25265
BUNYALA,Rural,10,875,918,1793,Busia,WESTERN,25266
BUNYALA,Rural,11,639,672,1311,Busia,WESTERN,25267
BUNYALA,Rural,12,881,786,1667,Busia,WESTERN,25268
BUNYALA,Rural,13,789,730,1519,Busia,WESTERN,25269
BUNYALA,Rural,14,722,667,1389,Busia,WESTERN,25270
BUNYALA,Rural,15,717,708,1425,Busia,WESTERN,25271
BUNYALA,Rural,16,653,628,1281,Busia,WESTERN,25272
BUNYALA,Rural,17,730,632,1362,Busia,WESTERN,25273
BUNYALA,Rural,18,661,575,1236,Busia,WESTERN,25274
BUNYALA,Rural,19,553,603,1156,Busia,WESTERN,25275
BUNYALA,Rural,20,570,805,1375,Busia,WESTERN,25276
BUNYALA,Rural,21,465,535,1000,Busia,WESTERN,25277
BUNYALA,Rural,22,512,655,1167,Busia,WESTERN,25278
BUNYALA,Rural,23,500,577,1077,Busia,WESTERN,25279
BUNYALA,Rural,24,434,513,947,Busia,WESTERN,25280
BUNYALA,Rural,25,520,569,1089,Busia,WESTERN,25281
BUNYALA,Rural,26,399,458,857,Busia,WESTERN,25282
BUNYALA,Rural,27,395,454,849,Busia,WESTERN,25283
BUNYALA,Rural,28,329,373,702,Busia,WESTERN,25284
BUNYALA,Rural,29,307,371,678,Busia,WESTERN,25285
BUNYALA,Rural,30,454,567,1021,Busia,WESTERN,25286
BUNYALA,Rural,31,268,240,508,Busia,WESTERN,25287
BUNYALA,Rural,32,325,372,697,Busia,WESTERN,25288
BUNYALA,Rural,33,243,247,490,Busia,WESTERN,25289
BUNYALA,Rural,34,250,253,503,Busia,WESTERN,25290
BUNYALA,Rural,35,358,422,780,Busia,WESTERN,25291
BUNYALA,Rural,36,215,204,419,Busia,WESTERN,25292
BUNYALA,Rural,37,190,213,403,Busia,WESTERN,25293
BUNYALA,Rural,38,183,192,375,Busia,WESTERN,25294
BUNYALA,Rural,39,163,187,350,Busia,WESTERN,25295
BUNYALA,Rural,40,279,401,680,Busia,WESTERN,25296
BUNYALA,Rural,41,163,169,332,Busia,WESTERN,25297
BUNYALA,Rural,42,190,192,382,Busia,WESTERN,25298
BUNYALA,Rural,43,131,169,300,Busia,WESTERN,25299
BUNYALA,Rural,44,127,152,279,Busia,WESTERN,25300
BUNYALA,Rural,45,219,286,505,Busia,WESTERN,25301
BUNYALA,Rural,46,134,211,345,Busia,WESTERN,25302
BUNYALA,Rural,47,146,229,375,Busia,WESTERN,25303
BUNYALA,Rural,48,141,172,313,Busia,WESTERN,25304
BUNYALA,Rural,49,132,177,309,Busia,WESTERN,25305
BUNYALA,Rural,50,184,346,530,Busia,WESTERN,25306
BUNYALA,Rural,51,104,166,270,Busia,WESTERN,25307
BUNYALA,Rural,52,109,168,277,Busia,WESTERN,25308
BUNYALA,Rural,53,93,133,226,Busia,WESTERN,25309
BUNYALA,Rural,54,116,152,268,Busia,WESTERN,25310
BUNYALA,Rural,55,141,209,350,Busia,WESTERN,25311
BUNYALA,Rural,56,94,145,239,Busia,WESTERN,25312
BUNYALA,Rural,57,139,159,298,Busia,WESTERN,25313
BUNYALA,Rural,58,58,84,142,Busia,WESTERN,25314
BUNYALA,Rural,59,69,141,210,Busia,WESTERN,25315
BUNYALA,Rural,60,133,255,388,Busia,WESTERN,25316
BUNYALA,Rural,61,99,110,209,Busia,WESTERN,25317
BUNYALA,Rural,62,76,83,159,Busia,WESTERN,25318
BUNYALA,Rural,63,76,104,180,Busia,WESTERN,25319
BUNYALA,Rural,64,76,109,185,Busia,WESTERN,25320
BUNYALA,Rural,65,86,120,206,Busia,WESTERN,25321
BUNYALA,Rural,66,49,61,110,Busia,WESTERN,25322
BUNYALA,Rural,67,89,159,248,Busia,WESTERN,25323
BUNYALA,Rural,68,43,73,116,Busia,WESTERN,25324
BUNYALA,Rural,69,63,121,184,Busia,WESTERN,25325
BUNYALA,Rural,70,84,217,301,Busia,WESTERN,25326
BUNYALA,Rural,71,44,81,125,Busia,WESTERN,25327
BUNYALA,Rural,72,39,75,114,Busia,WESTERN,25328
BUNYALA,Rural,73,64,58,122,Busia,WESTERN,25329
BUNYALA,Rural,74,50,78,128,Busia,WESTERN,25330
BUNYALA,Rural,75,51,91,142,Busia,WESTERN,25331
BUNYALA,Rural,76,40,72,112,Busia,WESTERN,25332
BUNYALA,Rural,77,38,59,97,Busia,WESTERN,25333
BUNYALA,Rural,78,30,52,82,Busia,WESTERN,25334
BUNYALA,Rural,79,30,89,119,Busia,WESTERN,25335
BUNYALA,Rural,80+,267,416,683,Busia,WESTERN,25336
BUNYALA,Rural,Age NS,8,4,12,Busia,WESTERN,25337
TESO SOUTH,Rural,0,2091,2116,4207,Busia,WESTERN,25338
TESO SOUTH,Rural,1,1947,1978,3925,Busia,WESTERN,25339
TESO SOUTH,Rural,2,2216,2180,4396,Busia,WESTERN,25340
TESO SOUTH,Rural,3,2104,2113,4217,Busia,WESTERN,25341
TESO SOUTH,Rural,4,2062,2060,4122,Busia,WESTERN,25342
TESO SOUTH,Rural,5,2067,2020,4087,Busia,WESTERN,25343
TESO SOUTH,Rural,6,1939,1966,3905,Busia,WESTERN,25344
TESO SOUTH,Rural,7,1800,1839,3639,Busia,WESTERN,25345
TESO SOUTH,Rural,8,1750,1782,3532,Busia,WESTERN,25346
TESO SOUTH,Rural,9,1805,1841,3646,Busia,WESTERN,25347
TESO SOUTH,Rural,10,1891,1887,3778,Busia,WESTERN,25348
TESO SOUTH,Rural,11,1443,1516,2959,Busia,WESTERN,25349
TESO SOUTH,Rural,12,1796,1774,3570,Busia,WESTERN,25350
TESO SOUTH,Rural,13,1553,1623,3176,Busia,WESTERN,25351
TESO SOUTH,Rural,14,1548,1470,3018,Busia,WESTERN,25352
TESO SOUTH,Rural,15,1410,1399,2809,Busia,WESTERN,25353
TESO SOUTH,Rural,16,1361,1310,2671,Busia,WESTERN,25354
TESO SOUTH,Rural,17,1376,1272,2648,Busia,WESTERN,25355
TESO SOUTH,Rural,18,1230,1173,2403,Busia,WESTERN,25356
TESO SOUTH,Rural,19,1053,1113,2166,Busia,WESTERN,25357
TESO SOUTH,Rural,20,1150,1387,2537,Busia,WESTERN,25358
TESO SOUTH,Rural,21,831,944,1775,Busia,WESTERN,25359
TESO SOUTH,Rural,22,914,1109,2023,Busia,WESTERN,25360
TESO SOUTH,Rural,23,761,938,1699,Busia,WESTERN,25361
TESO SOUTH,Rural,24,670,913,1583,Busia,WESTERN,25362
TESO SOUTH,Rural,25,717,937,1654,Busia,WESTERN,25363
TESO SOUTH,Rural,26,589,685,1274,Busia,WESTERN,25364
TESO SOUTH,Rural,27,602,739,1341,Busia,WESTERN,25365
TESO SOUTH,Rural,28,494,601,1095,Busia,WESTERN,25366
TESO SOUTH,Rural,29,603,641,1244,Busia,WESTERN,25367
TESO SOUTH,Rural,30,641,848,1489,Busia,WESTERN,25368
TESO SOUTH,Rural,31,467,575,1042,Busia,WESTERN,25369
TESO SOUTH,Rural,32,541,586,1127,Busia,WESTERN,25370
TESO SOUTH,Rural,33,457,533,990,Busia,WESTERN,25371
TESO SOUTH,Rural,34,473,526,999,Busia,WESTERN,25372
TESO SOUTH,Rural,35,557,663,1220,Busia,WESTERN,25373
TESO SOUTH,Rural,36,390,430,820,Busia,WESTERN,25374
TESO SOUTH,Rural,37,381,497,878,Busia,WESTERN,25375
TESO SOUTH,Rural,38,307,394,701,Busia,WESTERN,25376
TESO SOUTH,Rural,39,370,400,770,Busia,WESTERN,25377
TESO SOUTH,Rural,40,472,672,1144,Busia,WESTERN,25378
TESO SOUTH,Rural,41,328,433,761,Busia,WESTERN,25379
TESO SOUTH,Rural,42,266,306,572,Busia,WESTERN,25380
TESO SOUTH,Rural,43,236,294,530,Busia,WESTERN,25381
TESO SOUTH,Rural,44,205,288,493,Busia,WESTERN,25382
TESO SOUTH,Rural,45,311,370,681,Busia,WESTERN,25383
TESO SOUTH,Rural,46,319,339,658,Busia,WESTERN,25384
TESO SOUTH,Rural,47,290,330,620,Busia,WESTERN,25385
TESO SOUTH,Rural,48,236,285,521,Busia,WESTERN,25386
TESO SOUTH,Rural,49,266,323,589,Busia,WESTERN,25387
TESO SOUTH,Rural,50,269,434,703,Busia,WESTERN,25388
TESO SOUTH,Rural,51,238,260,498,Busia,WESTERN,25389
TESO SOUTH,Rural,52,199,254,453,Busia,WESTERN,25390
TESO SOUTH,Rural,53,163,251,414,Busia,WESTERN,25391
TESO SOUTH,Rural,54,169,239,408,Busia,WESTERN,25392
TESO SOUTH,Rural,55,212,276,488,Busia,WESTERN,25393
TESO SOUTH,Rural,56,179,184,363,Busia,WESTERN,25394
TESO SOUTH,Rural,57,251,277,528,Busia,WESTERN,25395
TESO SOUTH,Rural,58,115,155,270,Busia,WESTERN,25396
TESO SOUTH,Rural,59,181,224,405,Busia,WESTERN,25397
TESO SOUTH,Rural,60,220,280,500,Busia,WESTERN,25398
TESO SOUTH,Rural,61,165,169,334,Busia,WESTERN,25399
TESO SOUTH,Rural,62,118,100,218,Busia,WESTERN,25400
TESO SOUTH,Rural,63,132,121,253,Busia,WESTERN,25401
TESO SOUTH,Rural,64,133,145,278,Busia,WESTERN,25402
TESO SOUTH,Rural,65,145,150,295,Busia,WESTERN,25403
TESO SOUTH,Rural,66,84,76,160,Busia,WESTERN,25404
TESO SOUTH,Rural,67,148,158,306,Busia,WESTERN,25405
TESO SOUTH,Rural,68,89,83,172,Busia,WESTERN,25406
TESO SOUTH,Rural,69,135,188,323,Busia,WESTERN,25407
TESO SOUTH,Rural,70,134,176,310,Busia,WESTERN,25408
TESO SOUTH,Rural,71,96,85,181,Busia,WESTERN,25409
TESO SOUTH,Rural,72,85,96,181,Busia,WESTERN,25410
TESO SOUTH,Rural,73,93,75,168,Busia,WESTERN,25411
TESO SOUTH,Rural,74,91,124,215,Busia,WESTERN,25412
TESO SOUTH,Rural,75,72,108,180,Busia,WESTERN,25413
TESO SOUTH,Rural,76,66,59,125,Busia,WESTERN,25414
TESO SOUTH,Rural,77,99,86,185,Busia,WESTERN,25415
TESO SOUTH,Rural,78,63,47,110,Busia,WESTERN,25416
TESO SOUTH,Rural,79,90,121,211,Busia,WESTERN,25417
TESO SOUTH,Rural,80+,384,391,775,Busia,WESTERN,25418
TESO SOUTH,Rural,Age NS,25,23,48,Busia,WESTERN,25419
